cartodb_id,the_geom,percent_change,total_chang,totalveterans,unshelteredveterans,shelteredveterans,state,cartodb_georef_status
22,0106000020E610000008000000010300000001000000230000005F26A678CDFE52C05C9B244215FF4240A063DB5D58FF52C034EF6E3590FC42402B13FFBCB8FF52C0F8CE2D90FAF8424090C55DBA520053C0471F0E0DA9F942400ED0C558A60053C057919E57F9FA424076633DF25D0153C0389FEA9F06FB4240A298FD66140153C0402C5119A6F94240988330E23B0153C0935CF186D4F84240901932C8440153C074AFF66B03F842401D45CC3B1A0153C090F2A7BBE2F64240E467D3D9750153C074E2F43AD1F642409CF7FB02B00153C070756211EEF44240CCD5CA42E30153C080774D7D1DF54240C55F08D6040253C0108E4C39FFF64240303767C3E80153C03852578D91F84240C4D822CCC10153C0E4FF8A80B3F9424055EC4C5A1E0253C02CC8BFAB32FA42404F78A4B55A0253C0E0764523B1F94240B298578FCA0253C0105C1D217FF942405AC0CC56E20253C08FFC9D4191FB4240869DD373E50253C024AE1B8473FD42400867277E4A0353C07C71D0353EFF4240643E7CD3F30253C020B979E0ECFF4240604AAFC3F40153C060B0E754FAFF4240C8569C9FDF0053C0502B7F3DEDFE42404E947CD3310053C0B87A248B1F004340A7B67CD3DD0053C050D2258B57014340F8FF267E860253C050877AE0B40243401CCCCF08940253C078A5C4A6BC03434054E7563DDD0153C0ACCC612C500443409CDC9F531C0153C04B5CD9E2F30443401E289471AB0053C0B0E4D9159504434074257DE5570053C060B8CBCF64034340282EA7672EFF52C0A05848E9670243405F26A678CDFE52C05C9B244215FF42400103000000010000000F000000140B07CB230153C0483E8A686B0D4340781B86829E0053C0109120F7D50B434084C076355B0053C007409A26B60943407313ECBAF50053C058C7E33C380943406006DE549A0153C0F04926A27D0A43407428093D860253C080C0BD513C0A4340E49EE172A10353C03C0235B2F40B434050B89ADF0A0353C03C2512F92C0C43409E38B972450253C06CB60A2DEE0B434010D66867680253C017A84182360D4340B2686806E80253C050DA1E7B450E4340024C424A950153C0A7FF08B15D1043405AA63EA7380153C0A0871B099710434064744E863F0153C0DCDAD3F9E30E4340140B07CB230153C0483E8A686B0D43400103000000010000000B0000009EEFAC12A90153C0D090464CA313434058C9F871200253C0534AF4B803134340EAC65742040453C02805240E57144340B2F15FD4590553C020CD38B790144340A66A737D0E0553C0001D0C6D67174340800F4D22200453C0B880B5B6E51843402B5A68631C0353C0E4D255F4A6194340A2848364510253C028D68FE54E18434064C78C3E860153C0705FD0B4D71643409FDD8CF3E70153C0AC9CDF3F3C1543409EEFAC12A90153C0D090464CA313434001030000000100000010000000AEE160A4F40753C08F815857411E4340AA57D7EFC90853C050CF31E3D71D4340DC3F9923C40953C088F1A5C7611E43408678C1C6660B53C0703BD74BE11F434035183DF90C0C53C0749E0E310C22434036E547E54E0C53C01418285929244340B068D5A2960C53C0F4C26E6329254340B80850DCBC0B53C0ECE649E3E1254340EA3484566C0B53C074A483747F254340BE940B3F3F0B53C0445A3897C2244340FAED85DE6F0B53C0307B76B97B234340B578647E1E0B53C0A02460586421434014BABA128A0A53C0D8908F221A204340934605E1B90953C06F45EBBACD1F4340B0C180C04B0853C0643E41B83B1F4340AEE160A4F40753C08F815857411E434001030000000100000014000000C61FEDCE92CF52C088DA20F628034340FC8ACC7BD5D052C0783CC0B5E5024340FA4AD22849D052C04C877AE0F40343400A67277E0AD052C080DB79E0B80443405622277EB2CE52C0304FD035F208434006D97CD3C9CC52C0E493D0354A0D434088C1D12879CC52C038B6D035960E43403FBB267E2ECC52C0CFFD79E044124340914F7CD379CB52C00036248B8715434030EA7CD3CFC952C09C8D258B7F1A43404C947CD351C752C0A45ECF35DE2343404406D22851C652C068557BE0BC2643400A67277EEAC552C068557BE0BC2643405422277E92C652C060A3CF35F6224340C0607CD3DFC852C0B7C5CF35021C4340CEA594E4F4CA52C0208F301EFB1243400A9551F523CC52C0D0BCD3E67D0B4340F0717CD3A5CE52C0707479E014064340A46BD128FBCE52C017337BE0F0044340C61FEDCE92CF52C088DA20F6280343400103000000010000000A00000026F69BDF49C452C0F0007E23402D43400767277E0AC552C0740AD0351A2B4340944F7CD3D9C452C0E0B2CE35E22E43400967277ECAC352C0975ECF351E36434063AA7CD3B1C352C09848D0350A3A4340BA3A277ED0C252C02F8FD035163A43404A947CD3D1C252C0E393D0350A3A4340A028D228DDC252C0DC48258B67364340F2717CD345C352C0D8B2CE35A231434026F69BDF49C452C0F0007E23402D434001030000000100000009000000A0FE42DB661753C018DECA84B29E43404445175FEA1753C040995F77819E43407EDEDF964B1853C0F4B88A9AAF9E4340BC809F1D821853C0EC26D303079F4340B8241A198E1853C0501D5F4D6E9F4340872EA400671853C000F753F5C89F43406883B760391853C09367D6ADF99F43404C50339F111853C05825FE861BA04340A0FE42DB661753C018DECA84B29E434001030000000100000045040000462C2E80C9CF53C0584016EF60DC434078BB60B366C853C0485E7D555FDC4340DA4194E603C153C0485E7D555FDC43400CD1C619A1B953C0485E7D555FDC4340EE1E94E63DB253C0485E7D555FDC43401046FB4CDCAA53C0485E7D555FDC4340346461B378A353C048EDB0885EDC43409EEA94E6159C53C0387CE4BB5DDC4340D6EA93E6B39453C0387CE4BB5DDC43403971C719518D53C0387CE4BB5DDC4340A2F7FA4CEE8553C0387CE4BB5DDC4340CE862D808B7E53C0387CE4BB5DDC4340AFD4FA4C287753C02C9A4B225CDC43409A9394E6C56F53C0ACC9B0885ADC434082522E80636853C0ACC9B0885ADC43402DA9FA4C006153C0ACC9B0885ADC43409EA0FA4C9E5953C0ACC9B0885ADC434000272E803B5253C0ACC9B0885ADC4340AB7DFA4CD84A53C0AC58E4BB59DC43400D042E80754353C09C764B2258DC4340409360B3123C53C09C764B2258DC4340E18161B3B03453C09C764B2258DC4340141194E64D2D53C09C764B2258DC4340F55E61B3EA2553C09C764B2258DC4340D81DFB4C881E53C07494B28856DC43400AAD2D80251753C090D515EF54DC43406C3361B3C20F53C090D515EF54DC434026FBF94C600853C090D515EF54DC43400849C719FD0053C090D515EF54DC43402A702E809BF952C090D515EF54DC434078117D2379F252C0F7694F2954DC4340E0D79F5077F252C0180E8C97DED24340A5885D5E04F252C088A89F8F79C943403AD8E4A1BDF152C030D095D802C043408839328753F152C0102D166545B64340D40189B6E4F052C03C8517EF6CAD4340846F88B69CF052C0F3417E550BA443404A04C77C3AF052C00474D693289B4340C28051A9D1EF52C0B8BDC0C0549143400A9D68006FEF52C0680E9096E3874340380A400B05EF52C024AF9EDCA47E43400C305ECAB4EE52C0904E2C0EFD7443404F03817C54EE52C01412988DB56B4340D2CDA42EF4ED52C0C442ED40AE6243401A132FE993ED52C090AB67D4545943404A2F5CA938ED52C073AD2479874F434048548869DDEC52C0A836467DF9464340926F9DC9AFEC52C060F58CC033404340EED4F39A65EC52C06BC227DDEC3A434034DBD2AA56E852C050AA2064893A4340E0B712D68BE352C0A042E120523A4340205E89B660DE52C084BE7D55133A43409606BCE963D952C0000C4A22103A434044A6EF1C67D452C0D4D64B220C3A4340C2BFEE1C6BCF52C0C8C44922083A4340755F22506ECA52C0A80018EF043A4340F8672250F6C652C0C84718EF0C3A4340FA63277E5EC552C0B4F0248B0F3A43403EBB267E4EC552C0EB19CF35463943405E7246A1C0C552C0A846D85F52374340DF8C016F87C652C054F713052238434046E00C8790C752C0D0E55362FF3743407C02824845C652C0C46F7D7E3634434079209DADA8C652C06811524A973243401C127D252DC752C00F81F1B321334340DC7355102BC852C0487BB744F1334340E27C254E76C952C09F35099CF43443400A6CED6195CA52C07F5D9C2B5C354340AD7F6F177DCB52C07F034A1F473443408CD353BBF1C852C0C00AA697213343402A61784878C852C09C23F0A37432434004D97CD389C852C0F8CB7AE04C31434004D97CD389C852C054D2258B573043404206D22811C852C054D2258B573043404206D22811C852C010E8CF358E2F4340AAF97BD35BC852C0D8FD79E0442F434006D97CD3A9C852C0680AD035DA2E43402DEA7CD3EFC852C07C0AD0359A2E4340041C7CD307C852C0B07A248B1F2E4340309FD1282DC752C0D42CD035662E43405222277E72C652C0680AD0355A2E43400A67277EEAC552C028D5CE35EE2C4340061C7CD307C652C028B979E0EC2A43403FBB267EAEC652C098F7CE357A2843402C9FD1288DC752C0F880CF352A2643403A2D7CD34DC852C00CCC7AE08C244340BE607CD3DFC952C030B6D035D61E4340A228D2287DCA52C00881CF35EA1D4340D4C77CD3A3CC52C0CFFD79E0C41D434074A57CD3D7CC52C0B0C5CF35C21E4340B044277EFECB52C08471D0357E214340725AD12815CE52C0204FD035B21F43400E67277EEACE52C044B6D035961E4340091C7CD387CF52C0F8CB7AE00C1D4340745AD12875D052C0F019CF3586154340765AD12815D152C0E4B2CE3562144340D4C77CD363D152C0878D258B7F134340CC7CD12821D252C038D5CE356E0F43406689277E96D252C01417268B2F0E4340061C7CD307D352C028D5CE352E0E434076A57CD337D452C05CA3CF35F60E43404206D228D1D452C098F7CE35FA0E4340B044277E5ED552C00036248B470E4340FC4AD22869D652C0EC93D0350A0C4340FA4AD228C9D652C02C04258B8F0B4340914F7CD379D652C0B0C5CF35820A4340BE607CD3DFD752C047D2258B17044340C2AB277E02D852C008CC7AE00C034340A73901EA26D852C0A4374705F20143407206DC392FD852C0BC787EF0F0014340CC6441572DD952C0C87FFA4AC1014340C81F89ECF9DA52C0A816A3C381014340329D043675DD52C0E7249B78220143408DC471BB57E052C00417138893004340FA87488C12E352C080C6355B240043408803094ED5E552C0C805854CA5FF4240A4C5CC3D72E752C0E40C01A775FF424056738092E8E752C08041518444FF42406D582EF56DE852C0982A2418E9FD4240F1BCD6420FE952C0C435E881C5FC4240A2D2EC8276E952C0B7EDD0999CFB424060FB7CD3D5E952C0C82CD035E6FB42401E837CD30BEB52C00481CF356AFC424076A57CD3D7F052C05CA3CF3536FD42405322277E52F252C00481CF35EAFC42408BC1D128B9F352C0473CCF3552FB4240D5C77CD3A3F552C088F7CE357AF8424004D97CD3E9F652C01017268B2FF74240B044277E7EF752C0403CCF35D2F742409B28D2289DF752C08071D035BEF842406689277ED6F752C054A3CF3536F94240C0607CD3FFF752C08071D035BEF94240E9E3D128E5F752C0E4B2CE35E2FA4240E8E3D12885F752C018E8CF35CEFB42406989277EF6F652C0403CCF3592FC42402C9FD1286DF652C0607479E094FD42409DDD267E1AF652C07C71D0353EFF424062FB7CD3B5F652C0CC2CD03526FF42406A89277E36F752C0503CCF35D2FE4240ACF97BD39BF752C0E819CF3546FE4240E9E3D128E5F752C0948D258B7FFD4240643E7CD353F852C0948D258B7FFD42400E67277E4AF852C0BC7A248B1FFE4240C4AB277E62F852C0D893D0354AFE4240362D7CD38DF852C008E8CF354EFE4240964F7CD3B9F852C050877AE074FE4240A8F97BD33BF852C008E8CF354EFF42409E28D228DDF652C050877AE0B4024340765AD12895F652C047D2258B170443401C837CD32BF652C0503CCF3512054340B044277E5EF452C068BF248B770543405EFB7CD3F5F352C0D8B2CE35E2054340745AD12855F352C028D5CE356E0743401C837CD36BF052C0740AD035DA0B4340309FD1288DEF52C01417268B2F0E4340A8B67CD37DF052C09C8D258B7F0E43404206D22831F152C0DCFD79E0840D4340D3C77CD3E3F152C058A3CF35360C43408AC1D128D9F252C02C04258B8F0B43401E837CD36BF452C0CC2CD035A60B4340715AD12855F552C00081CF356A0B43409DDD267E1AF652C00817268BAF0A4340B244277E3EF652C01CE8CF350E0B4340DA0A7CD341F652C0284FD035320B434030EA7CD34FF652C008E8CF354E0B4340765AD12895F652C02C04258B8F0B4340765AD12895F652C0D0FD79E0840C43402C9FD128EDF552C060BF248BF70C4340F2717CD345F552C0E0FD79E0C40D43409CDD267EBAF452C0E093D035CA0E4340E8E3D12865F452C038D5CE35EE0F43400A67277ECAF452C010E8CF35CE104340C0607CD31FF452C01CE8CF354E114340623E7CD333F252C0780AD035DA11434049947CD3B1F152C008E8CF358E124340FAFF267EE6F152C0A85ECF35DE1343404406D228D1F252C03CB6D035561443404E947CD3F1F352C0D0B2CE35221443400A67277ECAF452C0E4B2CE3562144340081C7CD347F652C094F7CE357A13434040BB267E2EF952C094F7CE35FA134340D4C77CD383FA52C028D5CE356E134340904F7CD3D9FA52C0D893D0358A1243401E837CD3EBFA52C0B87A248B5F11434040BB267E0EFB52C0AC5ECF355E10434098DD267E9AFB52C038D5CE35EE0F4340B144277EFEFB52C02FB6D035561043404406D22831FC52C06C7479E054114340C2AB277E42FC52C0C82CD035E61343401E837CD36BFB52C0F419CF35C6184340A228D2285DF952C05FBF248BF71A4340F84AD228C9F652C0A87A248B1F1C4340E8E3D12865F452C00881CF35EA1D434006D97CD369F552C08071D035BE1E4340A028D2283DF852C044B6D035161F43401A837CD36BF952C0BF107BE024204340F4FF267E06FA52C00C17268BAF224340CE7CD128C1F952C0780AD0359A25434004D97CD309F952C040B6D035562843400C67277EEAF652C0C82CD035E62D434077A57CD357F652C0985ECF35DE2F4340924F7CD3F9F552C0A85ECF359E32434040BB267ECEF552C014E8CF354E33434074A57CD3F7F552C0C0C5CF35C23343402E9FD128CDF652C02CB979E0EC334340A8B67CD33DF752C02CB979E06C334340623E7CD373F752C088F7CE353A324340A4B67CD39DF752C00436248BC7304340E9E3D128E5F752C010E8CF358E2F43403EBB267E2EFB52C038B6D0359629434098DD267E9AFB52C02804258B8F28434004D97CD329FD52C0888D258BFF2043409E28D2289DFD52C08C71D035BE1F434078A57CD3F7FD52C0E0FD79E084204340725AD128F5FD52C090427AE09C2143409C28D228DDFD52C0680AD035DA22434078A57CD3F7FD52C098427AE01C24434076A57CD357FE52C0E0B2CE35E22443405F3E7CD3F3FE52C0503CCF35D2254340C6AB277E82FF52C0C42CD035E6264340DC0A7CD3C1FF52C038B6D03516284340AAB67CD35DFF52C090F7CE35BA29434075A57CD397FD52C06C557BE0FC2A4340D4C77CD323FD52C028D5CE35EE2C4340C0607CD3BFFD52C008E8CF35CE2F4340D2C77CD363FF52C048D2258B572E43405EFB7CD3350153C0780AD035DA2A4340CE7CD128610253C088427AE09C2743405EFB7CD3B50153C00017268BEF264340ACF97BD33B0153C00817268BAF254340A8F97BD31B0153C04C3CCF3512244340A8F97BD31B0153C0F835248B472243405FFB7CD3D50153C0284FD035F21E43402C9FD1286D0253C0B0C5CF35C21D4340BE607CD31F0353C0DFB2CE35A21E43404F22277E320553C094427AE05C2443405CFB7CD3D50553C030D5CE356E254340EAE3D128850753C028D5CE352E2643405DFB7CD3F50753C0DCFD79E00427434002D97CD3890853C07B0AD0355A2943408AC1D128590C53C08071D035FE3043401E837CD36B0D53C028D5CE352E324340C0AB277E220E53C0780AD0351A31434076A57CD3370D53C030B6D035562B43401E837CD36B0D53C02804258B8F2843404A947CD3D10D53C02804258B8F284340F6FF267E260E53C0E4FD79E0042C4340964F7CD3590F53C0DCB2CE35222F4340EE717CD3451153C02CB979E0EC334340ACF97BD39B1153C034D5CE35AE3443404C947CD3111253C08871D035FE3543409E28D2287D1253C07C71D0357E374340F74AD228E91253C017E8CF354E3A4340765AD128751353C008CC7AE04C3B43402F9FD1280D1453C08371D035FE3B434005D97CD3691453C00881CF35AA3C434076A57CD3771453C090427AE05C3F4340BE607CD37F1353C040B6D03556404340643E7CD3531253C0DBFD79E004404340CD7CD128C11153C050D2258BD73E434098DD267E7A1153C038B6D035D63B4340CC7CD128E11053C034B6D035963B4340F8FF267E461053C00081CF356A3D4340CF7CD128011053C0E4B2CE35A2404340C2AB277E820F53C060A3CF35B6424340725AD128550E53C0EC93D035CA434340E8E3D128E50C53C07871D0357E444340C2AB277EA20B53C094F7CE357A454340AEF97BD3FB0B53C0483CCF35D2464340DE0A7CD3010B53C090F7CE357A4843405222277E320B53C0740AD035DA4943408EC1D128790B53C008E8CF354E4A43403CBB267ECE0B53C04C3CCF35924A43408DC1D128390C53C0284FD035B24A4340944F7CD3B90C53C088F7CE35BA4A43408CC1D128790D53C030B6D035964A4340051C7CD3A70D53C028B979E02C4A4340745AD128B50D53C090F7CE357A49434001D97CD3090E53C0948D258B7F484340AAF97BD3BB0E53C0AC5ECF359E474340081C7CD3870F53C0B7C5CF3542474340D5C77CD3831153C098F7CE353A4743403CBB267E4E1253C0E093D0350A4843405422277ED21153C044B6D035D6494340F4FF267E661053C060BF248B774C4340F4FF267E661053C050D2258B574D43403EBB267ECE1053C000CC7AE0CC4D4340ACF97BD31B1153C02004258B4F4E4340CD7CD128C11153C068BF248BF74F4340CE7CD128E10E53C088427AE01C4F43404A947CD3D10D53C047D2258B174F4340D70A7CD3E10C53C0284FD035724F4340904F7CD3390B53C0D893D0358A5043405622277E520A53C0D0FD79E0C4504340EE717CD3450B53C0284FD035724F4340C2AB277EA20B53C047D2258B174F4340C0607CD3FF0A53C088427AE01C4E43405622277E520A53C050D2258B574D4340CE7CD128210953C0C0C5CF35C24D4340B8035ABF5B0753C0B04481C7424B4340063F0F20E90553C050BA5131FC4B4340B44D7BF46D0353C060F4677CB548434034010C1FBF0053C0FCC5D86267484340C2AB277EA2FF52C058A3CF35B64A4340DA0A7CD3E1FE52C0EC19CF35864B434076A57CD317FE52C0C4107BE0A44D4340081C7CD3C7FD52C040B6D03596514340D4C77CD323FD52C0E093D0358A534340F4FF267E66FD52C034D5CE35EE5343409E28D2289DFD52C038B6D0355654434078A57CD3F7FD52C038B6D03556544340AAF97BD35BFF52C0A75ECF35DE4F4340584CBACDFEFF52C06465F9D6214D43406036EF358D0153C0E8FDAA63E24B4340ECF06659CC0353C03C403A00984D4340A20131A6EC0453C0E40DF01ECC4E4340A8CADBCAB80653C0140E150EFD4F434002D97CD3E90553C038B6D03556544340D07CD128E10653C05CA3CF35B65343406689277EB60753C01417268BEF524340D6C77CD3A30853C03CD5CE35AE524340C4AB277EE20953C0E093D0358A534340C4AB277EE20953C038B6D03556544340372D7CD34D0953C0BC7A248B1F554340051C7CD3A70753C09CF7CE357A56434004D97CD3C90653C054A3CF35F656434004D97CD3C90653C040B6D035D6574340B044277E1E0853C0F880CF35AA574340D07CD128810953C0DC48258B27574340DA0A7CD3A10A53C088F7CE353A5743405222277E320B53C0E493D035CA584340EE717CD3C50A53C038B6D03596594340061C7CD3870A53C0C4107BE0A45A4340D0C77CD3830A53C0AC5ECF35DE5B4340C0AB277EC20A53C0D02CD035265D4340633E7CD3530B53C00481CF35AA5B4340A228D2289D0B53C0D048258BE75943406889277EF60B53C040877AE0745843406E7692AAB60C53C098482A3F68564340561BED62610D53C0487B7796E6574340EC99E42E7F0E53C023595A69B9594340348A2B48220F53C020DE582F8A5B4340C28E3488940E53C050362A4C2C5E434012C729E9EA0C53C0D0CCBE32BC5D4340D65C9340330E53C03C176A871E60434088F2E367F70E53C0782AAB19F4604340ACDB3E16481053C068557802E75F43407ED54D99831153C088C06A9C755B43400C272E2FAF1253C010F15409545C434032975D28071353C09C00B7C61E6043402AC5B1D5751253C0185FEB2723624340251AC4376F1253C0DC935870446343400042442DD71253C0F8E08EA70D6343400ED4364CD41353C0EF88AE3E7061434024357DA1E01353C00424C4501F5E4340E01ED0A1E51453C088BFC866EF5B43404C7D016CE91453C07C2E8ACD705943408C16C6C79B1453C088CDCE493F58434024097F42DA1453C0A76E3D70B95643405BDF65BED71553C09B0ADC872A564340FC4AD228291653C02404258B4F584340A8B67CD3FD1553C00881CF356A5B4340071C7CD3C71553C070557BE03C5D43405422277E321553C094F7CE357A5F43404C947CD3F11353C02C4FD035F2664340AF44277E9E1353C06F557BE03C684340BE607CD37F1353C02C04258B4F694340AE44277EBE1153C0D0B2CE35A26B43408003D882A91053C0E8868E73D46D4340E28146EB331053C0F4BF24BB706D43409B3A689F9C1053C088985D676B6B43402A252A05510F53C06FFF31BE39694340F051B7FA240E53C0049B9D005B684340285A1062980D53C0F0055BA360674340BCB2DE17930D53C014941C36E56443404B1F6031B30C53C090EF81B35A634340F0EDE607C00B53C064964152D76143405CD3383E140B53C0145D33ADD860434062FB7CD3350953C0543CCF355262434004D97CD3690853C030D5CE35EE624340F2717CD3850753C07C557BE07C6443409CDD267EFA0653C08871D0357E664340944F7CD3390753C0D8FD79E08468434060FB7CD3150853C08871D0357E664340EC717CD3650953C0F880CF352A654340C0058C6D530B53C058A1DEEC8C64434090B8BCA9700C53C0F0ADFD742E684340EA2F37EF0A0C53C0C3A17C5D606C43404A6E84400C0A53C060654189186E4340DD0A7CD3210853C0730AD035DA6E434004D97CD3C90653C0D4B2CE35627043406A89277E760953C09C5ECF351E724340C4AB277EE20953C0680AD0359A7243403A2D7CD36D0953C070557BE03C754340B044277E7E0953C0BC107BE0647643405622277E520A53C0707479E094764340EE717CD3850A53C030B6D035D6754340B044277EFE0A53C010E8CF35CE7243400A67277E6A0B53C0E3B2CE3522724340B6902F1DAA0C53C093C53F3E71704340AEF97BD37B0C53C0B0C5CF35C27443406A89277E560C53C04B3CCF35D2764340A2CC87199A0C53C0C8251651C3774340465EA01B4F0D53C0906B4B7DD678434070DC9502B70E53C068C7F86AE67943404D947CD3910F53C038D5CE35AE7943404E947CD3D10F53C0988D258BBF7943408CC1D128591053C02804258BCF7843404406D228D11053C098F7CE35BA774340CC7CD128E11053C0B87A248B5F774340E6E3D128851153C0D0FD79E0C4764340603E7CD3F31153C094427AE09C7643401E837CD3EB1353C0780AD0355A7643402DEA7CD36F1453C0740AD0351A7643401A837CD30B1553C02C04258B4F754340AAB67CD33D1553C048D2258B17744340E873A3323F1553C0889083179F724340260D8198EE1453C0A499133AC3704340B01D5FEA031553C0F8A90F70BD6E43409C87F41D341653C09052594CA06D4340ACD065CFFD1653C0ABE588755D6C434055ADBADEFB1753C0C8FCDEABB86B4340824277BB711753C074F8A3A3BA72434088B81361CD1653C078ED4B036D7943402BEA7CD3AF1553C0D8B2CE35227D4340A228D2287D1553C0687479E0147E4340A028D2289D1453C0403CCF35D2804340362D7CD32D1453C0BBC5CF35C2834340AAF97BD39B1353C0BFC5CF3502844340D70A7CD3E11253C0E493D0358A8343404EB1CDCDC41253C08FA95C641F8143400CF297CF3F1253C084A78894A57E434096184605A40F53C05F6B91BC4C7D4340DE654873D60D53C0CCB53E7FB67C43402246B3D8A40C53C034485C025B7D4340B044277EBE0A53C0F835248B877F434004D97CD3A90953C00481CF352A814340FB4AD228690953C0EC19CF35C683434004D97CD3E90953C02804258B4F8443401E837CD34B0A53C040B6D035168543405422277E920A53C0607479E014864340C0AB277EC20A53C0B7C5CF3542874340D27CD128410953C0284FD035B287434002D97CD3890853C01CE8CF350E884340D1C77CD3030953C030D5CE35EE884340FA4AD228C90753C040B6D035D68B43404206D228F10453C028D5CE356E9043400A67277E2A0453C04C877AE0B4924340B244277E9E0553C09C8D258BBF914340944F7CD3F90653C0A05ECF351E9043409EDD267E5A0853C0707479E0148F4340C4AB277EE20953C018B979E0EC8F4340D1C77CD3030953C0B77A248BDF904340D1C77CD3030953C09C8D258BBF914340725AD128350B53C0D8B2CE35E28F434008A8D009D90B53C0A0101A910D8C43404A30ACE00C0D53C0246FD72A458A434029894CF6980D53C0880F931AA1864340FCF794BA490D53C08C0625E3D083434096E710B7110D53C02FF5A239DC8143408A41CECBE60D53C03C40E7B7AD81434058AE5637080F53C0CCC83A122B834340B29DDC0D870F53C018E412DA41844340F2BFE97ECA0E53C044FAD49575874340DE5622FF150F53C048910816928C4340949FD50E8E0F53C0E4A07800D18E4340ED6F48B7860F53C080BF35703A904340AA1D2BAF171053C043B08B2BF990434006A60CAF731153C0386A820B669343404A04E2BC721153C01F9DA3C380954340B0C7FB06601053C0DC2B0FF321984340FE1ED25BFB0E53C0C8EE355D7F9D4340661489A49E0D53C024595D2188A143403CBB267E8E0B53C0B07A248BDFA4434040BB267E6E0B53C0DC48258B67A743405222277E320B53C088F7CE357AA843402E9FD1288D0A53C0D8B2CE3562A94340EE717CD3250953C02704258BCFA9434002D97CD3890853C008CC7AE04CAA4340362D7CD32D0853C0687479E054AB4340362D7CD3AD0753C0770AD0351AAE43406689277E760753C01BB979E0ACAE434086BD7D41BE0653C0A8FC46439FAF434062797995D00353C05C05F9FF4FAF43407E7CD36BC80153C0B45AD89B64AE43402A8ABA16FAFF52C06054401E5DAE434086A72D949DFB52C0982231CFB7AE43404A16CFEAAEF852C0CC336A5667AE4340661D0FC20BF752C0FC0F7AF44EAE4340745AD128B5F552C008CC7AE08CAF43402BB9890E4CF752C004C7C59596B04340ACDEC1B2E6F952C070DFDF84E8AF4340D69D8F146C0053C038D7CACDB5B0434056764864310253C074FAA2CD49B24340D0C77CD3E30053C0D0FD79E044B54340745AD12855FE52C048877AE0B4B94340319FD128EDFC52C0B87A248B9FBB43405022277ED2FB52C068557BE0BCBC4340EF717CD365FA52C098F7CE35FABC434042BB267E6EF752C030D5CE356EBB4340745AD128B5F552C09CF7CE35FABA4340745AD128B5F552C0F419CF35C6BB4340944F7CD399F752C0EC19CF3586BD4340643E7CD393F852C0B8C5CF3502BF4340603E7CD333F952C0740AD0351AC14340BC607CD39FF752C07871D0357EC24340AAF97BD37BF652C00481CF35EAC443406389277EB6F552C0A45ECF35DEC743409CDD267E3AF552C000CC7AE0CCCA4340F84AD228C9F652C0CF48258BE7C94340F2717CD3E5F752C00BCC7AE00CC84340081C7CD3E7F852C0543CCF35D2C54340AC547963EAF952C0A0DCD48CC1C2434098664BCDD3FD52C0F712E460A9BD4340EAED6CAE0B0053C06C1ED906F5B943409DDD267EFAFF52C0C4107BE024BE4340F8FF267E66FF52C0503CCF3592C043400E67277ECAFD52C04C877AE034C443408CC1D12819FD52C0DC48258B27C643408EC1D12899FC52C0A05ECF355EC843405022277ED2FB52C030B6D03556CD4340A6B67CD3DDFC52C037D5CE35EECC43409CDD267E9AFD52C0985ECF359ECB43400A67277EAAFE52C098427AE09CC84340FE3516D0880053C0EC8C39603BC64340F0A4F0F9710253C034B86B583FC74340BAE4119F250453C028B1160C1FC743402EEA7CD34F0553C0D02CD03566C7434002D97CD3E90553C020B979E06CC64340643E7CD3B30753C07B0AD0355ABF4340EC717CD3050753C0687479E014BE4340309FD128AD0453C02404258BCFBC43400A67277E2A0453C0C0C5CF3542BC43405422277E520453C0780AD0359ABA4340B044277EBE0453C02F4FD03572B943405FFB7CD3D50753C094427AE09CB44340DC0A7CD3C10B53C0EC19CF3506B143401E837CD36B0D53C01BB979E0ACAE4340745AD128750E53C08F427AE05CB043404C947CD3B10E53C0DCB2CE35E2B24340DA0A7CD3410E53C088427AE05CB84340725AD128D50D53C0F8CB7AE0CCBA434032EA7CD3CF0D53C0700AD035DABB4340DA0A7CD3410E53C068557BE0BCBC4340CE7CD128E10E53C068557BE0BCBC4340AD44277E5E0F53C00436248BC7BB434018837CD3CB0F53C0DC48258BA7BA4340623E7CD3331053C098427AE01CBA4340643E7CD3131153C08C71D0357EB043401C837CD32B1053C0F419CF3546AE43404A947CD3B10F53C08871D035BEAC4340F84AD228C90F53C000CC7AE00CAC4340D80A7CD3411053C00036248B87AB434030EA7CD32F1253C0B0C5CF35C2A743400867277EAA1253C058A3CF35B6AD43402DEA7CD3EF1353C008E8CF358EB3434030EA7CD3CF1453C030D5CE352EB443404E947CD3B11953C08371D0353EB24340309FD128AD1853C03CD5CE35EEB043400A67277EEA1653C0E0FD79E044B043401A837CD38B1553C0C4C5CF3542AF43402BEA7CD3AF1553C024B979E0ECAC434002D97CD3491553C024B979E0ECAC4340A6B67CD3DD1553C0607479E094AB4340D07CD128811653C0E893D0354AAB43404206D228311753C00C81CF352AAB4340FA4AD228E91753C008CC7AE04CAA4340725AD128751753C0A45ECF359EA84340BC607CD39F1753C044B6D03516A843400C67277E2A1B53C028D5CE356EA943405022277E921B53C060BF248BB7A84340964F7CD3191B53C0B47A248B1FA74340A6B67CD3FD1853C0C4C5CF35C2A24340FC4AD228091953C0E048258BE7A143404E947CD3B11953C0D8FD79E0C4A043403EBB267EAE1A53C0D893D035CAA14340C1AB277E421B53C0E893D0350AA343404E947CD3511C53C0B8C5CF3502A6434076A57CD3D71C53C00481CF35AAA643404006D228F11E53C0B0C5CF35C2A7434032EA7CD3EF1D53C064A3CF3536A44340041C7CD3A71C53C094427AE0DCA043409CDD267EFA1A53C0C0C5CF35829E4340AE5FA63C661953C0D88C1A2D769E4340FAEC53FDC61953C098222E17299D434032AC0C57A51B53C0F4CFF31E5C9A434062498754BF1C53C014C0E458F4984340F0A0E632B51C53C0740D1200AE9A43400C88C8CA7E1C53C000325E4EE49B4340D3C77CD3231D53C02FD5CE352E9C4340DA0A7CD3A11D53C0A85ECF355E9B4340A8265BCC0B1E53C0ACE3EDBF909A4340CCD6516DE11E53C0D854D6B08B9A4340D04CCD04D41F53C0B46E3B02B29A4340A69CA697841F53C014CFD4901D9D4340BE3383F3872053C098C1BF1F369E43407FE09C370C2253C0DBE6CCAB779F4340EF363FF6212453C0AF54B958EAA14340BCD07946882453C06440268E06A3434048947CD3312553C067BF248B37A24340623E7CD3D32553C088F7CE35BAA143405CFB7CD3752753C02C04258B8FA14340C6AB277EE22753C08871D0353EA143404A947CD3112753C0403CCF3592A04340581228E1902653C063934B16C99F4340AE44277E7E2553C01C04258BCF9F4340A62F08687F2453C0AF957913529F4340CCC65DF9162453C0D8D5B05B9B9D4340065D4ADC112453C058FF6CFA9F9B4340B605B358562253C06C36D997109B4340A0E5E1E6EF2153C044C10F5F0A9A434058B80B7ECF2153C068C43AFF7D9843402483193C942153C0077F54D7A2974340CC5704BD1F2153C078BBBCE59C964340BE607CD3FF1F53C0780AD0351A954340FA1CBD4C9A1F53C048F9180CAB94434064BB765AB81E53C08FAED502619543408F825B95091E53C04CB43714D8934340924F7CD3391C53C008CC7AE04C9143402CB66CE7BA1B53C04CADDAC3CB904340DEC0DCD5881B53C06871305C9C8D434075306031D91A53C0C8E9F3B1788B4340A8C07939381B53C0C44649917A894340C46E3E2CB61B53C0680CCDCB9A884340C43EEE79631C53C09F3BAAA9CB894340AE44277E5E1C53C0700AD0355A8B43403A2D7CD32D1D53C088427AE09C8B4340F6FF267E061E53C028D5CE35AE8A4340197596B49D1E53C0F828357E588A4340FE97B3F0D51F53C047B871A70E8A4340AE4A846ED82053C038B43812118B43404A2B81D13B2153C0F83B8B80F88A43404E40BDF30D2153C0B0D0896FAE8943406EF7E286FD1F53C0E4782540C2884340DDA52A267C1E53C0B869C74231884340686BA3EB761B53C03F676DC2D9854340686B6CF83B1A53C0C80EE02AD88443409CDD267E3A1953C0C0107BE024834340DC0A7CD3811953C058D2258BD78143405222277E921A53C0E019CF3546814340663E7CD3131C53C0D32CD035268143400867277E8A1C53C00481CF35AA80434080E4CB0E281D53C020A2E7DC8E7E4340A214FBFE3F1E53C00C49CF69607F434096592BAAC32053C0D09F49B1CF82434036509358932153C0E01F1D68CF854340E0539CAA882253C028BDE865338843403DBB267E4E2353C0CFB2CE35E28943404406D228112453C0B0C5CF3582894340309FD1286D2453C0908D258B7F884340C2AB277E622453C038D5CE352E874340D2CEF9548E2453C0C80C2E46F284434048337B0BF12353C0D09418D69D84434054743154C52253C0487F43D60A8443402E56AE2CFB2153C01089AAF5C4824340AEA805E5CC2053C00003DC9BBB804340B5747F341D1F53C0B87DAE74467E43401FF3C5677D1E53C0A8599F6DD37C4340E0D3464F131E53C098073525147A434063003A8FF41C53C0C0DC826DD0784340A91F8EBAC51D53C09079696C6A77434008290A4A6A1D53C060AF67E4C0744340B7D0959B172053C0D43529D2AB76434084D90B659E2153C0E04DE648BC79434074620AC7AD2353C0640D4EF3B77A434036F08C11642453C010F603E4EC794340AAF97BD33B2253C0E0FD79E00478434030EA7CD38F2153C0707479E09476434072061826CB2053C05F03875CD8744340D0578AF68E1F53C0082C52CB10734340FE1C54B2C11F53C07453F8EAA57043400C53EF97792053C0F86618748B7043400057D6BC5E2153C044AE68A88E714340EC717CD3652253C0E3B2CE35227243406689277E562253C03CB6D03596714340C2AB277E422253C064A3CF35367143405CFB7CD3F52153C0D4B2CE3562704340AEA1120C842153C0F0B38C0C666F4340489569E0B92153C0B07EA7CE456E43404B46F9D57E2253C008350B6DA66D4340DA2CAEBC072253C0FC2116DB6B6B4340BEE4A8046D2153C0F4B3DC09DE6B434099CBB05E602053C08847A1C7106C4340206B62EE8B1F53C0F0EC98F2156C4340A2F79469A21F53C0DC3C6581AB694340A4B67CD33D2053C0AC5ECF355E674340802E9542F62153C0003D20B2436443403DBB267E4E2353C0F419CF35466343407AA57CD3372353C0D048258BA7604340A028D2287D2253C018B979E06C5E4340F00F8FB5602153C058E21A49C95C43404C7181A3BB2153C03C3C2E38F0594340A47788E4E32153C09C8A834E7F56434004CCB444612153C0B8DCCAD3385343407CAD6BE4952053C0FFE63CDF665043400A1C7CD3C72053C0CC2CD035264943408059843CC42053C07438E6C88C4343403A2F2848B61F53C0B00BF5847D3F43404804D84ADF1B53C0A00109B817384340F0313CAF7E1A53C09407E970C73443404A41FCFE581953C02054124E153243403C999221711853C04875FEBD393143408437590D231953C09001DBC6412D4340246FEBC7D61A53C0E01549A72D29434032EA482B071D53C090D3F38F7A294340D046E4D7291E53C0489563B7F12A4340F6FF267E061E53C07C0AD0359A2E4340745AD128551E53C0F835248BC72F4340F0717CD3651E53C02FB6D03596304340C6AB277E821E53C0F8CB7AE04C3143404006D228F11E53C028D5CE352E324340DC0A7CD3012053C064A3CF3536334340944F7CD3B92053C064A3CF35B6334340A8B67CD3BD2253C03CD5CE356E344340340C18EAF12353C060BF23AE4C364340F6E1FBA38E2653C04C4D3EF4DF3843407C016301BC2853C08CDDF062B13C4340743321E8732953C0D8546D3CBA404340AE44277EFE2A53C0D8FD79E0C4534340A228D2289D2B53C054A3CF35F6564340041C7CD3C72B53C030B6D03516564340663E7CD3B32B53C030B6D035165543400C67277ECA2B53C0A05ECF359E53434048947CD3712B53C0D893D0354A4A4340382D7CD32D2B53C090F7CE357A4743406889277E362B53C0F419CF35864443403C1D8138422B53C08858C21C354143400A1399FB1C2B53C010ECE224373E434036923C1E0D2A53C0D0D45E90A939434003D97CD3A92753C01017268B2F364340AE44277E7E2553C018E8CF350E3343409E28D2285D2153C0D42CD035E62F43402EEA7CD3AF2053C0607479E0142F4340D0C77CD3632053C08B71D035BE2C43409ADD267E9A1F53C070BF248B372A43409E28D2287D1E53C008CC7AE00C284340B1C1DA2FD71C53C03F44E9A085254340BE9980DBAA1B53C080A18D17A3254340B22F80532C1B53C0A867D51C9D264340DC0A7CD3011A53C050A3CF3576274340984A6BABB01853C00F08A3EF34274340D902427EE51753C09CB7531C422643400C428B95C61853C030230612382443406AB93D855F1953C03FAD068E2F22434017837CD32B1953C068557BE07C1F4340FC4AD228C91853C0F8CB7AE00C1D4340924F7CD3591853C0747479E0141C434092E87EB10B1753C034B5D846EC1843402AAEDCFE611553C00047B77CE91443406C473A2E831453C0A0947A6AC311434016AD33562C1553C0381F610985104340E25AFE8DC71553C0C8064CF9730F434002D97CD3491553C02C04258B8F0B434063C133BDFE1453C0943AE33DBF094340CCCABA08DE1453C0586FB4202A084340A0D9CAB8BA1453C047ED149E9C0543403E85EB9D861553C098FC33F0D40643409246F96D7B1653C0B8D24E8157074340AC63E6AC561953C0F8BDF5EA2E0D4340B2692A93931A53C093DAFEBBDC0D4340F22CC511C81B53C0E0F3240CEA104340D2707CE04F1B53C0F4FE9F075A144340C2607CD3BF1B53C094427AE05C1843404206D228311D53C09C8D258B7F1A4340C4AB277E221D53C0707479E05419434018837CD3CB1C53C0D02CD035661743407AA57CD3B71C53C0E419CF3586164340ACF97BD3DB1C53C0E819CF35461543401A837CD32B1D53C0BCC5CF3542144340A8B67CD37D1D53C0878D258B7F134340DD0A7CD3011E53C01CE8CF35CE114340AAF97BD3DB1E53C040877AE0B4124340BC607CD33F2053C0978D258B3F154340EE717CD3A52053C038D5CE35EE11434088C1D128192153C0AC5ECF35DE1043405CFB7CD3F52153C0B0C5CF35C21143405022277E122253C0A85ECF35DE1243403E43C6A3942253C014AFC2727314434052E141460F2353C0A49A1173831743405254EAB0072453C084BE8D116C194340D27EAD439C2553C03CEE2C72F61A4340F0C03BB7782753C05481A64E951C4340D406BA98342953C08CD87C10CD1C4340859CEED7652B53C0003B6B150F1E43400E66F59CA12C53C054BE79E1761E43407E2176694D3053C0A71E9112221D43406A9347F3C43153C0DC470242681E434019FF932C783353C0084858B476204340D4C77CD3433353C0985ECF355E234340BC607CD3BF3353C02FB6D03516254340643E7CD3F33353C004CC7AE04C2643405422277E323453C0F8CB7AE00C2B43407AA57CD3F73453C0304FD035722E43405EFB7CD3553653C060A3CF35F6304340A028D2285D3853C018E8CF350E334340061C7CD3C73653C074BF248B772D4340F9FF267E263653C0780AD0355A2A4340623E7CD3B33553C068557BE0BC264340C34696B5B53553C064D31F7BEC204340C2C8C1BB683753C00015368CCD224340FEB7FA93533953C064F210E425244340C95E61E7043B53C0EFD5FDEC522543400E8740E91C3B53C0DC6CE9014E284340C88161D0B43C53C05059566C5C2A4340035821CE4B3E53C0D7B4DFD5102C43403F5CAFD2253F53C0ACE6B5C3732F4340C8F238B6E54053C0788BB0508738434009C1F098614153C0A3034E000F3B4340E8E3D128054253C0A85ECF359E3D43405622277E124253C0985ECF355E3C4340AAF97BD33B4253C098F7CE353A3B4340A028D2287D4253C0D048258B273A4340944F7CD3D94253C00C81CF352A3943408AC1D128D94353C0780AD035DA36434030EA7CD3AF4453C0AC5ECF35DE354340EB620D890E4653C098F781F0503443400CFFFFEBBB4653C02FF404E0A4344340DE0A7CD3A14653C0A45ECF359E374340A228D228BD4653C0E0FD79E004394340C0AB277E624653C0E393D0350A3A4340C0AB277E624653C08471D035FE3A434098DD267E9A4653C0E819CF35463B4340362D7CD3AD4653C0D42CD035663B43408CC1D128B94653C0E093D0358A3B43409D28D228DD4653C0985ECF35DE3B4340A9F97BD3BB4753C0403CCF35123B43405622277E924853C0E393D0350A3A4340D4C77CD3234853C0700AD0359A394340AE44277EDE4753C040B6D03516394340C2AB277E424753C00881CF356A3743405622277E924853C018E8CF350E3343401E837CD34B4953C0C4C5CF35C23143409D28D228BD4A53C0C4C5CF35C230434000D97CD3694B53C0304FD035F22F43402E6C209F084D53C0A85C3D3BA12E43400698BFF6D74E53C0DF98CB78E12F4340168B0A28565053C0287A22ED5E32434054148DEDC95053C0400812FF63364340CD900CC7805053C0B875B75FBC3943404C9D949D0C5153C0101C9D28863C43405EF72735175153C03CF694FF3D3F4340DC03687F735053C0901943CE7541434082397945DB4F53C0D0F15EB0F9424340FE4AD228494F53C04C3CCF35D244434030EA7CD38F4E53C0F835248B474743401CE8DD62624D53C0C0ED5CC7214743401247248BED4B53C098D977B745474340DC0A7CD3C14A53C0740AD035DA4943401E6FBBFB3C4B53C0649E5F52044A4340C6C314751E4C53C04021783FD8484340428B18E82D4D53C0F0993A9C74484340D41C367D154D53C02073448999494340DEE36DB4624C53C0E89ADE19BB4B43403A2D7CD3CD4B53C00C17268B6F4D4340663E7CD3734B53C0F019CF35C64D43401C837CD30B4B53C0D8FD79E0044E43403CBB267E8E4A53C02F4FD035B24E4340DA0A7CD3214A53C00881CF35EA4E4340924F7CD3B94853C0E093D035CA4E434076A57CD3174853C047D2258B174F4340B244277EBE4753C058D2258BD74F43408DC1D128594753C0FF35248B0752434002D97CD3C94653C09C427AE01C544340382D7CD38D4653C0C4C5CF35425643400E67277E2A4653C0D02CD035665743402E9FD128AD4553C074BF248B3758434018837CD32B4553C040B6D035D65843403F627AA9F54353C0A8009728445943405E65B4BBEB4253C088EF2E6BB059434087B171CF634253C013CFF9A01C59434065635921664153C0C7068E15065943400A5BEF41CC4053C07085AAF142594340A24BE8F6FE4053C0B801903BAE594340C3A20F478B4153C0C02252BC9259434012A44E7DF64153C0001F6CC0065A434090ABBF28384253C0F052DD42A85A434024E6AA23EE4153C0FC691CFE9B5B4340A20C6B16E74153C0D73FC0E89F5D4340765AD128954153C0483CCF35D25E4340342D7CD32D4153C098F7CE353A5F43409CC993DEB64053C0B0DCB7A6355F43404CD0C55DBF4053C02C1FEB1EA35F434067C6EA08404153C06817AF6038604340B56A5FBF8E4153C04073BD7798604340D46364C1CB4153C0D7838A9DF5614340C1562F70AD4153C09CD527D260634340EC3B34C95B4153C0586E731434644340002583DE264153C030E94E3B32654340F8929F7D5A4153C094DD8812E06543400C9A79BB774153C050A22016C16643406C52243BF83D53C0D0559C0E4F6C434026D89E35323A53C0F4ECD5014D724340B09C69EDC03E53C0C818D9E663794340363AE04CAF4253C0B8DEE55E817F43402FDCB8C90F4553C0705702D2B67B4340B268EA7DAA4753C038BEF9698F774340825F735F794853C080F8C03EAD794340C61EEEE1604953C05F65B8437C7B4340BC3461B3024B53C03C397E551B7C4340128094E6254D53C078E6B0884E7D434032B02E800F4E53C050A816EF947D4340F0A1C719F14E53C0487EE5BB497E43407ED02D805F4F53C0D4AF16EFF87F434024CE61B3A24F53C0F0134B2204824340007460B3065053C06C86B088C6834340444F61B36C5153C00C4117EF1C864340F49C60B34C5353C004AF4922B88743407242FA4C585553C0D88818EFA4884340EA93C719FB5A53C0F07418EF80894340704161B37C5C53C0A0504A22D48A434081F093E6C55E53C0445216EF788E4340FA2B60B3BA5F53C0B81B17EFDC8F4340B65C2D80936053C0405F4A2290914340505C61B3F26053C077824A22889343400434C719796053C0EB32E5BBB1954340508661B35C5E53C0F84CE4BBA198434066F4C719695D53C0103BE6BB959A4340ACD5C6192D5D53C098994B22349D43406E3AC719DF5D53C08CA47D55339F4340A8282E80255F53C03043B18812A043407C772E80976053C0579C7D55B7A043402AE093E6CD6153C04C907D5503A24340D6CBC719096353C0C012B18842A5434020DAFA4CBC6353C05C03E4BB45A6434064212E80A16653C0086A492260A74340E6AB61B3566953C0107E17EF14A943409A3594E6856A53C058C218EF70A94340B8D2C619C76D53C0EC56E5BB75A943404041C719056F53C0E8004B2260AA4340883D2E801B6F53C04C8F4B2270AA43405E3D2E80157053C000D1AF88EEAC434032C0FA4C187053C0E0C14B223CAF43404A7460B39A6F53C0044C16EFA0B14340368961B34A6F53C0A4894B22FCB343409AAD60B3D86F53C0C0BCB08826B64340907DFB4CC87253C0F8DFB0881EB843406AA82D80997353C0088717EF5CB943404AA360B33A7253C0105AB188FEBA4340405EC7199D7253C050C24A2294BC43408E3761B39E7253C0E46DE4BBF9BD4340DEFC93E6337253C0E43A17EFF8BE4340596AC719517153C0F848E3BB5DBF4340596AC719517153C00447E5BB3DC04340CC2361B3807253C038B917EF1CC043400EE4F94C947353C05BACB18896BF4340DA222E80857453C0F8407E559BBF4340DECA93E6537553C03CF716EF1CC1434087B660B3467553C070194C22F0C14340509C2D80E57453C0ECCAE3BBADC2434095862D80AB7453C0249EE2BBA1C343404E32C719177553C0E48417EF14C543404C83C719AB7553C0D8CEB18876C54340AA8DFA4C267653C0DCC44A229CC4434058A5FA4C7C7653C04819B18836C34340DAA92D80A37653C050F518EFFCC143405F17C819097753C050F518EFFCC143405E3BFB4CF67753C06BC84A22C8C64340AA37C719597853C07C447F552FC84340EA0794E6C37653C0402016EFD4C843409AAA60B3987553C048D0E2BB61CA4340B23394E6437553C0FCE1E4BB59CC434006A22D80337653C098E1E4BB4DCE434016A894E6D57653C0F4A77D55BBCE4340CC2861B3B67753C0A0167E55FFCE4340D080C7197D7853C048367E55CBCE43407898C719D37853C010517D55D3CD43408AE5C7192F7953C098C6B28862CD4340648D2D80F77A53C0C0717E552BCE43402663FA4CAA7B53C010517D55D3CD4340CFE5C619A77C53C014364B22E8CC43407123FA4C067E53C0A00B4C2200CD434012132E80797F53C0046FE4BBD1CD434070ABFA4CB08053C04CCE17EF18CF4340C298FA4C908553C054F716EFD0D643408BEB61B3828853C06C94E4BBC5D9434072EA93E6CD8B53C0E09C17EF24DA4340BC51C7198B8C53C088E74922C8D94340D96FFA4C248D53C0908CE4BB55D9434036D32D80A98D53C0400FE5BBBDD8434088BEFA4C908F53C020D117EF2CD5434019FFC7194F9053C09403B2883ED44340CE2FFA4C749153C048E3B088F2D143404C4694E6EB9153C0BF8F7D5553D14340583DFA4C329353C0F8247D5547D14340C869C719C79553C010237F5527D243404C28C7190D9753C00C454B22B0D143408C4261B3B69853C0C0744B2268D043402A1F2D804D9953C0880A7E554BD0434002D893E68D9A53C0C45AE4BBA1D04340D8CC2D801D9B53C0C33717EF8CD04340D2C62D80C39B53C0708BE5BBE5CF4340E6832D80FF9953C0F8494B220CCC43409F64FB4CD09A53C0B8427E558BCB4340B27C2E800F9C53C0ACDD16EF84CB43403A4C94E6199D53C0F80B4C220CCB43404ACDC7194F9D53C054CF17EF3CC9434046D661B3089C53C0F42E4B2290C84340CAFC60B3B89B53C02441B288E6C74340B8232E80059C53C03C4DB2889AC643405A7C2E80039E53C0C84A18EF4CC4434098CE2E809BA253C0B8A67E554BC54340868D61B3CAA453C064C87C5537C4434087CAFA4CF2A453C0B373E3BBB9C34340C637C81929AA53C0185B4B221CC54340BA4CFA4CBAAB53C0EC0BB088EAC54340FEBD2D8009AC53C070794A2250C64340F205C8194FAC53C0104C4C22BCC6434087C0C7195DAD53C0F86A7E55DFC74340A839C719B1AF53C07FD17E55A7C9434040FC61B3E8AF53C00488B288E2C943407C1EFA4C0CB053C0D09717EF14CA4340BF62FB4C68B053C0E8D116EFDCCA43401EDFF94C74B053C06BD6492204CB4340085661B37CB053C0C0C84B223CCB434096FF93E67DB053C08F0C492294CB43407AA32D8079B053C0C0B44B2218CC43406495C61961B053C0F056B18892CC4340F0D42D8047B053C014364B22E8CC43407B41C71921B053C07C1BB18832CD4340D09C2E809BAF53C0B79FAF88AECD43400679C71949AF53C0C8D9E4BBDDCD43400CD0C71937AF53C040A1E3BB29CE434014BD61B356AF53C0B73DB0889ECE43407A27FB4C0EB053C0081FB1885ECF4340FCB061B3A2B053C0183F492260D04340C64FFA4CD4B053C0585818EFE4D04340F8122D8047B153C007827F558BD143401EA2C71995B153C0A83919EFA4D14340FE84FA4CD4B153C07CDBB08882D143401C27FB4C02B253C0A0C74B2218D143407C1FC7192DB253C037197D559FD043402A1DFB4C70B253C07BF34B2298CF4340267F61B3C8B253C09856B18886CE4340FC2561B3B8B353C0C42918EF50CC4340062DC719EBB353C010A0AF88BACB4340C699C71913B453C0245FB1880ECB4340C86394E61DB453C0507118EF64CA434055F3FA4C0CB453C05CE1E3BBD9C94340681C2D80C7B353C00812E5BB1DC943402E1461B3B6B353C0C03EB088C2C843407D8394E6E9B353C01030B1886EC84340E68BC71949B453C09808B18832C8434030162D8067B553C0B42FE3BBD1C74340807BFB4CBCB553C0E80117EFA0C7434005BDC7190BB653C00BED4B2258C74340D0BD61B348B653C0FB6017EF04C743404C3561B38CB653C090B8E5BB95C64340244EC719C1B653C0F0E5E3BB29C64340910F61B366B753C0C89C17EF70C44340CD55C7192BB853C07B11B188C6C24340E443FA4C00BC53C00CEBB088AEBC43408182C719A3BC53C0BC114B2218BB4340DCFF61B3EEBC53C05F28E5BB95BA4340CC37FA4C4CBD53C0940EE3BB21BA4340EAD1FA4C04BE53C028C6B288A2B94340AA6A2E808FBE53C060EAE5BB95B9434016E62D800BBF53C0D47D4C22BCB94340C25F94E6B9BF53C0E700E5BB59BA43408ADD61B3EEC053C0106D7E5527BC43408A7461B3F8C153C0D8F2B0881EBD4340984FFB4C10C353C09CFEB088C6BD4340B8642D80A7C353C0B874E3BBDDBD43405AD72D8023C453C054D517EFBCBD434058E160B392C653C0644C7D55CFBB43400EA060B3DEC653C040CDE4BB69BB4340B59493E61FC753C048CCE3BBDDBA4340F092FA4C52C753C033E9492250BA4340EBD294E621C853C03F194A2214B74340F60F2E8049C853C0B81DB388A2B6434064F393E677C853C078B6E4BB31B643406C5CFB4CB6C853C084497D55BBB54340066694E6F3C853C09811E5BB5DB54340ACD7FA4C2CCA53C0780117EFE0B343408C092E80E3CA53C0A8F84B224CB24340AC15FA4C2CCB53C02468E4BBD1B14340B8982D807DCB53C0C8D07D5573B1434009E5C61979CE53C088BE7E55F3AE4340C592C71949D053C098C017EFCCAC434065D8FA4C1ED153C058CD4A2270AB434066AD2D8093D153C09F66E5BB55AA43408608FA4C54D253C018D3B0889EA74340EC2C94E695D253C0BB787E551BA743401652C81915D353C0F00418EFC0A6434047BFC719BBD553C08370B0880EA6434056D894E63DD653C0484317EFCCA54340F062C71965DD53C0843B7E55CB9B4340F3132E8035DE53C0F801B288F29A43404CEA2D80D7DE53C04C8FB188769A4340E3FCC71917DF53C070834C227C9A434098E6F94C3ADF53C0E86D18EFDC9A4340AAA5FB4C8EDE53C038FFB28862DC43405C6D94E62BD753C038FFB28862DC4340462C2E80C9CF53C0584016EF60DC4340,-22.3%,-159,555,119,436,Maryland,true
28,0106000020E610000001000000010300000001000000A4030000429BB1750B035AC0CCD9741A0E7F484011652E80F5025AC00C9FE5BBB1664840929D94E6F5025AC04042B18856514840929D94E6F5025AC074E57C55FB3B4840929D94E6F5025AC024774A22A0264840929D94E6F5025AC04CA9492244114840929D94E6F5025AC0E4C94A22E8FB4740929D94E6F5025AC0885B18EF8CE64740929D94E6F5025AC02CEDE5BB31D14740929D94E6F5025AC06090B188D6BB4740929D94E6F5025AC094337D557BA64740929D94E6F5025AC038C54A2220914740929D94E6F5025AC06C6816EFC47B4740929D94E6F5025AC010FAE3BB69664740929D94E6F5025AC0B48BB1880E514740929D94E6F5025AC0571D7F55B33B4740929D94E6F5025AC090C04A2258264740929D94E6F5025AC024E14B22FC1047404AA12D80DF025AC0B011492294F84640036F93E6D3025AC00C5E19EFB0EA4640EBC22D80C7025AC0346E17EFCCDC4640564F2E80BB025AC0C0DDE3BBE9CE46408FE42D80AF025AC04B4DB08806C14640F8702E80A3025AC048AB7E5523B34640A9CDC71997025AC0C438B2883EA54640699B2D808B025AC06C8A17EF5C9746406FF22D8079025AC0989FB188F6884640AF51FA4C78025AC0EC8A4A2298814640F68394E683025AC0048EE4BBFD7F464071FCF94CA0035AC0AC937D5503804640E2FFC71957095AC0AC937D55038046400F9E93E64D105AC0AC937D55038046409F2A61B344175AC0AC937D5503804640C45760B33A1E5AC0AC937D55038046404D7361B330255AC0AC937D550380464074112D80272C5AC0AC937D55038046408BD660B31E335AC0AC937D55038046401AF261B3143A5AC0AC937D5503804640BA57C7190B415AC0AC937D550380464050E494E601485AC0AC937D5503804640F149FA4CF84E5AC0AC937D5503804640069E61B3EE555AC0AC937D55038046405F332E80E55C5AC0AC937D5503804640BDC8FA4CDC635AC0AC937D5503804640952561B3D26A5AC0AC937D55038046407382C719C9715AC0AC937D55038046405850FA4CC0785AC0AC937D550380464062A461B3B67F5AC0AC937D5503804640080AC719AD865AC0AC937D5503804640989694E6A38D5AC0AC937D5503804640BDC393E699945AC0AC937D5503804640D588C719919B5AC0AC937D5503804640651595E687A25AC0AC937D5503804640854294E67DA95AC0AC937D5503804640639FFA4C74B05AC0AC937D55038046403AFC60B36AB75AC0AC937D550380464051C194E661BE5AC0AC937D55038046402F1EFB4C58C55AC0AC937D5503804640CE1294E64DCC5AC0AC937D5503804640E5D7C71945D35AC0AC937D55038046403E6D94E63BDA5AC0AC937D5503804640959194E631E15AC0A0B1E4BB018046406CEEFA4C28E85AC0904018EF00804640434B61B31EEF5AC0904018EF00804640A9E02D8015F65AC0904018EF00804640813D94E60BFD5AC0904018EF00804640D86194E601045BC0904018EF00804640BE2FC719F90A5BC0904018EF008046404DBC94E6EF115BC0904018EF008046406DE993E6E5185BC0904018EF008046407B3DFB4CDC1F5BC0904018EF008046401CA360B3D2265BC0904018EF008046403A6894E6C92D5BC0904018EF0080464012C5FA4CC0345BC0904018EF00804640E82161B3B63B5BC0904018EF0080464048B72D80AD425BC0904018EF008046409FDB2D80A3495BC0904018EF0080464085A960B39A505BC0904018EF0080464015362E8091575BC0904018EF0080464033632D80875E5BC0904018EF00804640CBEFFA4C7E655BC0904018EF00804640E2B42E80756C5BC0904018EF0080464001E22D806B735BC0904018EF00804640916EFB4C627A5BC0904018EF00804640BF0CC71959815BC0904018EF008046404728C8194F885BC0904018EF00804640ED8D2D80458F5BC0904018EF008046407D1AFB4C3C965BC0904018EF00804640DCAFC719339D5BC0904018EF0080464033D4C71929A45BC0904018EF008046405901C7191FAB5BC0904018EF008046406AC6FA4C16B25BC0904018EF00804640C85BC7190DB95BC0904018EF008046402080C71903C05BC0904018EF00804640A1F9F94C40C35BC0904018EF00804640A1F9F94C40C35BC02B2417EFEC7D464099912E8041C35BC0DBA7E5BB097A464099912E8041C35BC0333DB28826764640A102FB4C42C35BC01C73B088427246402E3B61B342C35BC078087D555F6E4640AE73C71943C35BC034FD17EF7C6A4640EEDB94E643C35BC08C92E4BB99664640F64C61B344C35BC0E8987D55B76246407D85C71945C35BC034BD7D55D35E4640FEBD2D8045C35BC0EC404C22F05A4640062FFA4C46C35BC05447E5BB0D574640CBCF2D8047C35BC0B04D7E552B534640CBCF2D8047C35BC07C12B088464F46400B38FB4C48C35BC0547817EF644B464013A9C71949C35BC0A09C17EF804746401B1A94E649C35BC0ECC017EF9C4346401B1A94E649C35BC044C7B088BA3F46404FCD2D8019C65BC000B1E4BBD9404640805B2E8023C75BC01C064C22F4414640BB9194E6FBC85BC0D85117EF4C4546401AB794E615CA5BC0F0857D5503484640668893E6EDCA5BC0F4127D557B49464021ED93E69FCB5BC097A0E5BB494A46406DBD2E809BCC5BC0FC517D55074B4640DEA9FA4C18CD5BC048DC18EF8C4B4640BAFFF94C74CD5BC0CFFA7C55134C4640EE8C94E6A5CD5BC0E84EE3BBA14C464029B82D80CBCD5BC034EA4922384D4640478760B3ECCD5BC0F4074C22E44D46409E9B93E6F9CD5BC038ACE2BB614F464041E060B3F6CD5BC0403918EF4050464016BC2D8003CE5BC0B0904B2218514640A104FB4C38CE5BC0B03AB188025246409FB660B398CE5BC0FBD517EF9852464001CA94E615CF5BC084547D550F534640DFD8FA4CB8CF5BC0EC0EB18882534640F273FA4C00D05BC01034E5BB01544640CE9EC71985D05BC024077F55A35546408D0CFA4C1AD35BC008A67D558F5B4640B2332E80B5D35BC024EBE4BBBD5D4640DE1B2E8059D45BC0A09017EF805E4640211261B3AAD65BC08CF6E4BB59604640E55AFA4C7AD75BC0AF52B088AA6046403C0E2D8007D85BC058B84A22A06046409B8BC71953D85BC00CF2B1883260464025F9C61905D95BC0F4D87D55675E4640E3FB60B35ED95BC06B4816EFEC5D46405AF12D80DDD95BC084A417EFA45D4640C98F61B3B6DB5BC03CEF4922485D464055BEC71925DC5BC054EB4922105D46400BCCC719E9DC5BC058397F55635C46409316FA4C86DD5BC078D07C55775B464079592E80B5DD5BC07BBEB088DA5A4640B16AFB4CC8DD5BC04765E4BB355A4640322794E6A9DD5BC018AC16EFA059464092FC2D8073DD5BC000DB7E5517594640FAE993E633DD5BC088BBE3BB9D58464045DD94E6FBDC5BC0F419B18812584640C3D861B3D4DC5BC0501317EF80574640824DC719BFDC5BC08C5516EFC4564640DE11FB4CC4DC5BC0900FB28802564640DA84C719E1DC5BC0CC51B18846554640C0D8C61921DD5BC0C48019EFBC544640452394E671DD5BC040844B22585446405C10FA4C26DF5BC034757E5567534640D2E9FA4C76DF5BC0A09617EF0053464046CD60B3A4DF5BC0606C7D556B5246405561FA4CBADF5BC0A39CB08812514640019361B3D6DF5BC060134C228050464081A0FA4C4CE05BC0784A7E550B4F464008552E806BE05BC054B07D55534E464091A760B37EE05BC038767E558B4D4640EE1294E679E05BC084B87D55CF4C464008552E806BE05BC06C1218EF1C4C46406A9B94E635E05BC0144E7D55CF4A4640284F2E8017E05BC08CAC4A22444A4640D888FA4CF6DF5BC0D01A7D55EB4946405C2BC719C5DF5BC0C8004C228C4946404B0194E67DDF5BC0F0277E552B4946404DD560B31ADF5BC05BDDB088DA484640F96EC719A1DD5BC0A81FB0881E4846402DFB60B346DD5BC0B0057F55BF474640EA8B2D8013DD5BC044AB4C223C474640F2FCF94C14DD5BC05C1B18EFB04646403E02C71979DD5BC048FB492248464640072F94E619DE5BC0980F18EF08464640AAB360B332DF5BC00C8816EFDC454640392861B3CADF5BC07C99E5BBF1454640F783FB4C2EE05BC0F02C4C2218464640182FC719F7E05BC06CE34922EC464640F275C719F3E25BC048894A224C484640F5D62E80BBE35BC03C1019EF8848464078392E80B7EA5BC0BCF17E559B484640147860B3A6EB5BC090D5B0886A4846406D512D8085EE5BC0CC78E4BB994546402AADC719E9EE5BC0D85117EF4C4546408058FA4C00F05BC0883D7F55F34446403CD8C71951F15BC0788618EFC8444640619DFA4CE0F15BC05C3B18EF88444640EAD5C71929F35BC02479E4BBA5434640962C61B3C2F35BC04C2C4B2298434640DD4BFA4C3AF45BC0B45FB088CE434640F548FB4C8EF45BC0E8D2E3BB39444640BB4094E6C9F45BC040CE4B22C0444640F5CD2E80FBF45BC0D85117EF4C454640B60461B37AF55BC090A7B18856464640D1E5FA4CECF55BC060D27E55DB464640027EFB4C88F65BC02C7A7D555B474640F516FB4CAEF75BC0340F18EFFC474640F05FC71961FA5BC038D2E3BB214846402A1995E6F5FA5BC05080E4BBFD47464029EEC7196BFB5BC09423E6BBBD474640593E2E80C1FB5BC02C7A7D555B474640D84BC71937FC5BC0186CB188F6464640B7B32D80E3FC5BC00481B288A646464087A2C71919FE5BC0D8D04A2260464640724E2D801FFF5BC0848D4A2290464640B5862D8039055CC0981F18EFF4444640DAAD61B3D4055CC0542A17EF10454640C451C71965075CC04375B288FE45464057F360B338095CC0843F4B22A44646400B8694E6690A5CC0182617EFCC464640DE5AC719D90B5CC014034A22B8464640FDF4C719910C5CC0B4BAE3BBD1464640050594E6110D5CC0F06A4B22184746405E7C2E80030E5CC0003DE4BB2D484640DDD8C719F10E5CC078AE7E55CB48464089D660B3800F5CC078AE7E55CB484640C6C361B3EE0F5CC0308D4A2284484640016B2D807F105CC0F8DC18EFA4474640E0202E80CB105CC0639EB0884E474640C563C71947115CC034D118EFFC464640B7DAFA4CE4125CC004184B22684646400B6360B3E6135CC0F894B288CA4546401DDC93E6A5145CC0E48E4B2228454640065360B3FA145CC040CE4B22C0444640A5DFC7193D155CC0201AE4BB414446408B69FA4C72155CC0DC4F4B229C4346409829C719EB155CC0D0127F55974046409272C71909175CC0D081B188563C4640AC3995E667175CC0384CE5BBB53B4640FB72FA4CF2175CC04CB04B22303B4640C9CBFA4CF6185CC0FF25B088AA3A46405AB3C719AB195CC0ECC17F55973A4640302E94E6371A5CC0A06C7D55C33A46406748C719991A5CC09427E4BB253B464095CE60B3E41A5CC0A876E4BB9D3B46401A8CFA4C521B5CC0241817EF283C464053ECC719DD1B5CC09C66E4BBB13C4640CFE0FA4C181D5CC0C0084A222C3D4640553D94E6051E5CC07891B188363D4640170361B3CC1F5CC09CAC7E55DB3C46406B79FA4C32205CC09B5E7F55EF3C4640C8A6FA4CC2205CC0549E17EFBC3D46408538C8191B215CC0F47C7E55233E4640FC7B94E685215CC0981AB188763E46408B59C7195D295CC0B8E94A22E03F4640D28C2E80892B5CC08C1D7E55B3404640162194E6392C5CC05CE87F55AF40464079FE94E6C12C5CC0FC24B08886404640D0F9C619E12D5CC05C23B288723F4640061DFB4C442E5CC05CBA4A22343F46401FF7FA4C18305CC0FC8A4A22883E4640FA55FB4C76305CC0BCE77E552F3E464041F594E621345CC090907D55D338464013B7FA4C68345CC044A717EF503846406C61C719A7345CC090A07D55BF374640360961B3DA345CC0242FE3BB21374640229A94E6F5345CC0385FB18876364640A8C9F94CF4345CC084127D55BB354640AE062E80CF345CC07C1E18EF1C354640021195E6B5335CC048854A2260324640EDCEFA4CC4335CC0A0BBE4BBA9314640FF69FA4C0C345CC028B6B088F63046402A872E8015355CC0C8F216EF343046404F4C61B3A4355CC0905D17EF403046407E45C7190D365CC0307E18EF9830464051EDC71989375CC0405BE3BBAD334640C14CFB4CD6375CC01863E3BB1D344640871061B338385CC0D8657D5577344640FCEC93E6113B5CC068EE4922C83546408874FA4C8A3B5CC07C7FE4BB31364640CD5FFB4CDC3B5CC02BB1B0889A3646401306C819DD3C5CC01F6EE3BBAD384640667C61B3423D5CC034517D553B394640765FFB4CD03D5CC0CC637C55C7394640A83DFB4CE23E5CC0FC1C4A225C3A464045CAC719713F5CC0D8D64A22E03A4640101B61B3B63F5CC0387717EF8C3B4640A49761B3C43F5CC04CE6AF88063D464073CC2E80DB3F5CC050F9B288963D4640228B93E673405CC0D8ADB2884A3F464077A8C71983405CC0FFEF16EFD43F464061BD2D807F405CC03CA5E4BB31404640410161B33E405CC0687CE3BB5D4146408F39FB4CA43F5CC0CC7517EF5C434640473D94E68D3F5CC09804E6BB09444640CA0B94E6BF3F5CC040CE4B22C0444640C16FFA4C34405CC08409B188664546408FC8FA4C38415CC09C43B0882E4646405CD2FA4CC4415CC0C01AE5BBC1464640E11CC81915425CC0E402E5BB654746402F672E8017425CC05BDDB088DA484640FF9BFB4C2E425CC01C78E4BB81494640099A60B35E425CC050C0E5BB154A46403E5DFA4C1A445CC0E8B74A22E04C4640A42894E651445CC0C853E4BB654D4640B3BC2D8067445CC014EF4A22FC4D4640EB5A2E805D445CC09B427E559B4E46404527C71925445CC0E05A16EF2C4F46407A6561B3DE435CC0009EB188AA4F464029B02E8035435CC0A88AE4BB75504640099B61B3EA425CC02B1B4C22F0504640C79CFA4CB8425CC080157D5583514640470B94E6AD425CC04CA44B2230524640C2ECF94CC0425CC0E35CE6BBD5524640501BFB4CE2425CC034864922785346409D17C71945435CC0FC6318EF9C544640268EC719F9435CC0583D7E5533564640776EC7192D445CC0FCB4E4BBC5564640924F61B39E445CC05097B088AA584640F1502E80CB445CC03C5617EF44594640E6C5FA4C04455CC0C4F74922D05946401EB5FB4C8E455CC0DC0617EFC05A4640F88E2D80CB455CC0B8B4B2884A5B464041AE61B3F6455CC0FC3D17EFDC5B46408A4AC7191D465CC03097E3BB815C464092DE60B332465CC080E44A222C5D464032E6F94C54465CC08879E5BBCD5D4640887FFB4C82465CC0B832B388625E4640527794E6BD465CC024FEB188E65E4640D16261B3AA475CC0D4BB7C553B6046408C422E80EF475CC00370E4BBB9604640A89FFA4CCC485CC0787F4922E0624640C0EAFA4C0C495CC0B4274C226463464010A12E80414A5CC094997E5537654640657894E6BB4B5CC0E8294B22F8664640D15F61B36A4D5CC034777C553B684640F448C719E74E5CC038E94922C8684640984761B302505CC074A116EFD06846407AC02D8073505CC02832E3BB9D684640CE36C719D9505CC0C0EDB2885668464099AA2D8033515CC0203E7E55FF67464041E660B376525CC05B427E5543664640F83AFA4CF4525CC0A01C17EFD4654640F95EC81995535CC0A8074C228C6546404AB3FA4CBE545CC0280319EF64654640AFAAC71959555CC05430B288A6654640C96894E6B5555CC023D8B0882666464036DB2D80E3555CC0A4F917EF506846400D4B94E605565CC0BC704B22F46846407F9961B38E565CC070AB7D55AB694640A767FA4C6C575CC06C9217EF706A46408966C7196B5A5CC02426B1887A6C46407ED393E62D5B5CC0C04116EF546D4640C66EFA4CC45B5CC03FF64B22706E4640594D61B32A5C5CC0A3D316EF906F4640A6982D80055D5CC0BC457C5547734640B83E2E806B5D5CC0F4FF4A2268744640CE6FC719E55D5CC08C0280556F754640700595E6755E5CC0908E7E555B764640B3C4C719B15E5CC024A17D55E7764640FD102E80CF5E5CC0E49BB2887E77464075B5FA4CBA5E5CC0EC1E4B221C7846405473FB4C7C5E5CC08C207F55977846407564FA4C265E5CC05C05B288F27846408E22FB4CEE5C5CC0BBEB18EFC8794640891094E69D5C5CC060AC18EF307A46403116C819575C5CC0F34D4B22BC7A4640676E2E80235C5CC02818E4BB617B4640086D61B3F65B5CC0305F7F55177C4640E6E4C7198F5B5CC05CA1B188327F46405EE294E6835B5CC0E8287D55F77F46407535FA4C865B5CC0789E7C551F804640C6C7FA4CCE5B5CC0AC737D552B824640168E2E80EF5B5CC0D45B7D55CF824640C781C719ED5C5CC03CB77E556F8646402FE3FA4C565D5CC040B8492294874640047AFA4C5A5F5CC0DC2BE3BBC58B4640726661B38A5F5CC0E03EE6BB558C4640BE6B2E80EF5F5CC090B818EF988E4640FC4F2E805B605CC080027D55938F4640585A61B3D6605CC0A0704A22E88F4640523A61B3FE625CC0A05F7F55D78F4640DA6AC71989635CC088744A2220904640986460B3E0635CC03CC9E3BB9D90464067992D80F7635CC0FCE6E5BB49914640CACE2D80FD635CC010087F55D792464037E8C61921645CC038DE7C5577934640019961B356645CC09FBB7D55FF9346405DFC94E6DB645CC0CCCFB0880695464051A794E609655CC038BE7C559F9546400641C71925655CC0E86AB2884A9646402967FA4C34655CC0903418EF00974640AB3EFB4C68655CC094EC4922509846408A0762B394655CC0908D4922EC9846403A392E80FD655CC0C8C44922089A4640EB12FB4CE8665CC040B117EF809B46401D98FA4CF0675CC0305318EFA89C4640BDB260B33A695CC077BCB288CA9E4640A98A94E6576A5CC08C567D551BA046405E4994E6A36A5CC013BCB288BEA04640FC002E80BD6A5CC0001B18EF68A1464051A494E6C96A5CC0403D17EFD4A2464059882D80E76A5CC04C54492288A34640D0612E80376B5CC02854E4BB35A44640EC92C719B16B5CC0E8E2B288E2A44640553BFB4C1C6D5CC010D4E2BB6DA6464053B72D80876D5CC050FE7C5503A74640C2F393E6BF6D5CC0441DE5BB8DA74640D91BC719EB6D5CC040BEE4BB29A84640FE9AFA4C046E5CC0B898B0889EA94640132D94E6FD6D5CC0283EE3BB61AA46408146C819D56D5CC01CAD4C22F0AB4640FA9194E6B56D5CC0AB5F18EF1CAF46405656C819BB6D5CC0C00FE5BBA9B04640AFF793E6F76D5CC0306718EF80B1464092432E80756E5CC068174A2260B24640380695E641705CC0C0627D5583B44640C2F761B388705CC0F4B3E4BB65B546400DAC93E6A5705CC0BF8817EFD4B64640C5A7C719CD705CC01C1819EF70B74640902C94E6EB705CC05071E5BB15B84640B9A9C719E9705CC0B0347F55D7B84640D59261B3D0705CC020E616EF94B94640E23761B3AA705CC018BCE5BB49BA4640A4A360B346705CC0C808E4BB9DBB46409BB6C61927705CC054617D5553BC4640BD722E801B705CC007AEB1880EBD4640A4A360B346705CC084AC4B2224BF4640F2F6C7194B705CC0BC39B088EEBF4640A4A360B346705CC02C6E4C2218C0464089E694E675705CC0688F4A22F8C04640E10C94E61F715CC0D8867C55DFC14640836594E61D735CC064814C2224C34640E0BFC619A1735CC01C0A7E55C7C34640B13A2E80E1735CC0ECA917EF84C446404D052E80DB735CC077B4B1884EC546403D4EC719B1735CC028AB4B22F4C646408D8FC71965735CC030384B226CC84640CB58FA4C32735CC054204B2210C9464052F260B3B2725CC0F0334B2228CA46401E6EC71983725CC040407E55BFCA4640C15994E675725CC0AC5117EF6CCB4640517F94E695725CC0C4EB17EF24CC4640552FFA4CDA725CC0144A4A22E0CC46402242FB4C68735CC084C44A22CCCD464087BDFA4CE4735CC0547E4B2250CE4640E2202E8069745CC0BC867E55AFCE46402C5560B3BA775CC0008F16EF54D04640C40FFB4C7C785CC05C1E18EFF0D046402DC12D80ED785CC0C8A07D559FD1464021732E8001795CC068CFE5BB09D34640F768C71921795CC0A00A4B22B0D3464074C6FA4C52795CC05011E5BB41D44640668D2D80F77A5CC0C08CB08852D6464037E694E6437D5CC044657E55A7D84640F9E994E6757E5CC098867C5587D94640E15861B3547F5CC01B77E5BBF1D94640594C2E80B77F5CC08C7E17EFC4D946402A44C719F37F5CC0A4694C227CD94640D0C52D8017805CC0BC014B221CD94640649B2E802F805CC03FAE17EF7CD84640896861B334805CC00C327E55C3D74640649B2E802F805CC0949D16EF10D74640179FC71919805CC0A8FC16EF74D64640061E94E6E37F5CC0F07B4A2294D54640AEB961B3CE7F5CC004BDE3BBF9D4464059F52D80C97F5CC0EC57B2885AD446403F8661B3E47F5CC0141BE3BBD1D346404E34C7190D805CC0B72918EF8CD346407C6A61B350805CC070BAE4BB59D3464095C893E605825CC01C454A2284D246403618C7196D825CC0348F492238D246404365C719C9825CC05C394A22DCD146400E802D8019835CC07FC07D556BD1464074A4C7195B835CC04C8A7E55DBD04640F45860B3C6835CC0E45417EF8CCF4640437894E6F1835CC0C0BA16EFD4CE46402402C71927845CC0FCC018EF30CE4640F5732D8065845CC0E8CB7C559FCD4640724D2E80B5845CC028474B2234CD4640CFC22D80D7855CC0B81A4A2234CC464014A52D8027865CC0340DB188BECB46401D0594E663865CC070B3B1882ACB46407C0661B390865CC05CAD4A2288CA46402988C719B5865CC0B495E5BBE5C94640911D2E80F7865CC078EDE2BB61C946401D29C71951875CC0A808B08806C94640C579C719D9895CC04CE14A2284C7464083362E80518B5CC0BC35B1881EC646406656FA4CB88B5CC0F0734B22D8C54640D1D1F94C348C5CC0F0507E55C3C54640499294E6498D5CC0B8CC4922E0C546404A3194E6C98D5CC028F74822C8C54640F96B61B3348E5CC0FCC9AF8886C546408CF1C719918E5CC0F43EB28826C546403CB0C719DD8E5CC06CAE4A22ACC44640F78F94E6218F5CC0741E16EF20C44640168294E6578F5CC09871B1888AC34640A81061B302905CC0E4194B22D0C0464001142E804B905CC078F6AF881EC04640E5DA94E65B905CC058807D5507C04640306494E6A1905CC0C8C4E3BBB5BF4640CC6D94E627925CC074B7AF8892BE46405D822E8083925CC018A317EF38BE464058712D800B935CC01029E5BBE9BD4640F0C9C619C1935CC058E916EFB4BD4640177F94E617955CC03C4D18EFDCBD4640767861B3CE955CC040567E552BBE46403C5F94E645965CC0F0AA17EFA8BE4640DCE2FA4C86965CC084AC4B2224BF4640E826FA4CE0965CC03C9EE4BB05C0464014FEFA4C08995CC0D4D5B288BEC146406C24FA4CB2995CC0D016B1886AC24640A3972D801D9A5CC084D4B18826C34640326D2E80359A5CC0005717EFD4C34640B4C160B3649A5CC0B41418EF90C446401600C719B99A5CC0F3D24B223CC546403F0DFB4CD69C5CC05CD5E5BB89C74640C8D1FA4C769D5CC060DE4B22D8C74640556594E679A05CC0E0944922ACC84640F52FFB4CBCA15CC0D0B2B088AAC8464079C2C7199FA25CC06C1C4B22D8C84640D33661B3E8A25CC0676B4B2250C946409A7E94E6DFA25CC008DE4B22CCC94640C2642D801FA25CC08F6F7E556BCB46409A5A61B3F2A15CC0F00F4B2218CC464092C6C719DDA15CC078157F55CBCC4640B7B6C719F7A15CC01F617C5593CD464002E7C61933A25CC09C897D555BCE4640390AFB4C96A25CC0FF73E4BB69CF4640C1B52D80B3A25CC028134B2238D04640CDB32D8097A25CC00401E4BBE1D04640184E2E8055A25CC0C83716EF60D1464032012E80FFA05CC084824C22FCD246406FAF93E62DA05CC0FC874A2248D446407F0D95E601A05CC0543D18EFA4D4464013EBFA4CDC9F5CC014C2492210D5464076DA60B3B89F5CC0547B17EFA4D54640E60D61B3A29F5CC0A3394B2250D64640D122C7199F9F5CC0146EB18812D746408638C719D99F5CC004E57F5563D84640F2DE93E6DF9F5CC0CB4F4A2208D94640667CFA4C989F5CC0200F7F553FDA4640597EFA4CB49F5CC09066B28816DB4640818061B31EA05CC01CA5E4BB05DC464061CDC619C1A15CC0BCEE7E555BDE46409DF0FA4C24A25CC0AC524A221CDF4640D11B94E649A25CC033A67D55BBDF4640BA9260B39EA25CC0F3244C227CE146406B49FB4C28A35CC084FB17EFB8E24640743695E647A35CC03B7CE4BB99E34640AC7294E631A35CC028CFE4BB49E4464013962D80E7A25CC020AD18EFC0E44640F5CEFA4C3CA25CC0ABE6E4BB99E54640053761B3EEA15CC0FC4017EF1CE64640183361B3B6A15CC0F4F318EFBCE646406AE72D8087A15CC000A6E3BB69E74640D7B8C71919A15CC0F0CAB28896E84640297594E65FA05CC0B302B0883AEA4640E94295E607A05CC06C7B17EF58EB4640EABDC619E79F5CC01CFBE2BBADEB4640B4E92D80AF9F5CC06862B1881EEC46403CAEC619079F5CC03C7317EFDCEC4640830B2E809D9E5CC078117D551FED46400C6660B3269E5CC0DBC24A2244ED464091FDFA4CF69B5CC0347418EF68ED4640C29CFA4C7C9B5CC0B4784B2290ED464070CD60B30C9B5CC0009A7F55D7ED46401CB0C719B19A5CC0D8EF7E5533EE4640AA23FB4C28995CC024DBB08866F046406E7C94E6E3985CC0384D7E55F3F046409F47C719CD985CC0889F4B22B4F14640C537C719E7985CC06B0717EFACF24640810794E63F9A5CC0C00EB288BEF546406EBB94E66F9A5CC0BC914A225CF6464021AEC719959A5CC0C414E3BBF9F646403F632E80A39A5CC04C2C19EFB0F7464021AEC719959A5CC02BAE4B2270F846407DF62D807B9A5CC044E84A2238F9464066CEFA4C509A5CC034AC17EFE8F946400EF8FA4CAE995CC094DCE2BBB9FB4640C6A293E68D995CC0E42EB0887AFC46400DD52D8099995CC08C1BE3BB45FD4640EE312E80DB995CC0DBAEE4BB19FE464066CEFA4C509A5CC0640A7D557BFE4640595FFA4C009C5CC030994B2228FF4640FB71FB4C889D5CC0C066B18816004740440461B31C9E5CC0F7F315EFE0004740FFC961B34E9E5CC02CA57E55B30147407E0C2D802D9E5CC034DA17EF640247403C8A93E6199E5CC040A34A222C0347408586FA4C309E5CC090CAE5BB15044740D1FE93E6B19E5CC04C77E5BB59054740804AC719E19E5CC04C15E6BB49064740AA20FB4CE89E5CC0E8304B222407474094B993E6C59E5CC0183C18EFDC07474009F494E6959E5CC01FD1B2887E08474039E22D804B9D5CC0F4EC4A223C0B4740040594E6119D5CC06B5EE5BBD90B47403AB6FA4CE89C5CC077F24822880C47408F5761B3D89C5CC01CCEB088420D4740803F95E6E19C5CC098D3E4BBF50D47400144C819099D5CC078A316EFA00E47408E2C94E64D9D5CC08C98B288320F4740F68E94E6D79F5CC0985C17EF0C1347402D86FA4C24A05CC0147316EFD0134740D2E493E633A05CC0E401E5BB7D14474011F460B32AA05CC04031E5BB29154740EDAA60B306A05CC0AC7FB288B2154740FF5861B3E29F5CC030B87D55FF154740A65594E6999F5CC0D0F6E5BB551647402762C719379F5CC0F0B2B28896164740594FFA4C149D5CC0A0C1B188EA164740DA4161B39E9C5CC07742E3BB1D17474094AD60B33A9C5CC0F01BE4BB6D17474026572E80EF9B5CC0743B7F55E7174740D56D2D80B99B5CC0D0B87E557F18474094EB93E6A59B5CC0A44616EF38194740E23EFB4CAA9B5CC0D8457E55F719474009CFF94CD49B5CC088567F55631B474091FDFA4CF69B5CC0243C18EF901D474051472E80099C5CC0A0BE7D553F1E47404DBAFA4C269C5CC01041E3BBED1E4740B6C22D80859C5CC0B05D492254204740BACB93E6D39C5CC010D3E3BB29214740A67F94E6039D5CC06CF67E55DB214740594FFA4C149D5CC0849CE4BB8D22474047FA94E6F59C5CC08CA24B2230234740F98160B3C09C5CC0931419EFBC2347404763FA4C389C5CC003E118EFCC24474020002E80019C5CC03C1C7E5573254740480A95E6E19B5CC0EFE5E3BB29264740E57B94E6D19B5CC0204917EFA8274740F9EA60B3B69B5CC0C883492260284740F4E3FA4C849B5CC0A3F4B0880E294740BA9C93E6339A5CC0ABB74A22C42B4740D1A194E6FD995CC0289AB188622C4740BC932D80E5995CC0B010B288162D4740746A94E6DB995CC0C84AB188DE2D474076DD60B3F8995CC018134C22642F474052102E80F3995CC0A0A47E55033147407BC194E6C9995CC0B4C517EF903247408479FA4C84995CC0274119EF0834474015B7FA4C06985CC02035B1887E384740A12394E6DF975CC03810E6BB4939474025E92D80C3975CC0542C7E55133A47408F752E80B7975CC0082BB388E23A4740100795E6C1975CC0E70BB0889E3B47403CEE93E6D9975CC0542F4B22503C47400F60FA4C18985CC0348EB088FA3C4740682D94E66B985CC04BA5E2BBAD3D4740119694E655995CC038024A22383F4740A94F2E808B995CC0741B19EFBC3F4740967E60B39A995CC0CCFB18EFF03F474022C0C7199D995CC04F5F16EF144047408529FB4C7C995CC08F18E4BBA9404740B85E94E633995CC04F8C4A22044147408AB52D80D3985CC0B300E4BB4D414740F83661B314975CC0505118EF40424740A5C0C719AF965CC080A17E5597424740221DFA4C54965CC0F88B4A22F8424740CEC92D8003965CC0E075E3BB69434740E7C52D80CB955CC04C53E4BBF14347409F79C719AD955CC0006B49229444474058C3FA4CC0955CC0DC3BB28832454740E241FB4CEA955CC03848E5BBC9454740EC3F60B31A965CC0EB3018EF5C46474011C894E635965CC00FA84B220047474098A7FA4C2C965CC0FCFA4B22B0474740A54CFA4C06965CC0C0F4492254484740AC77C71991955CC024E416EF78494740B05BFB4C62955CC0BC9CB1881E4A474053CDFA4C52955CC060F54A22D44A474086DEC71965955CC05C2AE4BB854B4740C1B060B380955CC09C067F552F4C474081AA94E68B955CC0384D16EFE04C4740F94E61B376955CC03F94B188964D4740F708C7194D955CC0AC1617EF444E47405BC294E6E7945CC030BD4A22944F474084A02D80B1945CC0B8AE7E55235147409932C719AB945CC048754A22745347402FAFC719B9945CC0A7EAE4BB495447401B37FA4CD2945CC07C1E18EF1C554740486D94E615955CC0F757E4BBF55547404E99C71979955CC0ACAC7D5573564740F27C94E6F5955CC090627E55BF564740F8EE61B382965CC030974922D4564740E4F2C61907975CC0682C4922C85647400AFAC6195F9B5CC0449AE3BB3955474032FC2D80C99B5CC0088BB188F6544740BACB93E6D39C5CC0ECA616EFDC534740A02995E6A19D5CC0A80BB088465347401F372E80179E5CC050CCE5BB15534740B42F61B3909E5CC0B4F6E4BBFD5247406DFEC719119F5CC0709017EF1853474099D3C61921A05CC058AF7F55A3534740490E94E68BA05CC004D8E5BBBD534740E3B6C719FDA05CC02097B188AA5347409BF960B372A25CC04BD44A22D85247408F6F2E8037A35CC020A7B18896524740C9BEFA4C4AA45CC0E83CE4BB7952474038BD2D8017A55CC050224A22C4524740675E94E601A65CC06F17E6BB555347401FC4FA4C8CA75CC0C8EC4B22B4544740944F61B33CA85CC0C873E4BB89554740E26EFA4CB4A85CC0A778E5BB4D564740D5C9FA4CDAA85CC0CBEF18EFF056474025372E80F1A85CC09C4E7E559B5747400711FB4CE2A85CC0502AE6BB55584740E26EFA4CB4A85CC03BCBE5BBF1584740B42694E6D3A75CC080217D55835A474085C5C719B9A75CC04C504A22405B4740DCFCC719DBA75CC0BCCA4A222C5C47409C8CFA4C64A85CC0ECB8B188725D4740A382FA4CD2A85CC0A0F3E3BB295E4740DCD2C71971AA5CC04479B188CE5F474005252E80E3AA5CC08488E3BB116047405C7F60B366AB5CC0D85718EF34604740BF9294E6E3AB5CC0F40A7F55276047406F8E2D8057AC5CC054A1E4BBF95F47402670FA4CB8AC5CC0F0A97C55AB5F4740985DC719C1AD5CC0D0207D556B5E474016E893E62DAF5CC0900E7E55EB5B474005822D8097AF5CC0E00BE4BB915B4740A96EFB4C16B05CC07CCBE2BB6D5B47404D1594E6B7B05CC0D3BDE4BBA55B47403D062E800FB15CC0E8EE7D551F5C47402CB12D803DB15CC064D1E4BBBD5C474080FB93E63FB15CC0DC654C22705D474002EEFA4CCAB05CC0FC24B08886604740C8A6FA4CC2B05CC0589A4A225C6147406423FB4CD0B05CC0904A7C553B624740BFC4C6190DB15CC047DD4A22206347408F62FB4C62B15CC0EBD1E2BBAD634740C996FA4CD6B15CC0703F7D5513644740E170FA4CAAB35CC0181BE5BBCD64474061D894E6B5B45CC014CDAF887A6547404E2294E663B55CC074424A225066474036F361B34EB65CC05CEDB088C66747407AF893E6FFB65CC0943E18EFA8684740A2BF2D80F3B85CC02C87B188726A4740E95A94E689B95CC0A40917EF206B47401454FA4CF2B95CC0A02DE5BBC16B474085A2C7197BBA5CC0F0ECE3BB916D4740EC872D80C5BA5CC0E851B088DE6E4740E1ACFA4CF6BA5CC050AAE4BB417047407743C71917BB5CC033CB18EF7C7247407079FA4C0CBB5CC0F899E4BB4973474075062E80EFBA5CC0683F17EF0C7447400273C719C9BA5CC0A82C7D55C774474024CD2D80B1BA5CC0889DE4BB75754740F9A8FA4CBEBA5CC0588B7D551F7647403E3DFB4C22BB5CC06C6E17EFAC7647400D58C819BBBC5CC0B861E4BB097847401C3261B346BD5CC0B402E4BBA57847400DCCFA4CB0BD5CC0637A4A223879474065B5C7197BBF5CC0AC197F55977C4740B98461B3EABF5CC00C977E552F7D47407227FA4C54C05CC0739FB1888E7D4740DD0361B398C15CC00C8FE3BB057E4740D4B6C71985C25CC0686CE4BB8D7E4740799A94E601C35CC060EA16EF147F4740EDF9C7194FC35CC0103FB088927F4740215B94E669C35CC030AD7D55E77F4740F9A72D8077C35CC03804E3BB21804740D8EC61B3C2C35CC0B8FA17EF748247401218FB4CE8C35CC06C0618EF1C834740DFCDFA4CA0C95CC05449E3BBE18B4740096F61B38ACA5CC08BBCE4BBDD8E474068FF2D804BCC5CC0BC077D5547924740950AFB4C04CD5CC0E4F8E2BB399347408ABEC719C9CE5CC05CDD4B22F0944740593994E655CF5CC04C64E4BBC595474075E6FA4CEECF5CC0CF354A22EC9647406FBB2D8063D05CC090414A2294974740C2AD94E6E7D05CC0606C17EF18984740A1BCFA4C8AD15CC0644A4B2290984740D06561B3EAD15CC0D0154A2214994740142594E625D25CC03B87E4BBB199474048022E805FD25CC0F7C77D550B9B47407D86C7198FD25CC0ACDFE2BBAD9B474079C560B3D2D25CC0982118EF4C9C4740D5B5C7193BD35CC05C3EE3BB059D4740512DC7197FD35CC000F77D55AB9D47403D66FB4C1CD45CC0601BE4BB819F4740238F2D80D1D45CC057E917EF0CA1474031A8FA4C54D55CC0F0F3B188D6A14740AA6794E6DDD55CC0F8537D555FA2474047F960B3A2DB5CC093A77E558FA54740654694E6DBDE5CC0D8B7B1885EA6474040ED93E6CBDF5CC07CAC4922ECA6474087652D804DE05CC0BC36E5BB71A7474084C793E6A5E05CC09C727D5507A84740E91761B34AE15CC093037D55B7A94740A13FC819D5E15CC0A01CB18882AB4740F1202E80E1E25CC0F4E415EFA0AD4740C6102E80EFE45CC068A87D55F3B04740C6D2FA4C84E55CC0541E4B22B8B14740A94F61B352EA5CC04C72E4BB1DB6474037B5C719D7EC5CC074154B2224B7474022BA2D80E7ED5CC0C8E44922E0B74740E2DF94E655EE5CC00832B1888AB8474086B1FA4C82EE5CC074554C223CB94740446594E663EE5CC06002B188D2B94740E563C71937EE5CC0486F18EF48BA47403A9261B30AEE5CC068BA18EF88BA4740B54794E6B9ED5CC08C87B088DABA4740466C93E64DED5CC0B7A37E550BBB4740CB0B2E8093EA5CC08488B18866BB47400425FB4C1CEA5CC04045B18896BB4740625BFA4CB2E95CC0E04E4A22D4BB474064A994E651E95CC0109FB0882ABC4740D246FB4C0AE95CC06C7CB188B2BC47407C0FFB4CE8E85CC01BA618EF58BD47401B9361B328E95CC08CFD4B2230BE474029C6FA4CBEE95CC0E0F77C55C3BE47400540C819BBEA5CC08F21E4BB69BF4740CDBC94E663EB5CC0CFDAB188FEBF474015E62D806DEB5CC08C567D551BC047400D9893E6CDEB5CC0B0EAE4BBC1C24740613AFB4C4AEC5CC03425B28826C447402A94FA4CDEEC5CC0DC82B188F2C44740D6FB60B384EE5CC0B77AB18876C647408BDD2D80E5EE5CC07886B1881EC74740EF122E80EBEE5CC0BC32E3BBC5C74740662161B3A4EE5CC024ED16EF38C847409AADFA4C4AEE5CC0A85AB1889EC847406980FA4CC0EC5CC0BB24E5BBF1C94740B2F72D8069EC5CC05C7418EF58CA4740B3EEC7191BEC5CC0E4634A22D0CA4740FF7FC719D7EB5CC0EBD517EF5CCB47403AB360B372EB5CC0C3E77E55A7CC4740C61FFA4C4CEB5CC088044A2260CD4740AC092E8071EB5CC004C5E4BB75CE474041A960B3E0EB5CC0F04C7E55D7CF4740D0302E80A1ED5CC0A453B08892D347405672FA4CF0ED5CC0E85B7E559FD447403E4AC719C5ED5CC0F4FC4B22CCD7474028112E80D5ED5CC05883B188B2D847400F4B61B302EE5CC0F492B18892D94740B87C2D806BEE5CC0D3BE7F55A3DA47402AA82D80DFEE5CC0C44D7D553BDB4740AC28FA4CBAF05CC0BC614B22F0DC47408C37FB4C10F15CC0544918EFA4DD47405EDF94E643F15CC09C6A16EF84DE4740E05494E66BF15CC0C04AB18866DF47409DB02E80CFF15CC0C4CE4A2290E04740C2C560B366F25CC094BCE3BB39E147404D7A60B31AF45CC033EB4B22A4E24740EE9C61B38EF45CC0CCB4B1885AE347408770C719D7F45CC0730D4B2210E44740A738FB4C0EF65CC0B80F18EF34EA47404C2D2E804FF65CC04497E3BBF9EA474036C7C719B9F65CC0F0EC7D5503EC47404C4860B33AF75CC030B716EFA8EC474060A82D80BFF85CC0CF817D55EBED4740705594E657F95CC094D317EFBCEE4740D64E61B30EFA5CC0338C7C55FBEF47407AC8C719BDFA5CC0DCD04B22F4F04740F937C7198BFB5CC0A0C2E4BBD5F14740768494E6F7FB5CC06F3FB1887EF24740891F94E63FFC5CC003877F5523F347401C21C819BBFC5CC0C4564C227CF447406CFA2D8051FE5CC06C8249226CF747409355FA4C12FF5CC08852E4BB61F94740FBD260B3F2005DC0D00A492294FC47409B6994E65B025DC0D864B18872FE4740AA4C2E80E9025DC0DC884922ACFF4740178994E621035DC0F84517EF78004840178994E621035DC0E8B17E55CB064840D1AFFA4C20035DC05F2516EFD41548400A9EFA4C1E035DC0B775B188DE2448407AF4C7191D035DC084F5B188E6334840331B2E801B035DC08B39E4BBF1424840AED9C61919035DC0749B7D55FB5148401E3094E617035DC05CFD16EF04614840094EFB4C16035DC0445FB0880E7048404398C91A15035DC08C3378B70A7F48402D21203EB4F55CC0B81578B70A7F48400646EDCAA3E75CC0B81578B70A7F48408CFA3BA691D95CC0B81578B70A7F484017AF8A817FCB5CC0B81578B70A7F48406B18B67A6FBD5CC0B81578B70A7F48404D2464C25DAF5CC0B81578B70A7F48402F30120A4CA15CC0B81578B70A7F4840ABFD7F2A3B935CC0B81578B70A7F4840F0608DDE29855CC0B81578B70A7F4840E162E7F415845CC08C3378B70A7F48402DC49A9218775CC0B81578B70A7F4840F7E249DA06695CC0B81578B70A7F48409C8497B5F45A5CC0B81578B70A7F4840DAE7A469E34C5CC0B81578B70A7F4840B20C72F6D23E5CC0B81578B70A7F4840F76F7FAAC1305CC01C73F5680C7F4840D37B2DF2AF225CC05CF6741A0E7F4840F9F13BA69E145CC05CF6741A0E7F48403655495A8D065CC05CF6741A0E7F48407CB8560E7CF85BC05CF6741A0E7F48401A5AA4E969EA5BC05CF6741A0E7F4840E378533158DC5BC05CF6741A0E7F484022DC60E546CE5BC05CF6741A0E7F4840F9002E7236C05BC05CF6741A0E7F48403F643B2625B25BC05CF6741A0E7F48405EDA49DA13A45BC05CF6741A0E7F48405FD3F62102965BC05CF6741A0E7F4840F98D6342F1875BC05CF6741A0E7F4840A8AE6FE0F47F5BC0CCD9741A0E7F4840C3AC128ADF795BC05CF6741A0E7F4840F2283F83CF6B5BC05CF6741A0E7F4840D934EDCABD5D5BC05CF6741A0E7F48405FE93BA6AB4F5BC05CF6741A0E7F48409E4C495A9A415BC05CF6741A0E7F4840E3AF560E89335BC05CF6741A0E7F4840211364C277255BC05CF6741A0E7F48405F76717666175BC05CF6741A0E7F484041821FBE54095BC05CF6741A0E7F48401AA7EC4A44FB5AC05CF6741A0E7F48403E1DFBFE32ED5AC05CF6741A0E7F48407E8008B321DF5AC05CF6741A0E7F4840DCD0146710D15AC05CF6741A0E7F48409EEFC3AEFEC25AC05CF6741A0E7F4840BE65D262EDB45AC05CF6741A0E7F484021B6DE16DCA65AC05CF6741A0E7F4840A76A2DF2C9985AC05CF6741A0E7F4840E6CD3AA6B88A5AC05CF6741A0E7F4840689BA8C6A77C5AC05CF6741A0E7F4840A5FEB57A966E5AC05CF6741A0E7F484041B9229B85605AC05CF6741A0E7F484004D8D1E273525AC05CF6741A0E7F48409F923E0363445AC05CF6741A0E7F4840869EEC4A51365AC05CF6741A0E7F48400C533B263F285AC05CF6741A0E7F48404BB648DA2D1A5AC05CF6741A0E7F48406A2C578E1C0C5AC05CF6741A0E7F4840429BB1750B035AC0CCD9741A0E7F4840,-40.4%,-112,165,73,92,Montana,true
27,0106000020E6100000010000000103000000010000007E020000D83361B346DC56C034C4492294304440DEA42D8047DC56C034C44922943044407A8C61B344DE56C070A8B188D62D4440DCD493E6BFDF56C05C8AE4BB1D2844401ABA94E6B7E056C064564B22902144403D0CFB4C2AE156C0844BB088521C44400477FB4C36E156C008FA7D5563164440A0862D8085DF56C0849BB0883A014440AA24C7192DDF56C05BDD17EF48FF4340088693E64DDE56C07791B18836FD4340727B94E637DD56C00887B28826FB4340F487C719D5DC56C034A17E553FFA4340144C94E68BDC56C0E00817EF54F94340608693E659DC56C070DC15EF54F84340AE5D2D803FDC56C0D0467E552BF74340DEA42D8047DC56C0879FE4BB09F44340C149C819CFDC56C02C04E6BB49F043406C3595E6C1DC56C0FC117F55CBEE4340687C2E807BDC56C0F0257F55EFED43402C0AFA4CA0DB56C0D02116EF6CEC43402C8EC71935DB56C0C4AE7D55BBEA43408D9E2E8075D956C0142CE5BB29E8434002B7C6190DD956C09014E5BBD9E643400E65C719E9D856C0D3D34B2280E5434076CEFA4CC8D856C0C4074C227CE24340E4C360B3FED756C070594A222CDE434068762D80B9D656C0D4947C55FBDA4340725CC719ADC656C0644B4B223CC44340AC7D94E6ABC556C0F30318EF50C24340F66F94E6E7C456C0FF9C4922ECBF43407F1061B39AC456C0CC92AF882EBD43402E9AC71935C456C07002E3BB6DBB4340013895E641C356C0F48718EFE8B94340269E2D8073B456C0E4F5E2BBF9A84340AD842D8007B356C0D4C27D55CFA64340BE89C71989B156C0D8B54922B8A34340122261B3E2AF56C098A07D55FB9E434048F393E625AF56C01C6D4A22349C43403A8CC719B7AE56C0EBCB17EFB4994340485494E6A5AE56C0B8824B22FC97434082BE61B3C2AE56C0CCA9E5BB719443403A8CC719B7AE56C018907E55B7924340AE802E805DAE56C0E8097E55239143408AF02D8037AD56C06CD64A225C8E4340F2DD93E6F7AC56C0CC4818EFF48C4340A64C94E63BAD56C0480E4B22908B4340E64A60B3BAAD56C050E015EF148A43405CCB60B300AE56C080D74A2280884340D0ECF94C9AAD56C0F89317EFCC86434040A4C71919AD56C0D401B2883E854340CA7AC719C1AC56C028BC17EF20834340D1C8C619ADAC56C07094E4BB01814340F2DD93E6F7AC56C0947917EF687F4340AE9F61B314AA56C074C617EFE47543405A91C71919A856C088A317EFF87143407B6E2E8075A556C0C40B19EF64704340101D94E6AFA256C00040E4BB6D724340756061B3A89E56C0D4D4E4BBBD7A4340E66C61B3689B56C0008916EFD47B434078E9FA4C2E9A56C08454B088127B4340C68994E6FD9756C0D7DA7D55CF7843409A2FC719CD9656C0407A7F55577843401A822D804B9556C0044DE6BB15784340184161B30E9256C0F0CB4B2298764340BE872D80BF8B56C014184C22FC70434020E72D802F8956C0D01816EFAC6D4340E2E760B3248856C03BF17D55476A4340BEB92D809F8856C0E4534B2200684340E72661B3B08956C09C1818EFC8644340FEEE94E6E78A56C0839E17EFE861434092BCFA4CD68B56C06486E4BBA9604340259161B3AA8C56C0DC697E55435F43404C2A61B3D68C56C0FC9EE4BB1D5C4340AA8C2E80838C56C0A8694A22F85643401EF4C619938C56C0DC417F55AF514340245E94E6A98D56C060D8B188AA4D4340B40195E6E19056C0E483B2887E454340A82194E6259456C004EB4B223C37434018ED60B33A9756C070177E55432F434058C960B3309856C0C866B088362B43403E2661B3729856C0F89EB088762643404C462D80DF9756C028E24A228C2043403A022E80859756C0382A7E558F1E434008E8FA4C249756C014274C22001D43406E3FC719B39656C0BC444A22B41B434034E8FA4C2A9656C09CEA7C55831A434083E82E80A19256C0236BE3BBA9154340EA8FFA4C389256C0F82218EF7C144340B62361B36A9056C0D0147E5587114340912AFB4C029056C0F85416EF6010434004A394E6898F56C05C49B188720E43404CB960B36A8E56C0002EB188EA0C434054F3C719098C56C00B1F7F55B30A4340224AFA4C608A56C0302017EF0008434014A32E80D58856C07408E4BBCD0443405A9E2D80178756C0A86EE3BB2102434066BC2D80D38456C05002E5BB010143405A512E804F8156C02C8E7D5533FC42407ED760B3528056C02C507E5533FB4240A4642D80F37D56C0A0C017EF44FB42405AE32D80237D56C028657F55E3FA4240E0E493E60D7B56C00C44B088EEF942404470C719E17856C0CCEB16EF44F74240CA8ABB453E7556C0B3E9E74039F14240920E2E80B77356C064C8B08892EF42405CA1C719C96F56C004ACE5BBE5EC42401EAAFA4C346E56C0C4DF4A2228EB4240B83EFB4CA46C56C0B030B18896E74240A064FB4CD06A56C0B31EE4BB91E04240B8F42D80656956C0D8317E55E3DD42402AFFFA4C2C6356C018B018EF4CD94240465094E67D6156C008F6E4BBE5D642401AB194E6F76156C0E0F2B28856D542407CF7FA4CC26156C054007E553BD3424012CCFA4C4E6156C0A8D44A22E4D04240724894E60D6156C0CC1318EF98CE42408970C719396156C0DB15B18872CC4240142C61B38A6156C0D04116EF44CA4240928093E6B96156C020B718EFF0C74240465094E67D6156C0505E4C2258C54240820FFB4C246056C088107F55E7C04240EA1661B3625E56C06B60E4BBC9BC42401C902D80DF5C56C04C3617EF5CB842408ECB2D803F5C56C0F4A917EFFCB24240F861FA4C5A5D56C0440A4B2268AE4240C276C719995F56C08478E5BBE5AA42403065FA4C7A6156C080F9E3BB41A74240465094E67D6156C068C2B0884EA24240D69760B3266156C018687E55CBA1424052E261B3E25F56C09C3318EF08A14240A82BC719595F56C024147D558FA04240868860B3525E56C0D8A37E55379F4240AF8161B36E5E56C0FC65E4BB899D424028AA60B33A5E56C0A81AB188669B4240F6CC61B3B45D56C044FEAF88529942408ECB2D803F5C56C06CC6E4BB1D954240467594E6B15956C0BC134B22608F4240F106FB4CC25856C0EC59B288B28B4240F7FCFA4C305956C00FFFE3BB01884240C06EFA4C265856C068FFE3BB0D86424030D4FA4CF05456C073F1E4BBD1814240803F60B35A5256C0A3014A221080424057ED94E69B5156C0931FB1880E8042400C91C719495156C0C430E5BB698142403AA494E6775156C0D02A4C2258834240EC9F2D80EB5156C0A34418EF64844240EB61FA4C805256C040AE7C552B854240A6D960B3125356C0D050B0884286424058CD94E6C35356C02B544B221C89424062B92D80575356C0DC004B22608A4240D2FC2D802D5256C060C84922AC8A4240E81994E6A55056C0182EE4BBA18A4240F80E2E803B5056C080F817EF008A4240C267C719F74F56C01C92B288F28642409C75C719C14F56C0F448B088D2854240C6272D80274F56C0ACB6E5BBF184424048192E80D94D56C0C8B0E3BBA183424018F4F94C5A4D56C0A0E24A22C4824240B8B593E6054D56C0A85AB1886281424074192E80DF4C56C088FCE3BBF97F4240E20F95E6A14C56C0F4917E55A77E4240540C61B30A4C56C0B066E3BB857D4240EEA1C719534B56C0389FE4BB397D42400656C819894A56C0CCCB4A228C7D424028CB94E6C74956C008D317EF0C7E42408274FB4C2E4956C0C44118EF507E42401C0961B3EA4756C048C717EF647D424098C794E69B4756C0287D4A22207B42409643C719074856C040F87C559375424078CD94E6EF4756C0443018EF807142409643C719074856C030A718EF4070424006FCFA4C5E4856C0407F4A22686F4240786494E6F94856C0F8F4E4BB496E42403256C8198F4956C058787D55F36C4240E8BBC719D14956C01833B188726B4240252CFA4C944956C0BC04E4BBC16842405035FB4C9C4856C028DB49224464424024D42E80814856C08431E4BB65614240A4A293E6FF4856C03821E3BB055E42400073FA4C904B56C0BF0817EF28554240376AC719254D56C06CEE16EFC44D4240571F95E67B4E56C058C7B1884E4A4240CC41FB4C365056C0708D17EFD8484240847C94E6355256C0F0BE7E55EF494240F7D42D80E55356C0800C19EF7C4C4240E22894E66D5556C010567D556B4F42400BE5C719F75656C0909AB188AA514240C028FB4CB05756C088944A2208514240149F94E6155856C064FA492250504240DCCB61B3B65856C05498B288164E42409C0DFA4CA05956C0DC3549224849424080502E80CF5956C03036492254474240D6D893E6D15A56C040867F55574142400432FB4C2A5B56C04C3AE3BBDD3F42401C5A2E80555B56C0A7707D55273F42403E79C719C75C56C07CA317EF443C424096CBF94CD45D56C0E88E16EFA03A4240668E60B3A65E56C023E317EFE83942407B2BC719536056C0E811E5BBA53A4240AA9594E66F6056C02C83E4BB893C42400636FA4CD45F56C0D023E4BB193F4240C84094E6A35F56C0DC84B0882E404240A82BC719595F56C0ACE0B188DA414240F92694E62B6056C054FEB088F6464240E6EEC7195D6256C0ECA64B22B0484240BCA894E6756456C068BA7D5537474240E61DC819FD6456C0F4727C55BB4242403C172E806B6456C008E7E2BB214142402473C819D56356C0D03E16EF04404240AA6394E68F6356C07F55B088823F4240468F94E6096356C048677F55A33D424069D8F94C7A6356C0FF947D55433B424084EF61B3946356C01CDDB08846394240649194E62B6256C0444419EFFC3342401AB194E6F76156C080C47F551731424008FB93E6A56256C0EC9CB1884A2E42409D3161B3D26356C0BF90E3BB052D4240DE762D80536556C01CF3B088B22C4240666A61B3FE6656C0D8DAE2BBB92C424092142E80376856C04879E3BBB52B42406ECB2D80136856C0806B17EF5C294240BE9860B31E6756C0086C7C55BB2642409E5F60B3E66556C0C00C7F55DB244240399B60B34C6456C0602618EF04244240222D2E80AB6356C0541CB1882A23424073D7FA4CEA6356C040BEE3BBC121424060602E808F6456C0FC3CE4BBF1204240F461C719576556C0CBEC7D559B20424084A794E64B6B56C0D44319EF3C20424084BA61B3746C56C0DC9017EF9C1F42407A102E80F96856C0B413B28856174240857F2E80496756C088917E5523124240D61194E6DD6756C0E8D617EFCC0F424054202E80DF6856C028C3B288620F424017E5F94C1A6A56C0ABA216EF5C0E42404A73FA4C246B56C053D216EF140D4240D6AA61B3946B56C07C72B088DE0B4240DA5AC719D96B56C050FDB088C2094240CA3361B3CE6D56C0401D19EF700442406E672D80536E56C0846F4A2210004240A0D1FA4C706E56C09451E3BB1100424062E5FA4C8E6E56C098C2AF881200424023F9FA4CAC6E56C014227E5513004240DC9B2E80C96E56C0240417EF14004240F6A82D80E77756C064617E55ABFF4140C074C719058156C050D0E3BB41FF41400979C719238A56C0902D4B22D8FE41401C15FA4C409356C0E0FB7E556FFE414022D2FA4CE49756C0282D7D553BFE4140DE2D95E6479856C0702BE4BB6DFE4140128F61B3629856C020034C22F0FE4140F082FA4C669856C0641BE4BB81FF4140505894E62F9856C0633F7C55BB004240E4AEFA4CEC9556C00C8CB188DE074240764661B3509556C064CD7D55270942405453FB4C429456C0C4E1E3BB110C4240ACB6C7197F9356C074E0E2BB790D4240ED0A2E80139356C0F4714B22800E42401C99C719D59256C07C7FE4BBF50E42406ED1C619879256C074284922540F42402225FA4C2C9256C07432E6BB950F42409E6FFB4CE89056C0C47A16EF14104240CC81C7198B9056C0C872B188521042405558C719339056C0D8ECE3BBA1104240344CFB4CEA8F56C034844A22001142401C72C719AB8F56C010AF17EF841142403E3894E67D8F56C08820B2882212424018EF93E6598F56C0E8314B22D01242407240FB4C428F56C048D217EF7C1342405C3294E6298F56C037034C22A4144240FD5394E6118F56C06CCDE4BB491542403676C719E98E56C048AAB288E21542403A902E80AF8E56C0508D4C22701642409A03C7196D8E56C0E87C7E55E7164240AE8394E6C98D56C07C644B229C1742405A66FB4C6E8D56C0BCE44922E01742405E2661B39E8C56C040704B224418424092482D802D8B56C094A8B1883E19424012FC93E62B8956C058384B22101B4240E475FA4CE08856C06C4617EF741B42405ADD2D80A38856C09C6B4B22F41B42405EB860B3728856C0882AB2888E1C424078D72D804F8856C0BC6517EF341D424017B393E60D8856C03442E5BBC11F42408A8D93E6ED8756C074FBB288562042404E3F2D80B38756C0EC977F55CB204240C7FD60B3648756C0B7F9E3BB21214240883CC719C58556C06C69E5BBF1214240914B2D806D8556C058EF7C553B2242400E0A61B31E8556C05B1BB0889E2242405EA461B3DC8456C0B86417EF102342401B4DFA4CA08456C030B3E4BB992342403C1CC819758456C03425B288262442401E4494E6518456C0CFCB4A22C8244240DEC1FA4C3E8456C0E4D1B1886A254240C06594E6398456C0C43017EF142642406042FB4C848456C0BC72E4BBDD294240208A2E807B8456C07441B088AA2A4240CD0A94E6138456C09C014B22B42D424078F660B3068456C043EE7D557F2E424086672D80078456C068F94A22382F42405C0DC7191F8456C083107D55EB2F4240F2AC94E6418456C07CB17C5587304240FCB3FA4C748456C0E8FF492210314240874CC719B18456C06B1FE5BB89314240A0E7C619F98456C0E42C7E55FF3142408E1795E6478556C0789A18EF6432424058A793E6658756C04CA4E4BB85344240F62AFA4CA68756C070464A2200354240DC642D80D38756C0889AB0888E35424002552D80ED8756C047177D5537364240DEAAC719FD8756C0D48D7D55EB3642400A42C7190D8856C028B6E3BBF93842406ED0C7191D8856C058FEE4BB8D39424030DBC619398856C0D09AB188023A4240E4F9C719758856C0ACF0B0885E3A424072AC60B3C48856C0BC7CE5BBB13A424066832E80098956C03467B188123B42400C5594E6358956C010E07D55833B42402ACCC719D98956C028E9B188623E4240D2DAC6192D8A56C0C4BB7D55673F42406200C7194D8A56C080AD4C22B03F42402ABBC619618A56C087A4B088FA3F42404274C719CD8E56C087A4B088FA3F4240F89A93E659A056C087A4B088FA3F4240D84794E6E5B156C087A4B088FA3F4240C56561B372C356C087A4B088FA3F42406D1B61B3FED456C087A4B088FA3F42409DE70A1D1DE456C087A4B088FA3F42409C09C7198BE656C087A4B088FA3F424002EF2D8017F856C087A4B088FA3F42406AD494E6A30957C087A4B088FA3F4240188A94E62F1B57C087A4B088FA3F42407E6FFB4CBC2C57C087A4B088FA3F4240AE5D61B3483E57C087A4B088FA3F42408C0A62B3D44F57C087A4B088FA3F42408A01C719616157C087A4B088FA3F4240F0E62D80ED7257C087A4B088FA3F424020D593E6798457C087A4B088FA3F424086BAFA4C069657C087A4B088FA3F4240B6A860B392A757C087A4B088FA3F4240A6C6C71991A757C027AAE3BBF94F42409855FB4C90A757C0D420E3BBF95F4240C943FB4C8EA757C0E885E4BBF96F4240111494E68DA757C088FCE3BBF97F4240517360B38CA757C0E493E4BB51904240517360B38CA757C0342BE5BBA9A04240517360B38CA757C0A0A47E5503B14240517360B38CA757C08CDCB0885AC14240517360B38CA757C0ECE47D55B3D14240490294E68BA757C03C7C7E550BE24240C2C92D808BA757C097137F5563F24240C2C92D808BA757C0F41B4C22BC024340C2C92D808BA757C05495E5BB151343404191C7198BA757C0503EE4BB6D2343403420FB4C8AA757C03CE7E2BBC53343403420FB4C8AA757C09CEFAF881E4443403420FB4C8AA757C068574B2278544340F4B72D8089A757C057004A22D0644340747FC71989A757C0C479E3BB29754340747FC71989A757C010A017EF80854340747FC71989A757C0C8307D55DF8E4340747FC71989A757C00F647D55C38F4340562CC719D3A757C090EB7E55EF8F4340C02B94E6E3A757C0F8A5B28862904340C02B94E6E3A757C0F04E17EFC090434050F893E6F9A757C04CA0E3BBF5904340AD9894E611A757C02498E3BB79924340CDD893E633A757C098587E558F934340CC7894E63FA857C09C7C4C22309443406E8294E6C5A957C0788CB188629443408603C819FBA957C07C54E3BB9D9443407455C7191FAA57C0A89DE5BBBD9543404EEAFA4C72AA57C0574CE3BB2196434092CCFA4CC2AA57C020B7E3BB2D964340FE8D94E667AB57C0807016EF14964340ADC061B35CAC57C0E4A4B2883E9643400A37C71957AE57C0574CE3BB2196434072DFFA4CC2AF57C09BF0AF88069743404A2761B396B257C0FC1618EFF4994340A2712E80E1B357C030ED15EF949A43404ADA93E617B557C014D04A22D09B4340C65A94E65DB557C09C517D55839E434005DD2D8071B557C088C1B18836A143408E3061B310B657C00C27B18872A243407AF894E641B857C010BE17EFC4A4434054EE94E6A9B957C0AC6A4A22E0A9434046A2FA4C26BA57C038A6B088FAAE4340CC9261B394B957C0B89CE5BB4DB14340A6D1C61967BC57C0EF6FE4BB41B2434093F893E6B3BC57C08857B188F6B24340349FC71909BD57C01498E5BBFDB44340CDA860B346BD57C0903D18EFC0B54340E48CC719F5BF57C0BB5C7D55C7B84340086DC71923C157C010D217EF9CB943405E562D80A5C157C068BB7D551FBA434098D9C71945C257C0D054E6BB95BB4340166494E6B1C357C0640018EF24C04340626961B316C457C02CF716EF1CC14340723BFA4C2CC557C0C490E4BBE5C14340A43CC71953C657C00C25B188DEC34340BE26C71913C757C03078E4BB71C6434090C5FA4CF8C657C0A8F4B0880EC94340D24F94E681C657C08CCD7E556FC94340083CC819CFC457C010437E5597C94340626961B316C457C06483492254CA4340AE4A60B3DAC357C0285CB28862CB4340D0FDC619CDC357C078604A22D0CC4340766561B3DEC357C054FFB08892CF43402896C7196FC357C0ACEAE2BBC5D1434052CCFA4C6AC257C0ACBE7D55F3D343405CD093E65FC057C0488FB0881ED74340AEE560B3B0BF57C00B2F4A22DCD74340C188FB4C22BF57C02CC0E4BB45D84340A25061B3C2BE57C0D42FE6BB15D94340A52B94E691BE57C0A806E5BB35DC4340F16E94E661BE57C0A06BB18882DD4340744594E609BE57C06814B1888EDE4340107194E683BD57C024C94B22FCDE4340D093C7196DBA57C0842917EF90DD4340AAC42D8003B957C048AE7E5563DD43404CC2FA4CFEB757C024C94B22FCDE434062D8C619D9B757C080C17E556FE0434095312E8031B857C04824E4BB51E14340B262C719ABB857C0385D7D553BE24340F42AFB4CE8B857C0D7BF7D55CBE3434002F3C719D7B857C0C0884B2240E543408622C81989B857C0804D7E55C3E74340EA2BFA4C78B857C094767C5513E9434000D960B310B957C087ED4A2264EA434050E860B3E4BB57C080AB7E5503ED43402A9861B3D6BC57C0FC117F55CBEE4340CEDB2D8047BC57C0F0057F5517F043409C942D803FBC57C050964B22D8F14340225BC819AFBC57C0583416EF60F34340107194E683BD57C0879FE4BB09F44340484594E603BF57C06C29B288F2F34340B4DB60B31EC057C08450E4BB91F343405E0E2E8013C157C024ED4B22C0F24340D3C62D80FFC257C0D4C3E4BB25F0434002EDC71957C457C0FBA0B288CAEE4340AC1795E6D5C557C020D049222CEE4340F09094E62FC757C0209117EF30EF43407F4594E6E3C857C0A0CDB08846F24340528C2D8097C957C0543DB28816F34340CCE160B352CA57C0CCD97E558BF34340A6BD94E6A7CB57C0DCA1B088C6F34340414A61B336CC57C0879FE4BB09F44340AEE82D80C7CC57C088F74A22D0F4434016CE93E611CD57C0409BE4BBC5F54340A06F61B350CD57C020387F55D7F643406DFD93E6BDCD57C03FECB088EEF74340109361B34ECE57C070DC15EF54F84340CE6A2E801DCF57C0BC4B492288F84340B30D2E80D5CF57C0CCB916EFDCF843406AC42D80ABD057C0A01E7E55D7FA4340B87B93E64DD457C0A0CA7D5503004440262D2D8007D657C078607E5577024440983DC71925D757C0B0337D556B034440F28960B320DA57C0D8A24B224C04444098CD93E6D9DA57C0DC2F4B22C4054440923195E601DB57C0C4C14B220008444032B4FA4CB6DA57C0A012B388D60A4440947E2E8015DA57C0EC72B188420D4440C20CC819D7D957C0BC95E3BB9D0E44404CDBC71909DA57C08872B188360F4440663195E6FBDB57C0E0D816EF44124440A4BC94E65DDC57C00486E4BB251444407299C71943DD57C0A4FAB0885216444041D060B30ADF57C0EC0AB288B21944406CB694E6FDDD57C098404C22E41C4440B16C61B3EADD57C073BAE3BB791E44406EC860B39ADE57C0145A18EFE41F44408414C719B3DF57C05824B1888A2044401E5560B306E257C00493B188CE2044407FAE93E6F9E257C064564B2290214440C16EC719C1E357C03494E5BB3D234440B4F5FA4C4AE457C094A1E3BBF92444403E992D80F1E457C0C827E4BB8D2644408E9D60B312E657C090A5B188C22744403245FA4C40E757C068924922E0274440D8D92D808DE857C0746B7C55932744409A1161B398E957C064F24A22D0274440027394E601EA57C0D053E5BB81294440283F61B32EE957C0EC50B0886E2A4440D2322E8097E857C088EFE3BB4D2B4440AA5394E641E857C06846E4BB352C4440ECF8FA4C6AE857C0986B18EFB42C444021C593E62BE957C034C44922943044404CE2C71935EA57C0B4DD4B22FC3244404E9B2E807BEA57C0435DB288FE334440124D2D808DEA57C0505A7D55EB3444406C9593E673EA57C05CB4E5BBC93644404E9B2E807BEA57C074EEE4BB91374440EC042E80F5EA57C058C97E55A339444002AA94E617EC57C03C38B288CA3B44403B5A61B3AAEC57C000098055AF3D444068F160B3BAEC57C07C5D7E55733F4440C676FB4C7CEC57C0BB317E55F340444082B72D808DEC57C0406C4B2258424440E46961B38AED57C0C4B7E3BBCD4344409EC6C61913EF57C05F5617EFAC444440737F2D8053F057C0482FE5BB0D454440EAD660B32AF157C0F4B817EF3C464440A00F2E8079F157C0CCD5B0888649444072B6C61921F157C0605D4A22DC4C44405CD42D801FF157C05BEC7D55DB4C4440CC2AFB4C1EF157C05BEC7D55DB4C44400C8AC7191DF157C05BEC7D55DB4C4440F8A72E801BF157C0507BB188DA4C444077D793E619F157C0507BB188DA4C44406AF5FA4C18F157C0507BB188DA4C4440221C61B316F157C0507BB188DA4C444094722E8015F157C0507BB188DA4C444014A293E613F157C0507BB188DA4C444006C0FA4C12F157C0507BB188DA4C4440BEE660B310F157C0507BB188DA4C4440A804C8190FF157C0507BB188DA4C4440B26C93E60DF157C0507BB188DA4C4440A28AFA4C0CF157C0507BB188DA4C44408CA861B30AF157C0507BB188DA4C444044CFC71909F157C0507BB188DA4C4440B62595E607F157C0507BB188DA4C4440BE8D60B306F157C0507BB188DA4C4440AFABC71905F157C0507BB188DA4C4440E80A94E603F157C0507BB188DA4C4440DA28FB4C02F157C0507BB188DA4C44405A5860B300F157C0507BB188DA4C44404576C719FFF057C0507BB188DA4C4440049D2D80FDF057C0507BB188DA4C444075F3FA4CFCF057C0507BB188DA4C4440271A61B3FAF057C0507BB188DA4C4440E240C719F9F057C0507BB188DA4C4440D25E2E80F7F057C0507BB188DA4C44408A8594E6F5F057C0507BB188DA4C4440FBDB61B3F4F057C0507BB188DA4C444004442D80F3F057C0507BB188DA4C4440F66194E6F1F057C0507BB188DA4C4440AE88FA4CF0F057C0507BB188DA4C44401ADFC719EFF057C0507BB188DA4C44405A3E94E6EDF057C0507BB188DA4C44401265FA4CECF057C0507BB188DA4C4440FC8261B3EAF057C0507BB188DA4C44403CE22D80E9F057C0507BB188DA4C4440AE38FB4CE8F057C0507BB188DA4C4440366860B3E6F057C0507BB188DA4C44402086C719E5F057C0507BB188DA4C4440D8AC2D80E3F057C0507BB188DA4C4440CACA94E6E1F057C0507BB188DA4C4440022A61B3E0F057C0507BB188DA4C44403C892D80DFF057C04C0AE5BBD94C44402DA794E6DDF057C04C0AE5BBD94C4440E6CDFA4CDCF057C04C0AE5BBD94C44405824C819DBF057C0409918EFD84C44405F8C93E6D9F057C030284C22D84C44404FAAFA4CD8F057C030284C22D84C44403AC861B3D6F057C030284C22D84C4440F3EEC719D5F057C030284C22D84C4440761E2D80D3F057C030284C22D84C4440EC74FA4CD2F057C030284C22D84C44405ECBC719D1F057C030284C22D84C444010F22D80CFF057C030284C22D84C4440CA1894E6CDF057C030284C22D84C4440823FFA4CCCF057C030284C22D84C4440735D61B3CAF057C030284C22D84C44402C84C719C9F057C030284C22D84C4440E6AA2D80C7F057C030284C22D84C44401E0AFA4CC6F057C030284C22D84C44409660C719C5F057C030284C22D84C4440807E2E80C3F057C030284C22D84C4440A5A660B386EA57C0949BE4BB954C444034BD94E649E457C0F40E7D55534C44405AE5C6190DDE57C0B87017EF104C4440E8FBFA4CD0D757C088D2B188CE4B44407E06C8199DD057C0C8CF17EF744B4440E41994E669C957C00CCD7D551B4B4440812461B336C257C050CAE3BBC14A44401A2F2E8003BB57C0F4B54B22684A444055F194E6E9B357C038D67E55234A444066BCFA4CD0AC57C088677E55DF494440A27E61B3B6A557C0CCF87D559B494440AC49C7199D9E57C08007B38856494440FAE460B3369757C084894A22684944404880FA4CD08F57C0F48817EF784944409C1B94E6698857C05C88E4BB89494440F0B62D80038157C0CCF87D559B4944409689C719BF7957C0F0D717EFF0494440106560B37A7257C0ABC8AF88464A4440726761B3366B57C0CC367D559B4A4440EC42FA4CF26357C0600419EFF04A444048A660B37A5C57C018A6B088CE4A444067392E80035557C040A716EFAC4A4440CA9C94E68B4D57C0D725B2888A4A4440F308FA4C144657C0F4B54B22684A4440661FC8191D3A57C06015E4BB014B4440E80E2E80252E57C03C637E559B4B444068FE93E62D2257C018B118EF344C444090186DC0AE1D57C0343B21A86E4C4440A21D61B3361657C08810B188CE4C44405A122E80C30F57C0B31A7D55FB4C44401007FB4C500957C044134B22284D4440C6FBC719DD0257C0731D17EF544D44407CF094E669FC56C01016E5BB814D4440FC4E61B376F556C01054E4BB814E444099F82D80C3EE56C08C5918EF344F4440220361B344EE56C0C0CA7F55EF4D4440F9CCC61901EE56C08C5FB188464D444056252D80D3EC56C018DC4A220C4C44400AA52E808FEC56C01C84E4BB454B444018BDFA4C86EC56C0CCF87D559B49444032DCC71963EC56C0587517EF6048444025B294E61BEC56C0141F4A2268474440E87494E6A5EB56C0C098E4BB81464440740CFB4C0AEB56C0C368B188E6454440142E94E6A9E956C04C384B225C4544404EA760B326E856C0C4B7E3BBCD4344403749FA4C06E856C0F880B1884E434440D06394E6BBE756C0E0F6B08882414440E80694E679E756C070517E55BF40444080212E802FE756C0A44EE4BB65404440E6F4C719DDE656C05C027E5547404440A45761B32AE656C097BA4A2250404440585294E6C5E556C084E016EF104044407A1861B398E556C04445B0887A3F444077A594E67BE556C08C99B188C23E4440FC4761B34AE556C078934A22203E4440D8822E80BBE456C000FFE2BB6D3D44400EE293E671E356C0B86C18EF8C3C4440C619FB4CE8E256C0AF5A4C22F03B444080142E8083E256C0239EB188123B44402FA5FA4C50E256C0609A16EF2C3A4440B06393E64DE256C018977F554B3944407A4A61B378E256C01CFEE4BB7138444054852E80E9E156C01CC84A2234374440D2262E8097DF56C0BF60E4BB99334440798461B3CEDE56C028337D55BB32444036D42D80F3DC56C0EC8AB0889E314440D83361B346DC56C034C4492294304440,6.5%,35,575,81,494,Missouri,true
24,0106000020E61000000F00000001030000000100000008000000EC2E183446C954C0546058ECC90D4540BEEF7BFF17CA54C034997858D40B4540B1003EBCDDCA54C014AFD94C1C0D45404041B781ADCA54C0C0F0FC29F410454062377912A9C954C044824B7F2618454030CFD4162EC954C05CA6B40EF1184540E6E53D9013C954C06055DF7E8E114540EC2E183446C954C0546058ECC90D45400103000000010000000D00000092FF48C8C98655C03C831292A38146404A7C7127EB8755C03CD47808358046409D8E1075528955C07C9D3DB26981464060372E369D8955C078CBE4B03883464099087FB2308955C0B72BFDD9548546400CE8D7C9468855C0D0E6B9E80687464078BB0D5C198755C034254E9897874640D4DCBCC9A08655C0AC4D8153E0864640C4C476BF198655C090353B49598646406686E20F898555C04003CA1E0C8646409A0E59E8E98455C06490DF2EEF854640272F00D1D38555C0203CEA8A1684464092FF48C8C98655C03C831292A38146400103000000010000000F00000008083B8D5B7E55C0C85A4EF02B8B4640B29525A9428055C0B39F91E179894640C68D99D6E38155C070B30DC0828B46405C1400A5098455C0E02C160B2E924640CDF358BC1F8355C0C8E5ED03A1944640DDA5DFE06A8255C00CA38F28929546402AAF48446B8155C0A0EF2B73A59546409851EA3C928055C080BF9F5E9794464057944818A17F55C01075E829C3934640ACE68B1FD47E55C0386BAABABE92464008083B8D5B7E55C054492641339146400E5115318E7E55C0CBDA057D948F46401E695B3B157F55C000469713EC8D4640DC8BE7393E7F55C0604A613F6A8C464008083B8D5B7E55C0C85A4EF02B8B46400103000000010000000A0000007EB690F1F47455C0886D4B3642B54640FABEF1CF577555C0609A481D09B346407C4DE470DC7555C0E8711562C0B346406CD527D0A37855C0345E089D88BA4640A869C12D487855C0700F873C36BB4640E6C0A36CFD7755C0B835D5E13FBB4640241886ABB27755C0680364B7F2BA4640460225B76A7655C00C22590337B946406ABB2F29777555C0C7CD635F5EB746407EB690F1F47455C0886D4B3642B546400103000000010000001E0000002E36C8B8506255C0C029908F9ECC4640588F5C94AB6455C0C0923C10B7CB4640BE7C8ACDAA6655C0486A09556ECC464010CCE039016855C0008AA8B8BACE4640BF996F0FB46755C004C4723CCDD046409EEF74BDC76655C0D0EF34255DD34640888E540F0E6655C03CC6C66BDDD84640793957E6976555C0640276052FDA4640F6E71B64026555C067A5EC095ADB4640BCBC2E87766455C0E707EA48B5DC464019DEDDF4FD6355C01750BC674ADE464082486706B86355C0DCD8074CAFDF4640E83882DA936355C0544728104EE14640309C879E8C6355C0A8B363BEADE346409EF54EF3806255C0B42833C409E34640C685519E406055C0335D890496E24640C4686C5C375F55C04CD2580AF2E14640262D92CEE95F55C07CD43D2031E14640C0489A7F516055C0C463384653E04640CA0BE360626055C08CA6962162DF4640B83C77FA0D6055C0A79C58B25DDE4640AD6D0B94B95F55C098EDBE28EFDC4640670A06D0C05F55C0288BC1E993DB4640DAC98C0AF15F55C0AB28C4AA38DA4640B83C77FA0D6055C0AC792A21CAD84640DE064429E05F55C0388CFCE7CAD64640C4686C5C375F55C0A056FC8F36D34640C4686C5C375F55C014DCB84654D14640EA98F870456055C0703D0C6EA7CE46402E36C8B8506255C0C029908F9ECC46400103000000010000004C0200006E630013352D55C0A8B363BEADE346400A42E28BDC2455C0002C53D87FDD46408633385EEF1F55C06B31580235D7464078E127D0551D55C0FCCE5AC3D9D546403C565543471755C078A6270891D646404A4880215E1455C02874B6DD43D64640DCB7DBE3331155C068DF47749BD4464032D05467540E55C00F730CC63BD24640A8CF7F5B500C55C0B3FAAD9298CF4640F641953F690A55C0B0114A8517CC464024813174970955C0F4FDCDA60ECA4640862872A4400955C044EA51C805C8464059CCF02D090955C020174FAFCCC54640FACA139D670855C0D7AA13016DC346406CE723D36C0755C0FF09821281C14640205B1648270655C0BC4CE0ED8FC046408A77B7645BFC54C084A784D325C046409269E24272F954C0A8FACF5FF6BD464096A986FC3DF754C0980549CD31BA46401CCD1A8004F654C0CC70DA6389B846406870C4FDC8F354C03C8DEA998EB7464008CC7068FCF154C0F0C325F059B646402E48C4BB19F154C0E8B7026B16B646402D02D7B2C3EE54C05C7789A546B6464012A1B6040AEE54C0E8B7026B16B646409EC44A88D0EC54C098EE3DC1E1B44640FC4283F12CEB54C0C09E124987B146404089A3731CEA54C084ED93A9D9B0464024DFA82130E954C0C407BFC99FB04640D02993CF9DE654C03F999E0501AF4640F6A5E622BBE554C0C8D917CBD0AE4640665C377384E354C03F999E0501AF46404AFE0360A7E054C0D442C44BE9AD46409E167DE3C7DD54C0603D500863AB4640FEB487290ADB54C04C54ECFAE1A74640C9D5618B8DD854C050E057F3BCA346403E7516E9D7D954C0904BE98914A24640986AD0F435DA54C094B4950A2DA1464006670E4E55DA54C03CDFADDBB49F46404844824F2CDA54C0A4EF9A8C769E4640023E068708D954C058E0E8D9EB9A46403023065B3ED754C034DF3EC2E396464092CA468BE7D654C0F0219D9DF2954640083031651FD654C0B87C418388954640C935D8213FD554C0674AD0583B9546406934FB909DD454C058328A4EB4944640837836FD4DD454C03702FE39A693464052109201D3D354C09BD8206755904640243AA24DBDD354C004E90D18178F46402A77596CACD354C0246A00A3B68E46406C54CD6D83D354C038EBF22D568E46403DBB94D85CD354C028D3AC23CF8D4640D0819F604ED354C06F62A749F18C4640F9DD20D785D354C088D7764F4D8C46407AA9CA96F9D354C038A50525008C464064EB20ED6AD454C0F07EB77FF68B46406934FB909DD454C0F07EB77FF68B4640E8A508F018D454C0ECAD997CFC88464052137F9CAFD154C043A6402337874640AAAE9C4715D154C020D33D0AFE84464068CE3BAB61D354C0B01FDA5411854640B2116F9274D454C0B72BFDD954854640AE2E54D47DD554C06490DF2EEF854640388CB2DB56D654C0D0E6B9E8068746408E9E5129BED754C0748566C1B3894640A079E01456D854C0839DACCB3A8A464030C38FC48CDA54C0BCABB466BD894640F1C549E6CFDB54C00423698258884640E08D31FF62DC54C0F7DC7B7902864640E413C3C184DC54C0F8FF3AF1C482464054D349FCB4DC54C06C1C4B27CA8146401D3FB09E10DD54C07C9D3DB269814640280E1C0565DD54C0B4AB454DEC80464006BEBD1371DD54C0BC08CF48C17F464021C5416132DD54C0CC89C1D3607F4640EA5C9D65B7DC54C0A4E465B9F67E4640DB07A03C41DC54C040A6D109667E46404035722F0CDC54C09435CC2F887D46406285D02000DC54C0283C7B71457B4640F1C549E6CFDB54C0844C6822077A464074BDE8076DDB54C03C8FC6FD15794640A88216FFBCDA54C0FCC50154E1774640FAD45906F0D954C03C49D9F4BF7646409A30067123D854C09841809BFA7446409A8D8F6CF8D654C0C0A0EEAC0E734640745D0358EAD554C0545637783A724640AE2E54D47DD554C0FC17A3C8A9714640366FCD994DD554C05CB3C0730F714640EC85361333D554C0C4C3AD24D16F46400A50034205D554C0F4C5923A106F4640AE8BDDCF52D454C0603F2C6CEA6C46407460F0F2C6D354C09C1F8D089E6A4640467EDDB96DD354C094CD7C7A04684640CCFB0D9E2CD354C0C4B85684F3614640008484768DD254C0A7143668C05C46404461F87764D254C07029ED44005A4640BCE3C793A5D254C0F417567C365746409936E0A6DCD354C023B2C90F94524640C655AAFE24D454C044EDCE91DD4F46409284598291D454C0E023BD9B353446400A50034205D554C0C47F9C7F022F4640366FCD994DD554C0ACC4DF70502D46401C2B922D9DD554C0376E05B7382C4640D62129CA9CD654C0885A89D82F2A46407E860B1F37D754C0E401CA08D92946402551AD590DD954C054B52DBEC5294640784667656BD954C0D4E983FE51294640DA4744F60CDA54C05C7B633AB32746403ECCC5AEF3DC54C080F16D3E462246401250725BD6DD54C0E8015BEF07214640516A9D7B9CDD54C00026C47ED2214640FEB19A8E2DDD54C020EDA312C8234640CE551918F6DC54C0F0EABEFC88244640A4B9F3E7F2DE54C0C85DA9ECA5244640944424E296DF54C0F0EABEFC88244640C2234A8013E254C0C00B995E0C224640F22242FB75E354C0D818F7E1861D4640E2AD72F519E454C03CA92C06E0174640A619D99775E454C014108557E80E46408E4F0C69A3E454C074144F83660D46404D7EBBEC0FE554C0C8AF6C2ECC0C46406ADFDB9AC9E554C07071D87E3B0C4640FA2B78E5DCE554C0473529E5E90A46401AB98DF5BFE554C00CED56C6540946406E656D5DEBE554C0E4B0A72C0308464048F53C8F11E754C053CDB76208074640B685E1CC3BEA54C094E7E282CE064640E03BFFA36BEB54C0B0DDA413CA05464076D17592B1EB54C06C14E069950446401AB0C6242AEC54C08CC4B4F13A0146406CA5803088EC54C04C1336528D0046408806A1DE41ED54C030862042AA004640B47F079782EE54C0D4EA029744014640A40A389126EF54C000843B2C6B0146402CE204D6DDEF54C0F87718A7270146409A38DF8FF5F054C03CFBEF470600464066B068B794F154C05C7CE2D2A5FF4540F00DC7BE6DF254C034EFCCC2C2FF4540D3A9B975D7F354C074A04B62700046403A3128C99AF454C04C1336528D0046402433DA6540F754C014BF40AEB4FE4540A664430BF0F854C0EFBD9696ACFA4540CEFA8E053AFB54C03741FF1DBAF04540CF1A61E21FFA54C0531F7BA42EEF45401904F8683AFA54C094A252450DEE454012527144EFFA54C0D8252AE6EBEC45406E1697B6A1FB54C0C876905C7DEB45400AE9C4C3D6FB54C0F3D5FE6D91E94540BE3CE55BABFB54C020EF7F764FE54540C485BFFFDDFB54C040D91E8207E44540BC1C137FC5FC54C040FCDDF9C9E04540B08A5E3760FC54C058A08FFC2BDD4540CEFA8E053AFB54C080506484D1D94540EC21E52FE1F954C0FC4AF0404BD74540B95FA4D36DF854C0EF9B56B7DCD545404ECFFF9543F554C0006EAFB80DD445404AA6F7CEF6F354C0184C2B3F82D2454022B60F74B4F054C050C3DF5A1DD1454012A1B6040AEE54C094971D728DCE454092D8F9DF72EB54C000C0502DD6CD454040E62C6FF1E854C074AD7E66D5CF454062762F1AB1E654C0C0BC301960D34540F6055DB96CE254C02807576705DD4540927EEE65A9E154C0B0DE23ACBCDD454014B344A635E154C050946C77E8DC45407C1DCEB7EFE054C040E5D2ED79DB45404AFE0360A7E054C020B546D96BDA4540FA71F6D461DF54C0E80FEBBE01DA4540FE54119358DE54C09F2F8A224EDC4540CE551918F6DC54C0AC52B8B3E1E14540F8111125DFD954C0F42665E422E84540784667656BD954C0008598F7FFEA45408E41C82DE9D854C057F1D3A55FED4540D40157EDB6D754C0F4835DF9C8EF4540AE2E54D47DD554C098B95D515DF345407E2C6FBE3ED654C0C8013070F2F4454058BC3EF064D754C0605AEF3F49F54540F86E9A20B4D854C0FCA68B8A5CF545403F385FCAE8D954C09C0B6EDFF6F545405EA2464938D454C033FB802E35F74540D0819F604ED354C07CB8225326F84540EAC5DACCFED254C0784F76D20DF94540AAAE9C4715D154C0B4DD35FAF8FC4540E0F95B0187D054C01428ED2ECDFD4540606B696002D054C0DC19E5934AFE4540066A8CCF60CF54C02C4C56BE97FE4540F6A0FA9EC5CA54C0A40BDDF8C7FE4540BA69EA3CF6C954C0DCB0381332FF45403E815B3B79C854C0CBDEDF110101464092D39E42ACC754C000843B2C6B01464092D68BDD88C554C0E40249A1CB0146406AE3B6E769C454C01033D5B5D9024640666012C024C254C0644EAAEDA70646406C06765F2CC154C07C72137D7207464046D9D6E5FABD54C06F9497F6FD084640F64CC95AB5BC54C0C0C608214B0946409AF14F691BBB54C01C6E4951F408464062864FB9F2B354C0D824CD1A570346400C1A140B93B154C0C4D2BC8CBD0046403AF3F05985AF54C09F6866F49CFD454078F323D31EAC54C054E51F3AEDF5454067DBDDC897AB54C007850711D1F34540D308B0BB62AB54C0B80CA9DD2DF14540CA3944550EAB54C0BCDE01DF5EEF45409CA3F85AC4A854C034419004E9E74540420EB5E517A554C03F37962FA0C3454046D4EA6105A354C0C4E04C5CB7B94540880EE85EB1A154C0B754941769A345401ABBFA3F769E54C048A28D2D118D45400C66FD16009E54C0B0B27ADED28B4540AA6420865E9D54C0B80F04DAA78A45404C8315D2A29B54C064C687A30A854540D4B76B122F9B54C048FFA70F15834540994FC716B49A54C0908EA235378245408E0D1BC8A59A54C0F0FF15D03A8245409C83457DA69A54C0D80597BC31824540468523DB889A54C05CD9F7E8DA7D45409A70FD5B8C9B54C0C8C1146EC4794540DEBF85E4009D54C000220140A17545407A1F26F8BE9D54C04FD28F021B7145405E2F314FF49D54C000415AB2966E4540BAABA469DE9E54C0C83652F8E46A4540AC6A34AC0E9F54C0B8B2F768C56845406E49D4BF4F9E54C0A8AB963C2A66454056EEC091249E54C0D8931051316545401ADBF97E2A9E54C0243734F3D16345405072FE5B869E54C0503F52F8776145409CBD5331F09E54C058FC4484105C4540F2B6C68BB8A054C02C54E23AC6524540C696F0A7ADA154C0CC395615594F4540C3CC93D826A354C0887453F8A34B45409163BD74DAA454C0F0FA09973049454092714120F1A654C0E84CEC11D2474540163871B63CA954C0687E178B66474540FC6BA6BB42A954C030BD173E5D47454086A8979246A954C0980413A1E3474540302D4CC4C6A854C04475187BC1484540D088F82EFAA654C008FE635F264A4540987AF09377A754C088C90D1F9A4A45409CA3F85AC4A854C0105074EDBF4C4540602F31DA05A854C05CB08C16DC4E4540D4B100F646A854C083EC3BB02D5045407A16E34AE1A854C080838F2F155145403E8249ED3CA954C07F1AE3AEFC514540ED4FD8C2EFA854C070488AADCB5345406CC1E5216BA854C0FCC2CDF6AD554540DE3792B868A854C0E4E4517039574540E09D519EA4A954C02C0BA015435745403ED9F8B258AC54C08CECAAC9FE58454056FD614223AD54C0405DB0A3DC594540F6F89716A5AE54C0BCEE8FDF3D58454044C25CC0D9AF54C05C0D852B82564540B69EC83C13B154C034D1D59130554540C8D3F388A3B254C0D09241E29F54454068CF295D25B454C0D8EFCADD74534540AE322F211EB454C0C39DBA4FDB504540F8784FA30DB354C01CFF0D772E4E45407CCD77C07FB154C0105074EDBF4C4540CCFFE8EACCB154C0B06E6939044B45404CCB92AA40B254C0A056232F7D4A4540ACCC6F3BE2B254C05730D589734A4540382ACE42BBB354C008FE635F264A454094EB061A91B654C060F60A0661484540F6AF2C8C43B754C07CECCC965C4745400A4E0459ECB754C0EC594343F344454042B6A85467B854C088D5C18A0C424540463C3A1789B854C058F69BEC8F3F4540D07CB3DC58B854C024BAEC523E3E4540BEA124F1C0B754C0338C45546F3C45400142E1D3A8B754C00C5096BA1D3B454054EEC03BD4B754C0182E12419239454042B6A85467B854C0EB4EECA215374540463C3A1789B854C074E0CBDE763545400C6BE99AF5B854C0308CD63A9E3345404EEBD3A0F7B954C0C89EA8019F314540C604F73B20BB54C0B4E3EBF2EC2F4540BE9B4ABB07BC54C094B35FDEDE2E45408813D4E2A6BC54C0EC5AA00E882E4540CCB0A32AB2BE54C0DC425A04012E4540E8B14D42BAC254C088D61E56A12B4540E9170D28F6C354C027F513A2E5294540AC1AC74939C554C02CAF26998F274540543F05E507C854C0100B067D5C2245407C7BB47E59C954C0DCF1155BCD1D454056A2D72F67CB54C054A645F51F104540687D661BFFCB54C0A492C916170E45409A9C307347CC54C04C543567860D4540221A615706CC54C0181886CD340C4540BEEC8E643BCC54C0CF5AE4A8430B454016E2487099CC54C068040AEF2B0A4540CE04D56EC2CC54C078D662F05C084540CA7E43ACA0CC54C05CBE1CE6D5074540B8A3B4C008CC54C034826D4C8406454040E42D86D8CB54C08C116872A6054540F6FA96FFBDCB54C048BD72CECD034540D024A74BA8CB54C078BF57E40C03454056A2D72F67CB54C0772804652502454096169FB025CC54C0EF7EDE1E3D03454057BFBC7170CC54C02C305DBEEA034540CE04D56EC2CC54C074EDFEE2DB044540221774BC29CE54C0B4F01EF751FF44406A975EC22BCF54C064275A4D1DFE4440AAAE9C4715D154C0CCCE9A7DC6FD4440DE36132076D054C09892EBE374FC4440AC1749C82DD054C01B24CB1FD6FA44404464E51241D054C0508F5CB62DF9444056F6995AA6D054C014478A9798F744401F4E51A55FD254C018EA009CC3F84440BC863E98D0D354C0F8B97487B5F7444006CA717FE3D454C0E46764F91BF54440AE2E54D47DD554C09858B24691F14440AED1CAD8A8D654C0E88A2371DEF14440F814FEBFBBD754C000699FF752F044409EB3AA9868DA54C098FBB931EBE944401E429D39EDDA54C0B84E05BEBBE74440B414CB4622DB54C0A4FCF42F22E54440023B19EC2BDB54C078867B12BEE1444034A3BDE7A6DB54C078867B12BEE14440001B470F46DC54C0005E485775E244401C7C67BDFFDC54C0407873773BE244402E57F6A897DD54C0686E350837E144401250725BD6DD54C054B378F984DF4440F0B8BDCAC1DD54C0F83F0C3CD3DD44407ECABB257EE354C0F4B57CAC51DD444048FF17A5F5E854C0F4B57CAC51DD44401EEFCB9F75EE54C0D8CE63E4EBDC4440148D59EE5CF354C0C8E74A1C86DC4440DEF2BCDFEDF854C09C00325420DC44406049FF96FFFD54C0A814D366FEDB4440FE41B2917F0355C08C19198CBADB444002B3B795EE0855C018589FD632DB444011AE0DA34C0E55C0906EE3FBEEDA4440C4B6A8D5661355C07087CA3389DA444094EB0455DE1855C07087CA3389DA4440686509594D1E55C054A0B16B23DA4440ADE1B06F9A2355C0CCA2547E01DA4440B252B673092955C038A5F790DFD944402258E7952A2F55C01BBEDEC879D944406FE301BD963355C034D63FEC30D944406FE301BD963355C0805F1F240FE144405A3294E6ED3755C048D9AF881EE144407FC52D80E53C55C0B8387E551FE144402E2061B3DC4155C0C8A94A2220E144409D8393E6D34655C0D88BE3BB21E14440FC0D2E80CB4B55C0535C7E5523E144409CF794E6C15055C058CD4A2224E14440125BC719B95555C058CD4A2224E1444040EE60B3B05A55C0C82C19EF24E144402D192D80A75F55C0E40EB28826E144400E6B61B39E6455C0E40EB28826E14440B4C594E6956955C0F36117EF28E144402A29C7198D6E55C010D3E3BB29E14440D083FA4C847355C01044B0882AE14440AAD52E807B7855C090144B222CE144401E3961B3727D55C0A0F6E3BB2DE14440C69394E6698255C0AC67B0882EE144403CF7C619618755C01CC77E552FE14440E251FA4C588C55C02CA917EF30E14440C2A32E804F9155C02CA917EF30E14440360761B3469655C0AC79B28832E14440DE6194E63D9B55C0ACEA7E5533E14440FE8361B334A055C0ACEA7E5533E1444074E793E62BA555C0BCCC17EF34E144405239C81923AA55C0D7AEB08836E1444048D560B31AAF55C0E790492238E14440F62F94E611B455C058F017EF38E1444016B5F927F5B555C0143FF93C39E14440501B7CF846B355C0D86786C679E344403ABA5B4A8DB255C00CA43560CBE44440B66820C8F7B155C01C53CFE939E64440363AA4BD24AE55C0A87CACBC8AE9444060D9B68804AA55C088A918BD22F04440EA3CEFC596A655C0E444A58159F844406C313233869F55C0D471EFB4931045404D534793409855C0F84F496EAA20454081E197A15A9355C0D0411F06CA32454090F0A7C17A9155C0EC65F7AE653C4540F840392C088E55C0881A52C8CD5A4540FE8913D03A8E55C048A2AFFA6E7B4540F29AD58C008F55C08BA53E28B67E4540AB37D0C8078F55C0E4E3D2D7467F45408461E014F28E55C0147D0B6D6D7F454032B500ADC68E55C0147D0B6D6D7F45409EE2D29F918E55C0EBEFF55C8A7F4540A2686462B38E55C0EBEFF55C8A7F4540507FCDDB988E55C08C3C92A79D7F4540E445D8638A8E55C024955177F47F45409EE2D29F918E55C034AD97817B804540FC6941F3548F55C0B71BB8451A8245401C51F363309055C01CA039FE008545400E9F6C3FE59055C0340A909621884540D853AD85739155C0783BC6C2378D4540B1E08F1CBD9455C0100889B3849A4540B8296AC0EF9455C078F5B6EC839C4540C0921641089455C09C19207C4E9D4540E8C58FF0F29255C0AB316686D59D4540DF5FD00AB79155C0D46D1520279F45402C69396EB79055C0344F20D4E2A04540DA737F62599055C090302B889EA245409090312BC99455C09CF660048CA04540D2C7418D989555C0D46D1520279F454022910637CD9655C060E8586909A1454083559BC250A055C04CE62FB90EC54540BF80889FDCA055C08774EFE0F9C8454038A6CEBF48A255C0B08DDF0289CD454046FBCBE8BEA255C0389F76CB52D04540AA289EDB89A255C0E08310AD55D54540F4AB757C68A155C0D8F7A4B47AD94540EEC2116FE79D55C04C71ADFF25E045406854F1AA489C55C0C0A4C8417BE445405E858544F49B55C05B7D3F9E3AE94540A9C8B82B079D55C03F2A632B3BF445404AE4C0DC6E9D55C0A41791643AF6454096CD5763899D55C0FCEC7893B2F74540368FC3B3F89C55C0A89748F1A2FA45409247C6A0679D55C088ADA9E5EAFB45407FD2F69A0B9E55C0905020EA15FD45402CBD6AB2C79E55C01762B7B2DFFF4540B3FAF6DCBAA055C0B7A3DA8FB70346405E22221366A155C0B0DDA413CA054640A43C4D332CA155C040290660A60A46408838B680479F55C04C1E8DF26A0E4640726301CB689A55C0D01888C8B5144640E6622CBF649855C0DCA462DA611946403E3EEE23969555C058FBABAD4A234640B4A6C598AA9255C05858A4C2F02A4640CE84411F1F9155C0FC3C3EA4F32F4640AC9D8FAE439055C07413D0EA73354640D0478A00309155C0708764F2983946400E9F6C3FE59055C0178FBD4B5E3B4640EA8BC56CE09055C084B6B508703F46406E46AD6F8E9055C0B4FE872705414640CE2AA5BE269055C07887D30B6A424640CE872EBAFB8E55C02455D1FAED4A4640AA7487E7F68E55C090E57538184E464006F0D2B5768F55C0B44FCCD0385146406E46AD6F8E9055C09093D4C34F544640D20AD3E1409155C0E4AEA9FB1D584640FCC3DD534D9055C098659CDE515B4640E2828F82798E55C0C0389FF78A5D464022A0A73D1C8C55C0338F79B1A25E46402083C2FB128B55C0CC7E8C00E15F464036416CA5A18A55C063D74BD0376046404A3CCD6D1F8A55C08C6461E01A604640BA9594C2138955C0038D949B635F4640EE1D0B9B748855C0D4F35B063D5F46401614CD2B708755C0BC6646F6595F46402240C28D998655C00C99B720A75F46404E05F084E98555C024BD20B071604640F4C65BD5588555C0C4B85684F361464096E26386C08555C0583FBD52196446409A0E59E8E98455C0BCB78A9F8D6F4640149128042B8555C0D0B834B79573464076FBB115E58455C0309A3F6B5175464032B87E2ED28355C000985A55127646403641FD8BD08155C000985A55127646406CD596E9748155C040B28575D87546405F43E2A10F8155C05C3378007875464052EEE478998055C00C0107D62A75464041D69E6E128055C00C0107D62A754640BA3B89484A7F55C090E4F69F257646406E55DF5C0C7D55C0FFAE6561627B4640D482B14FD77C55C018D3CEF02C7C46408C5C63AACD7C55C0781D8625017D4640149DDC6F9D7C55C070A8B61FA57D4640FFFE04A3F47B55C078B4D9A4E87D4640380D0D3E777B55C09C41EFB4CB7D464019E9A3AEAC7A55C038035B053B7D464052F7AB492F7A55C0609070151E7D46407EB0B6BB3B7955C00752DC658D7C46401886D1634D7755C02099046D1A7A46403AB94A13387655C0BC5A70BD89794640F638600D367555C068BF5212247A4640FC279E50707455C030489EF6887B4640904E1F6F137155C038F7A699C8854640F2F55F9FBC7055C05CCAA9B2018846406EA4241D277055C0D420846C198946405A093AEB5A6D55C06F62A749F18C4640359CF6B75D6C55C0D043B2FDAC8E4640EA98678A166955C033769241CB974640F687A5CD506855C09CCC6CFBE29846400277E3108B6755C0148CF335139946409C2C2CDCB66655C07F3F57EBFF984640566F8AB7C56555C0A4D88F8026994640D27AD830056455C070045269B69B4640C4CB3EA7966255C0385FF64E4C9B464081EECAA5BF6255C0DC7DEB9A90994640309C879E8C6355C0245E4C3744974640D27AD830056455C0202482B331954640781C72A48E6455C0481A44442D944640A00F479AAD6555C01075E829C3934640E0CCE8BE9E6655C0E8383990719246409A69E3FAA56655C0D043B2FDAC8E4640043D198D786555C0CCC3FA70448A4640632111DC106555C03C31711DDB8746402C1309418E6555C01B01E508CD86464032B67F45B96655C0A8AA0A4FB58546400C464F77DF6755C0E87E48662583464028F049C9CB6855C0E4AD2A632B8046401AF5E8004E6955C078B4D9A4E87D46409AC37F5B9E6755C0744B2D24D07E46405F98927E126755C0CFF26D54797E46409A69E3FAA56655C0609070151E7D4640081D47B0926655C0FFAE6561627B4640363C1108DB6655C0BC5A70BD89794640A97E3C6A506955C01899955349714640128C3C80356A55C0DB0AD62B5E6D46402A0D2F0BD56955C0C8B8C59DC46A4640749006ACB36855C04C10DB5513674640888B6774316855C0B820C806D5654640A6FB97420B6755C04BCAED4CBD64464004E08F91A36655C02CE04E41056646402AAA5CC0756655C04CA72ED5FA6746405626B013936555C084FB2379D3694640B0CDF0433C6555C0A0C2030DC96B4640609B7F19EF6455C0BCB78A9F8D6F4640C205092BA96455C0DCE716B49B704640980611B0466355C0C4099B2D277246403AC87C00B66255C010D35FD75B734640422E3CE6F16355C07F1D170C30744640BCBC2E87766455C0589001FC4C744640FE33E3A2116355C0333DB66F7C7646409EF54EF3806255C03BE02C74A7774640E60F7A13476255C0DBDB6248297946406C8DAAF7056255C050782A0B977C4640CEF73309C06155C06C3F0A9F8C7E4640A01521D0666155C0BC08CF48C17F46405EDE106E976055C05B6DB19D5B804640AD6D0B94B95F55C09C87DCBD218046404CA9E521075F55C0C47D9E4E1D7F4640208A1BCABE5E55C09435CC2F887D4640BA9900F6E25E55C018D3CEF02C7C46401A9BDD86845F55C02FB14A77A17A4640ACAAC2B2A85F55C0DBDB624829794640670A06D0C05F55C0E40A45452F764640DE4F1ECD126055C08086C38C48734640187B0BAA9E6055C0DCE716B49B704640A01521D0666155C0D0A129AB456E4640D49AAA0DEB6255C060A8D8EC026C46408E807FED246355C07011856D1B6B46409043C8CE356355C054B3515A3E68464007034F09666355C0D850541BE36646402AAD495B526455C02031B5B796644640524682F0786455C0D067F00D62634640D8C3B2D4376455C08CAA4EE970624640309C879E8C6355C0C4B85684F36146403C8BC5E1C66255C0CCC479093762464072D6849B386255C0C85BCD881E634640508C00E0FD5D55C0EC221C36E56D46405E41749F255B55C08C7B4A1F0D774640CE409F93215955C05C04051D438146408E83FD6E305855C06F62A749F18C46409A6F4E178E5955C0E0664FA8119D4640D27D56B2105955C0188C624FE4A14640086F790B8A5755C098344D9795A54640087266A6665555C05C6C320569A846408A4CB16C294B55C0D488B1543FB04640BC14CCFE554855C044D3688913B146408C1BAEB9AC4255C034BB227F8CB04640F0E5AD61183F55C0A486CC3E00B14640A6A56715E23B55C0741B3BA8A8B2464004E7E85F4F3A55C0E8B7026B16B64640E7390173863B55C04802BA9FEAB6464064DFFE1F5B4155C034181B9432B846403EAC8570704255C077D5BCB823B946403A230713724455C0903F135144BC4640669C6DCBB24555C0245DCD9E51BF464060F6092CAB4655C020D161A676C34640FF1112DD124755C074838A5D2CC8464010D0BB86A14655C0C735B314E2CC46400AE46ADE434555C004C4723CCDD0464016B6C3DF744355C07CC9E67F53D3464029119B3EA43F55C02C172DE26ED746403C957A64203D55C050C77083E5DC4640005E6A02513C55C020C58B6DA6DD4640701DF13C813C55C0A79C58B25DDE46400867A0ECB73E55C08CEC832AB8E1464029119B3EA43F55C0F4425EE4CFE2464029119B3EA43F55C0A8B363BEADE34640686B6A18363D55C0A310EDB982E24640FE0072EDAA3455C04CD2580AF2E1464019EB10F9623355C08883D7A99FE24640064D392CBA3255C0D84C9C53D4E34640F8F73B03443255C08FD5E73739E5464094331691913155C098785E3C64E6464068BAAFD8503055C038DD4091FEE646406C9DCA96472F55C098785E3C64E646406E630013352D55C0A8B363BEADE3464001030000000100000018000000204CE45AA91955C028C5FA8677E6464008287BCBDE1855C098E10ABD7CE546400AEEB047CC1655C0602469988BE4464067B2D6B97E1755C0989B1DB426E346406E554DBEA91855C0F4651D5C92DF46401A030AB7761955C0A79C58B25DDE4640ACA94262821A55C0E0AA604DE0DD4640445C9E92D11B55C0BC1128B8B9DD46402C3548682A1D55C0E0AA604DE0DD4640723BC4304E1E55C0A79C58B25DDE4640005C6B19381F55C05C0D5E8C3BDF464094E2D1E75D2155C0F4425EE4CFE246408C7638CC682455C09F8481C1A7E6464066FAE4784B2555C0F35969F01FE84640C0FEAEA4C92355C01C96188A71E94640CC9350870B2255C0FBFCDFF44AE9464040D31F35D31D55C05B01AA20C9E746400C4E96F74E1C55C0E09EACE16DE64640F8AFBE2AA61B55C098785E3C64E64640344458884A1B55C048F5869B85E74640EA5AC101301B55C0CC63A75F24E94640932850D7E21A55C00C1526FFD1E94640BEE15A49EF1955C0F35969F01FE84640204CE45AA91955C028C5FA8677E64640010300000001000000130000002AB6102CE85D55C0F35969F01FE846404074BAD5765D55C0D4C0305BF9E746407882C270F95C55C03C80B79529E84640208D08659B5C55C0AC331B4B16E84640642DC547835C55C0B09CC7CB2EE7464068B3560AA55C55C09F8481C1A7E646402A5C74CBEF5C55C0FC1F9F6C0DE64640EEC7DA6D4B5D55C08054F5AC99E5464046BD9479A95D55C050BBBC1773E546400646E05D0E5F55C03C3ACA8CD3E54640CA0BE360626055C08B038F3608E74640E22F4CF02C6155C0ACCA6ECAFDE8464067AD7CD4EB6055C0FB42CDFDA0EB4640D3DA4EC7B66055C0EC2A87F319EB4640370821BA816055C0C8914E5EF3EA46400EAC9F434A6055C0746B00B9E9EA4640B83C77FA0D6055C04FD2C723C3EA464000FD05BADB5E55C01C96188A71E946402AB6102CE85D55C0F35969F01FE8464001030000000100000013000000CA76FC2B311855C08BB1CBF4E1FE46408EE262CE8C1855C078F60EE62FFD464024D562B8A71755C0F0B5952060FD464056D747CEE61655C070EAEB60ECFC4640D2850C4C511655C0E006FC96F1FB4640C6F35704EC1555C08831146879FA4640D608B173961855C0ACCA4CFD9FFA46404622D40EBF1955C0C7E2920727FB46400D6E68D4341B55C02F396DC13EFC4640CA730F91541A55C078F60EE62FFD46408EDF7533B01A55C08002326B73FD4640932850D7E21A55C0880E55F0B6FD46400CAB1FF3231B55C000CEDB2AE7FD4640F8AFBE2AA61B55C0206714C00DFE4640F8AFBE2AA61B55C0D4D7199AEBFE464032810FA7391B55C09CC911FF68FF4640CA730F91541A55C07CDF72F3B0004740D608B173961855C0EBFB8229B6FF4640CA76FC2B311855C08BB1CBF4E1FE46400103000000010000003D000000DD27E132F8E354C044C5B6ECBB094740665C377384E354C013E6904E3F074740BEF7541EEAE254C057237BE6C7034740F76E093A85E154C09BA65287A6024740108A3CDFE8DF54C01CDBA8C732024740789A2990AADE54C07CDF72F3B00047407DE30334DDDE54C07C30D96942FF4640783DA094D5DF54C0785FBB6648FC46403FA1785BD3DF54C0E0C347FC45FC46403A405AB618E154C0F4AAAD9953F846403AE3D0BA43E254C0A8E1E8EF1EF7464076747D7D0BE454C00C892920C8F64640FCEEC0C6EDE554C05CBB9A4A15F7464030744A0472E754C074DF03DADFF746401C76FCA017EA54C0CC4B3F883FFA464070889BEE7EEB54C014728D2D49FA464038D42FB4F4EC54C0F4AAAD9953F846409012C46385ED54C05C52EEC9FCF7464017EA90A83CEE54C06B6A34D483F84640344BB156F6EE54C0848E9D634EF946408E4C8EE797EF54C0700DABD8AEF9464072421DFFF9F154C0700DABD8AEF946407A4E40843DF254C04474724388F9464024766BBAE8F254C04CE94149E4F84640591BC7D452F354C0BC9CA5FED0F846400CB8C1105AF354C0C4A8C88314F94640F436CF85BAF354C08831146879FA4640066CFAD14AF554C0282D4A3CFBFB46406224FDBEB9F554C0B0041781B2FC4640D72C5E9D1CF654C058751C5B90FD4640825489D3C7F654C06018935FBBFE4640E255666469F754C094BDEE7925FF46400E7530BCB1F754C0F8C1B8A5A3FD4640F26DAC6EF0F754C040E8064BADFD464024D6506A6BF854C048F429D0F0FD4640CA2E103AC2F854C0448B7D4FD8FE46409C95D7A49BF854C07CDF72F3B0004740E255666469F754C0207E1FCC5D0347406CF368250EF654C02BF3EED1B9024740891ABF4FB5F454C063525DE3CD0047406064A17885F354C03722D1CEBFFF4640B4792D61C9F254C0543A17D946004740900CEA2DCCF154C0E4CCA02CB00247401241406E58F154C0F4E4E636370347405E4AA9D158F054C0207E1FCC5D034740FAC23A7E95EF54C057237BE6C703474012A1B6040AEE54C05FC6F1EAF2044740BA0886F480EC54C00837F7C4D0054740EBCDB3EBD0EB54C043E875647E064740E03BFFA36BEB54C0408BEC68A9074740E8614C386EEB54C044C9E19BD40847406EC5520D6EEB54C0432E636DD4084740044FA67670EB54C02838A1DCD80947403C0025161EEC54C0A40F6E21900A4740EE3373D10CED54C0AC1B91A6D30A47400C58DC60D7ED54C0186648DBA70B4740981EE7E8C8ED54C0F006DAC9930D4740CE03E7BCFEEB54C048456E79240E47406ADCEEFFECE754C0ACECAEA9CD0D4740061BB62817E554C040F35DEB8A0B4740DD27E132F8E354C044C5B6ECBB0947400103000000010000000D000000B3C497D4430755C09C6B9A51D01F4740387C923C150955C0D8E24E6D6B1E4740F641953F690A55C044C4592127204740AEBEBD9E8A0B55C080BBC5C92A234740FC878248BF0C55C0C82701788A254740847F216A5C0C55C0D36DEE80E02747407CBCD8884B0C55C0C49B957FAF294740BCCAE023CE0B55C09CA5D3EEB32A4740C922CBE7200A55C09CA5D3EEB32A4740F2188D781C0955C06C5D01D01E2947402D538A75C80755C09019F9DC07264740F0583132E80655C0D456E37490224740B3C497D4430755C09C6B9A51D01F474001030000000100000021000000CC6F35FCE7A855C0B08E152FD73F474000F8ABD448A855C01836565F803F474050C45D195AA755C01F4279E4C33F4740E879A6E485A655C0A882F2A9933F4740BC5ADC8C3DA655C0C0606E30083E474082898B10AAA655C02065385C863C4740544AEFDB7BA755C0A0998E9C123C4740CC6F35FCE7A855C0175915D7423C4740EDBF93EDDBA855C0688B8601903C47408A92C1FA10A955C018F068562A3D474028EB80CA67A955C0702EFD05BB3D474032BAEC30BCA955C0C0606E30083E47403C89589710AA55C02808AF60B13D4740B448DFD140AA55C0A7A5B121563C47405664E782A8AA55C0175915D7423C474020DC70AA47AB55C028715BE1C93C4740F88B12B953AB55C0F0625346473D4740683F766E40AB55C0EFF9A6C52E3E474003D5EC5C86AB55C0B08E152FD73F4740CA039CE0F2AB55C09CA476231F414740400CFDBE55AC55C08C3BCAA20642474026C8C152A5AC55C08CD21D22EE4247409E87488DD5AC55C077E87E16364447404C9EB106BBAC55C00F872BEFE2464740CCC6E4C103AC55C02442E8FD944847400C877381D1AA55C0D3A6CA522F494740D701EA434DA955C094F54BB3814847405AED65E0A6A855C00C1E7F6ECA47474070AB0F8A35A855C0803A8FA4CF464740560D38BD8CA755C077E87E1636444740C0DD80B482A855C0E061184810424740CC6F35FCE7A855C0DCBEA143E5404740CC6F35FCE7A855C0B08E152FD73F4740010300000001000000E4020000C6AE0E89812156C004108085FF85474022D0BDF6082156C0E0EB16F634854740CE17BB099A2056C0A0D1EBD56E85474098725FEF2F2056C0B0E931E0F5854740D243B06BC31F56C004108085FF85474063EDD5B1AB1E56C0408734A19A844740885D0680851D56C09073B8C29182474066B30B2E991C56C0F4E02E6F288047407D34FEB8381C56C0C80109D1AB7D4740847DD85C6B1C56C08416C0ADEB7A4740E0F8232BEB1C56C06BAC6915CB77474068D0F06FA21D56C078DB4B12D1744740A40701D2711E56C0982E979EA1724740521247C6131E56C04C65D2F46C7147407462A5B7071E56C0FC9B0D4B387047400835D3C43C1E56C0ABD248A1036F47403EDA2EDFA61E56C0A82FD29CD86D474022D3AA91E51E56C0C81971A8906C474088007D84B01E56C0302A5E59526B4740EE4D2154611D56C01835D7C68D674740E80447B02E1D56C0FF106E37C3664740109E7F45551D56C02F13534D02664740B47CD0D7CD1D56C0B047A98D8E654740147EAD686F1E56C0CFC89B182E65474092CFE8EA041F56C0C0B0550EA7644740A0DB0B70481F56C054669ED9D2634740A244B8F0601E56C0EF1BE7A4FE6247407D34FEB8381C56C0B0DEFC0C7666474007D5ED14BA1856C0E03DDA375B6D4740066C4194A11956C08039100CDD6E4740E80A21E6E71856C0EC83C740B16F474036711345BD1656C0CC02D5B5117047405867D5D5B81556C00CB45355BF704740D2EC918CD61356C0B85E23B3AF734740D67510EAD41156C0504E3602EE744740C1DA25B8080F56C044B6A784CF7847407FA602F1150C56C03887C587C97B4740F0C212271B0B56C0DBEBA7DC637C47406948CFDD380956C0642C21A2337C4740E75C5341DF0956C048591E89FA79474076D7968AC10B56C07F2D5CA06A77474084834379530F56C0C0019AB7DA7447403E86FD9A961056C09C97431FBA7147403B662BBEB01156C04088916C2F6E47406AA2DA57021356C07F5CCF839F6B47406AA2DA57021356C0683866F4D46A4740A793FDB07B1156C09CE9E493826B47406EC599CFC40F56C030704B62A86D47408429A7185B0E56C0BC81E22A72704740724E182DC30D56C00CFA405E157347404C1E8C18B50C56C090686122B474474010ED55EC9E0756C0407CDD00BD7647405067F7A2160456C0C04787C030774740C87EF987C8F955C0DF3126CCE8754740BEF50B11F9F255C0140664E358734740A40E5AA01DF255C064893B8437724740C015DEEDDEF155C0D4A54BBA3C7147408A27A82F42F155C0FC3261CA1F7147406CC6878188F055C0D4A54BBA3C714740C661A52CEEEF55C08373DA8FEF70474044D3B28B69EF55C07BD0638BC46F4740EAD1D5FAC7EE55C0C7B0C427786D4740FA46A50024EE55C0C81971A8906C474096BF36AD60ED55C0988038136A6C47405F77648ECBEB55C01F580558216D4740BB9813FC52EB55C000BFCCC2FA6C47405E5A7F4CC2EA55C0E46099AF1D6A4740BF7B2EBA49EA55C0DCBD22ABF2684740C82DB5DE94E955C0ECD568B579694740E81754EA4CE855C09B3A4B0A146A47405A34642052E755C06C5B256C976747405E177FDE48E655C06438F7DA03624740D3B920D76FE555C00357EC2648604740B698A4E281E255C0648A984FCC5B4740C60D74E8DDE155C020C1D3A5975A474000DFC46471E155C044141F3268584740DAAE385063E055C01C411C192F564740640F84F218DF55C0D8EC267556544740FAF56057F0DD55C08C2362CB2153474044DFF7DD0ADE55C054CF6C27495147405654C7E366DD55C00406A87D14504740068EEFD40EDA55C0707F41AFEE4D47405E66C49E63D955C01841ADFF5D4D4740E4E3F48222D955C018AA5980764C4740709EDC85D0D855C0681626150546474072078906E9D755C0089EC7E161434740640F15D947D655C074AEB49223424740A68F90C578CE55C03C5ABFEE4A4047406AA447A2B8CB55C004FB50DD364247407210E1BDADC855C0A4B099A86241474084EE5C4422C755C01B7020E392414740DE4CC3D098C655C0E86D3BCD534247402993E35288C555C058678C8B9644474066277DB02CC555C0205984F0134547402E1C62B086C355C0A899FDB5E3444740CED1AA7BB2C255C0900CE8A5004547404A806FF91CC255C0E84A7C5591454740C4A8A2B465C155C0772E6C1F8C464740A2C1F0438AC055C0C860DD49D94647403FB4F02DA5BF55C0087B086A9F46474068F38C62D3BE55C0B03C74BA0E46474052926CB419BE55C0B0A5203B2745474094AC97D4DFBD55C080F4A19B794447400260FB89CCBD55C05CD0380CAF434740871AE38C7ABD55C00C0774627A424740F8DC566287BB55C0402C18F07B3E4740E601C876EFBA55C0C0606E30083E474038540B7E22BA55C00887BCD5113E4740B27C3E396BB955C047A1E7F5D73D4740CCC079A51BB955C0E04A0D3CC03C4740B722A2D872B855C054D0C9F2DD3A4740CA001E5FE7B655C0049E58C8903A4740480C6CD826B555C0F82889C2343B474068F60AE4DEB355C0175915D7423C47406E42D222EEB155C084E9B9146D3F47406319CA5BA1B055C00CC1865924404740CAA3254A41AF55C0402C18F07B3E474033775BDC13AE55C040E62AE7253C474058E78BAAEDAC55C03843B4E2FA3A47404CFB3A0290AB55C0049E58C8903A474032BAEC30BCA955C0BC770A23873A474036407EF3DDA955C060397673F6394740AEFF042E0EAA55C09CB02A8F913847401CFC42872DAA55C0447296DF003847408D75DCB807A855C0A4BC4D14D5384740469B55520DA655C0DCA79637953B474005E1A0C8F8A255C08C3BCAA206424740090D962A22A255C0089EC7E161434740D09BBB44409F55C0C860DD49D9464740861BD13E3E9E55C0209F71F9694747403972DE71EF9B55C084DD05A9FA47474076461C895F9955C00BFBBFF6074B47405C6831E9199255C03C14B018974F47409D8E1075528955C044141F326858474040AD05C1968755C0A418E95DE656474098A5AC67D18555C0244D3F9E72564740C24D8603477B55C0AB6AF9EB7F594740AACF8013847955C04B662FC0015B4740C68D2ABD127955C0A4F529E6235A474059A0FC83137755C0FC33BE95B45A4740A01521D0666155C08FA319588A5747403ACE56366F5E55C0147BE69C415847401E70B409C15255C054895D519560474050E11FD6D14C55C0F7270A2A426347403C49223FE24755C054669ED9D2634740AAE57AE87E4255C00CA9FCB4E16247403A837DA9234155C014B51F3A25634740246E243A793E55C06F7EE4E3596447401AFC41CFF93C55C0C0B0550EA7644740BA9DDB42833D55C098DD52F56D6247406C9472DF823E55C04C148E4B3961474006FEF36B9F3F55C020E401372B604740DA81A018824055C0F09B2F18965E47400864B351DB4055C06021ECCEB35C4740546A2F1AFF4155C067731E2AAB4D4740C80CD112264155C03C66518D5F494740B897010DCA4155C060B99C1930474740F428AECF914355C077E87E1636444740C2C009D4164355C04C219F8240424740F90BC98D884255C01CD9CC63AB4047404C5E0C95BB4155C0A882F2A9933F4740DA81A018824055C0081E1055F93E4740027862A97D3F55C0C403E534333F4740B6174A80613D55C0D4B27EBEA1404740C0433FE28A3C55C04B7205F9D1404740D0B80EE8E63B55C09C0D23A437404740D121BB68FF3A55C0ACDF7BA5683E4740585611A98B3A55C0C0606E30083E474076608291293855C0A83C05A13D3D4740ACAE2EE6773555C00CAA7B4DD43A4740CEA4F076733455C0BC770A23873A4740FABA84E4543255C00CAA7B4DD43A47403AD89C9FF72F55C00841CFCCBB3B474038184159C32D55C0A83C05A13D3D4740000D26591D2C55C084E9B9146D3F474048366199032A55C0E433714941404740F806DD09932755C0783A208BFE3D47407B5B0527052655C04CC4A66D9A3A47408E3694129D2655C0447296DF00384740F8AF2D44772455C04844EFE031364740EA5D1DB6DD2155C0B38EA615063747407458A972571F55C03C150DE42B394740F2EF6C666D1F55C08BF2BE88943A4740560B457D9C1E55C00CF85932B53B474012CCF93EC91D55C0EC9797BC343D4740D977D79CAD1C55C0F4D35832AF3E474048D9B15D161B55C0C035077A7B414740AE421CE1F01855C0A04BE9F4974247408E8322DB8E1655C0B8C3953CE9424740B6052DB28A1355C07086D1A934404740E69C231B7D0F55C0C89D1A28634347402C42E550A00C55C0CFC40A17EF4547405F751884730955C0842B30D64A45474022C91F7E110755C0C89D1A2863434740E67701F9290A55C0942720C5773747405F751884730955C0880631562F33474005FDEC4A420855C070C9E5D7003047407A7CB25DBF0655C0E44B69C3822C474038BB81C7C70655C0D82345FD552C47400234C01D800755C00887DEA26F2C4740264767F0840755C0480AB6434E2B47403016D356D90755C09499B069702A47403A3FDB1D260955C0A0484AF3DE2B47402D509DDAEB0955C090C757683F2C474062D52618700B55C0E0F9C8928C2C4740D2888ACD5C0B55C0A8EBC0F7092D47407AF6A20C5E0E55C028B76AB77D2D474029C431E2100E55C0CCF81E7B84284740AE7E19E5BE0D55C0B7A60EEDEA254740A286A5B71D0C55C0D456E3749022474062D52618700B55C0D410F66B3A204740BC6D5728F90C55C05C516F310A204740000B2770040F55C0708C74B3531D474055E00E9F7C1055C030DBF513A61C47403490B0AD881055C0242C5C8A371B4740E6C6EB03540F55C05CF4761C641847408EF103D5DB0D55C010945EF3471647400E1A3790240D55C0E09179DD08174740130975D35E0C55C074818C2C471847406C011C7A990A55C0EC401367771847402CEADDF4AF0855C0C49BB74C0D18474098BD1387820755C05C5D239D7C17474080E2849BEA0655C0C7D6BCCE5615474053C3BA43A20655C07098281FC61447408E940BC0350655C098253E2FA914474048D7699B440555C000E5C469D914474082A8BA17D80455C07098281FC6144740088374F76B0355C0D8A815D087134740F2215449B20255C0A403BAB51D134740F48A00CACA0155C0A403BAB51D1347400D668FB5620255C074BBE79688114740FCF0BFAF060355C0DBCBD4474A1047400A46BDD87C0355C018438963E50E4740E7F55EE7880355C088C8451A030D47409600A5DB2A0355C06898B905F50B4740D8E00578DE0055C0408BEC68A90747406C4D749FD7FF54C0A08FB69427064740027D2BA8E1FE54C0D89DBE2FAA05474006604666D8FD54C070DE37F579054740FB363E9F8BFC54C05FC6F1EAF204474070D9DF97B2FB54C0F07B3AB61E04474036651817F4FA54C0ECD8C3B1F30247403A910D791DFA54C014CF8542EF014740A8278CEC00F954C09403DC827B01474096EF730594F954C020FE673FF5FE4640C64BF57BCBF954C040E8064BADFD4640EC21E52FE1F954C02F396DC13EFC464056F22D27D7FA54C0B8103A06F6FC4640F0A19CBC49FE54C02F396DC13EFC4640BE9FB7A60AFF54C050BA5F4CDEFB464066049AFBA4FF54C01009E1AC30FB4640EA55D57D3A0055C04817E947B3FA4640B690A786EA0055C050230CCDF6FA4640A19546BE6C0155C0CFEEB58C6AFB4640C5965FEF450E55C094BDEE7925FF464098BA9505771255C0D4D7199AEBFE46406BF5670E271355C0280A8BC438FF4640943117A8781455C074D34F6E6D00474066F27A734A1555C07CDF72F3B0004740E6806D14CF1555C074D34F6E6D004740B035AE5A5D1655C0D46E6D19D3FF4640C2C762A2C21655C0280A8BC438FF46400AEEB047CC1655C0D4D7199AEBFE4640C0A790C5DC1755C09CC911FF68FF464060660F7B6F1955C0B484CE0D1B014740FE9B0FD3031D55C09C0FFF07BF01474034416BED6D1D55C063525DE3CD004740D55C739ED51D55C0206714C00DFE464012EE1F619D1F55C07CDF72F3B0004740DADF17C61A2055C02BAD01C9630047403EB060BD102155C0DCE33C1F2FFF464094E2D1E75D2155C0D4D7199AEBFE464082AAB900F12155C0448B7D4FD8FE4640AB063B77282255C09CC911FF68FF4640D8DC2A2B3E2255C0B484CE0D1B0147404FE58B09A12255C0FBF009BC7A034740DEC87BD39B2355C0876B4D055D054740C4DEDCC7E32455C010431A4A14064740A4F43DBC2B2655C05FC6F1EAF2044740A06BBF5E2D2855C004CE4A44B8064740DEBFB402062A55C0CCBF42A935074740C6985ED85E2B55C0485122E5960547408CD330E10E2C55C0448B7D4FD8FE46407C158737802C55C02873374551FE4640B6C605D72D2D55C007DAFEAF2AFE4640D6ADB747092E55C078F60EE62FFD46407C129A9CA32E55C01815043274FB46400E5F36E7B62E55C07819CE5DF2F94640BC697CDB582E55C02C5009B4BDF84640CA1B0300A42D55C074DF03DADFF7464052FFF2C99E2E55C0D0D7AA801AF64640EDD120D7D32E55C0E012B00264F3464026E02872562E55C0FC59D809F1F046406E630013352D55C0B49C36E5FFEF4640CF0754A8012F55C0007D9781B3ED4640364F1E42F93155C03C2E162161EE4640B460B50AC33455C0F44DB584ADF046402E3D2187FC3555C048BAF0320DF346403E556791833655C000DA8F9659F546406ACECD49C43755C054AF77C5D1F6464008CA031E463955C0B8F92EFAA5F74640585611A98B3A55C074DF03DADFF746406CF4E875343B55C0E429BB0EB4F846409DF3E0F0963C55C018AC57B15BFC46404358C345313D55C078F60EE62FFD4640CDF2D86BF93D55C0901A7875FAFD4640F6882466434055C08482E9F7DB014740CE55ABB6584155C0F4E4E63637034740A4F0626F8B4755C0ECA9E1B4ED054740A65335BAEA4A55C09C54B112DE084740B402CF43594C55C0F49245C26E09474044499158B35055C06852CCFC9E094740020F945B075255C09C034B9C4C0A47400E5581645D5455C09BD4689F460D47401241D20CBB5555C018AC35E4FD0D474065902879115755C017FD9B5A8F0C4740561B5973B55755C06FA4DC8A380C4740958F20F4735855C088C8451A030D47408AA0E2B0395955C0001F20D41A0E474082EE5B8CEE5955C0E8A950CEBE0E474022533EE1885A55C0C4101839980E4740642DC547835C55C088C8451A030D4740CA71A2469E6155C0C879C4B9B00D47406A24FE76ED6255C017FD9B5A8F0C4740F321E6E7146755C05FC6F1EAF2044740F84AEEAE616855C03CC547D3EA0047403C4547F2416955C0D4D7199AEBFE4640392575155C6A55C0206714C00DFE46409AC001DA927255C02873374551FE46401883E4C8707955C028C49DBBE2FC4640AEAFAE369E7A55C097E0ADF1E7FB4640508EFFC8167B55C0C43F1C03FCF946404882DC43D37A55C0CC6EFEFF01F74640798A0AA99C7E55C0CC4B3F883FFA4640743B56CFB08255C02F396DC13EFC4640A057338C1C8555C020B87A369FFC46401A8EAA821F9055C038FFA23D2CFA4640EC4B21B3149355C098C9A2E597F6464056BFE0AE359555C0E0CCC2F90DF146406C7A9DBDE79655C00C1526FFD1E94640C79B4C2B6F9655C00C7ED27FEAE846406C7A9DBDE79655C0F35969F01FE84640D80D2F96EE9755C040E9631642E74640E0166580559A55C0CC1DBA56CEE64640B65D5A0E499B55C098785E3C64E6464010165DFBB79B55C0A0ED2D42C0E54640B6B7F66E419C55C04818461348E446409E3604E4A19C55C0A8B363BEADE34640D09BBB44409F55C04CD2580AF2E14640BEBD3FBECBA055C01C392075CBE146402245AE118FA155C0142DFDEF87E14640958AC60EE1A155C06CBCF715AAE046404F27C14AE8A155C05C0D5E8C3BDF4640E436A6760CA255C07CF7FC97F3DD4640EE0512DD60A255C08060A9180CDD4640A2198EBB69A455C060301D04FEDB46409C732A1C62A555C0AB28C4AA38DA4640C8EC90D4A2A655C03BE985E39FD54640AEA85568F2A655C08003B10366D546405287A6FA6AA755C010504D4E79D5464016B6557ED7A755C0DFB614B952D546408D75DCB807A855C060D324EF57D44640F628406EF4A755C084D5090597D34640EC59D407A0A755C0883293006CD24640560D38BD8CA755C093A76206C8D146400761585561A755C09C1C320C24D146406CCBE1661BA755C02CBA34CDC8CF464090DE883920A755C0B057378E6DCE46403A06B46FCBA755C010F35439D3CD46402891E4696FA855C06025C66320CE4640D2B80FA01AA955C03023E14DE1CE46401CFC42872DAA55C0CC1E172263D046405ED6C9ED27AC55C063A57DF088D246409E87488DD5AC55C0E0077B2FE4D346406C85637796AD55C0E04D68383AD646403C29E2005FAD55C0ECFC01C2A8D74640B065C4134AAB55C0B434E72F7CDA4640C6236EBDD8AA55C070B10F8F9DDB46401CFC42872DAA55C0EC59FAD64EDF4640A2B62A8ADBA955C0B44BF23BCCDF46402AAEC9AB78A955C0E4E42AD1F2DF4640F6CBB6721FA955C02C0B7976FCDF4640CC6F35FCE7A855C0ECF04D5636E04640ECFC4A0CCBA855C0FC089460BDE046409E8D22C38EA855C08077B4245CE2464094BEB65C3AA855C030F4DC837DE34640240B53A74DA855C0983271330EE4464094BEB65C3AA855C078B17EA86EE446407A20DF8F91A755C0602469988BE4464091FE5A1606A655C0602469988BE44640A7BC04C094A555C078B17EA86EE4464088D5524FB9A455C0D84C9C53D4E34640E4F601BD40A455C0A8B363BEADE346405024D4AF0BA455C0B0BF8643F1E34640B8D73765F8A355C0602469988BE446405024D4AF0BA455C0FF884BED25E54640E4F601BD40A455C050BBBC1773E546400E903A5267A455C0E8AACF66B1E64640F242C9FB4FA255C00C2C310B22EF4640952D3D130CA355C0FC59D809F1F04640D21B73D1A8A355C0D4631679F5F14640A4DCD69C7AA455C0DC6F39FE38F2464061A2D99FCEA555C0147E4199BBF1464024A593C111A755C0448026AFFAF0464044D51FD61FA855C06C76E83FF6EF4640F4086E910EA955C0433A39A6A4EE46405D166EA7F3A955C0E8582EF2E8EC4640B2280DF55AAB55C070025438D1EB4640C45D3841EBAC55C07099A7B7B8EC4640CAA3254A41AF55C00C2C310B22EF46405ED0EFB76EB055C00C2C310B22EF46406C7F8941DDB155C020AD2396C1EE46403E40ED0CAFB255C04097C2A179ED464096DB0AB814B255C04FD2C723C3EA46405A47715A70B255C0B4D6914F41E94640FE25C2ECE8B255C0AC331B4B16E84640100151D880B355C0B09CC7CB2EE74640BBAE0DD14DB455C098785E3C64E64640BBAE0DD14DB455C008FE1AF381E4464068F31D4902B655C08C5530ABD0E046405235749F73B655C028680272D1DE46405EC728E7D8B655C0D79E3DC89CDD46407A712339C5B755C090E19BA3ABDC46405A3EAA89DAB855C0A7566BA907DC464020D318F382BA55C0B8D75D34A7DB4640068CF0EBF5BC55C0B434E72F7CDA4640871AE38C7ABD55C00CC4E1559ED9464024B0597BC0BD55C0E48732BC4CD84640CC143CD05ABE55C00B2D8ED6B6D846406C791E25F5BE55C0AB28C4AA38DA46400A0F95133BBF55C0683C408941DC46408880A272B6BE55C0C89D02CA65E2464068F38C62D3BE55C0602469988BE44640E6FBED4036BF55C05FD30222FAE54640668AE0E1BABF55C048F5869B85E7464008A6E89222C055C044232E9A54E94640962F3CFC24C055C0FB42CDFDA0EB4640433A82F0C6BF55C04F18B52C19ED464016FED25675BE55C0FCC2848A09F04640BA828788F5BD55C0147E4199BBF146406CD6A720CABD55C048BAF0320DF3464024B0597BC0BD55C0F0C1498CD2F446400C2F67F020BE55C0602447CB2DF646400A0F95133BBF55C0602447CB2DF64640B6F9082BF7BF55C0B81CEE7168F446406E397A6B29C155C01F16D016DAED4640603E19A3ABC155C02067368D6BEC464016F8F820BCC255C0A8105CD353EB4640C468FEFA99C355C0A4BE4B45BAE846409AAFF3888DC455C0A8B363BEADE34640A641A8D0F2C455C0C31D4B3DFDDD4640FAED87381EC555C0BC1128B8B9DD46401698828A0AC655C00CC4E1559ED94640A801041727C755C074D4CE0660D846402B139BDFF0C955C00472D1C704D746402BB611E41BCB55C03BE985E39FD5464086A8DE549DCD55C06025C66320CE464023A414291FCF55C03852C34AE7CB4640E0006BAB5AD155C06CE0135901C74640D24EE4860FD255C008F3E51F02C5464087CB0CE630D355C0A39123DFDDBE46402E6DA659BAD355C0846197CACFBD46405AE60C12FBD455C01F746991D0BB464064B578784FD555C0C4AAA4E79BBA4640945AD492B9D555C0AC404E4F7BB74640C83CE7CB12D655C0E8B7026B16B6464032FBA121DDE355C01C01C33B6F9846408CF99117A2E655C0F82DC0223696464028CCBF24D7E655C00869C5A47F9346405E177FDE48E655C028D3AC23CF8D464046C7B43D5EE655C0C82BE3CE708D4640ED9993E6D3E955C09BA418EF748F4640208194E6E7EA55C0C82D18EFB4904640929A2D800BEB55C0A4EC7E554F914640C86461B364EB55C0EC904B22349246403626FB4C0AEC55C0181A4B22749346406EFAFA4C8AED55C0A88E17EFA095464072772E8081EE55C0A4B3B08866974640D62861B3F2EE55C098F5AF889E98464016ABFA4C06EF55C05CF94A2284994640366FC719BDEE55C0CC914A22989D464072772E8081EE55C01CEE7E55339F4640467461B33EED55C0B83AB0885EA446407ECA60B3A6EB55C038B74A228CA946403E7394E61DEB55C0A865E3BB9DAA4640F81CC71925EA55C074FE18EF24AC464002852D80D7E955C048AF7D55F3AC4640D0462E80D1E955C0A84F4A22A0AD4640A67BFB4CE8E955C0C0C67D5543AE4640D0E52D8051EA55C02FB64A2268AF46408A0494E6D9EA55C05CFE15EF94B04640DD7A2D803FEB55C0CC927D5547B146409BCDC619A1EB55C06CE2B088AEB14640C41F2D8013EC55C06F764A22C4B14640D83FFB4C7CEC55C04C6C7E5597B14640C1BA61B32EF155C02CBDE4BB05AE464039572E80A3F155C0A7B8B188DEAD4640347C60B320F255C0482AB188CEAD4640F41494E6ABF255C0B7297E55DFAD46402A28C81923F455C0ECF316EF84AE46409C1494E69FF455C0F876E5BB89AE4640A20A94E60DF555C04C2BB2885AAE4640C2F493E6CDF555C034254B22B8AD464032F361B34EF655C0D0857F5597AD4640824F94E6EDF655C0FF0018EFC4AD46404164FA4CE4F755C08C5DB188B2AE46408E69C71949F855C024684B227CAF4640EC6A94E675F855C0F42AB2884EB04640322161B362F855C07F234A2214B146404C2561B3A0F755C0B42DE4BBD1B346407C9793E67FF755C040F6E3BBA9B4464079D6C71977F755C0846F7E55B7B546404C2561B3A0F755C0B7664B224CB74640FE81FA4C94F755C08C0F4B2258B846401651C81969F755C00C264A221CB94640148F60B320F755C0A0277E5597B94640F8FBF94C06F555C04030E4BBD9BB4640325B61B3B8F455C054617D5553BC46403E13C71973F455C0CCAF4A22DCBC46404C5F61B3F6F355C0E8B6B2880ABE464000B394E69BF355C0B427E4BB51BF46404CC061B376F355C004E617EFFCBF46405AD82D806DF355C0EC5EE4BB6DC04640EFFB2D8071F355C06C097D5547C146402A53FA4CFAF355C0B049B18842C546406A7D94E68FF455C09C8416EFDCC746409C98C61981F455C080447E5503C946409C9861B334F455C0F880492288C946400961FA4CC4F355C033F07C55BBC946403E23C7195FF355C07C11B18802CA46402938C8190FF355C01061E4BB69CA464092252E80CFF255C09CE8AF882ECB4640985060B3A6F255C0385CB18836CC4640FAC494E6A3F255C0A4BD4B22E8CD46401294C719C5F255C078B44A22E0CE4640E8B52E80FBF255C058C5B0889ECF464094ABC71915F455C06CA717EF30D24640702494E685F455C0A8D6B2888AD34640460061B392F455C044F77D557BD446407C2294E669F455C0600EB0882ED546401011FB4CBCF355C09F30E5BB01D646407EA560B372F355C06CC718EF70D64640667D2D8047F355C0BC254B222CD746401233C71945F355C0341017EF8CD74640AE7994E65DF355C0AB9B18EFF0D746406CD52E80C1F355C08C1D4B22B0D846402AC7C719A3F455C0AC3AE4BB05DA46409AC5FA4C70F555C00862492288DB46400C7E93E613F655C0BCD14A2258DC4640A89094E69BF755C0B49F7E55E3DD4640FAE360B3ECF755C010E9E5BB55DE46409295FA4CACF855C0F0627D55EBDF4640A630FA4CF4F855C0688218EF64E046402ACBC6194DF955C0781F18EFC8E046404C5C61B3B6F955C03822B28822E146408A632E8037FA55C09CE44A2258E1464029EAC61901FD55C0CC34B188AEE14640C0ADC71911FE55C0C800E3BB21E24640E8AF2E807BFE55C0F4DF7C5577E246403653FA4CD4FE55C088BEE3BBDDE24640061E61B31CFF55C054C6E3BB4DE34640BC2B61B3E0FF55C04C714A22C4E44640D9CD61B30E0056C0876FB188F6E44640AB8FC719550056C0344A18EF24E546401698FA4CB40056C024687F5523E54640E8F960B3060256C0636D4A228CE44640E6CF94E6070356C047D44A2260E44640EE3861B3920356C010B017EF6CE4464092DEFA4CA40456C078B84A22CCE44640101AC719990556C0ACEE49225CE546407473FA4C8C0656C044F9E3BB25E6464056BF94E6090756C00405E4BBCDE64640DE12C819A90756C040414A2200E84640CCBDC719D70756C0B04A7E55EBE846406888C719D10756C0C8A74A22C8E94640506094E6A50756C038B9E3BB75EA4640C6C7C719690756C02FDDB18816EB4640B2E3C719030656C0535F17EFB8ED464084B62E80C10556C04C83E5BB59EE4640D511FB4C880556C010A0B08812EF4640022D2D80790556C0887116EF38F046404CF560B3B60556C0303317EF2CF146404CA72D805F0756C09CCD18EF58F646405AC0FA4CE20756C0F4417C553BF746405C82C719770856C0ECD1B088C6F746409A2894E6770956C0D46D4A224CF84640CA2AFB4CE20956C0788E4B22A4F84640759261B3880B56C058A07C5587FA4640D89C94E6030C56C084DF17EFCCFA46409ADCC719850C56C008924B22D0FA4640B5AC60B37E0D56C010ACB28896FA4640816661B3020E56C0E3D57E558FFA4640120894E68D0E56C0B0E07D55ABFA46400487C719A10F56C0D0B7B2883EFB4640D25294E6C11056C0D0D2E4BB29FC4640681594E6451156C00C834C2270FC46404CB12D80CB1156C0E4E0B0888EFC46407EABFB4C081456C0476FB1889EFC464096EE60B31E1556C0044F7E55E3FC464046D02D807F1556C0D0FF18EF18FD46409C7360B3201756C05CE8B088F2FE46404EF4C719B51756C07C194A226CFF4640F28094E6431856C0EFACB08892FF4640528C2D80971956C06B7C4A2208FF464009B494E6211A56C06B7C4A2208FF46409A7894E6C11A56C06C5118EF30FF4640C09F94E6F11C56C00477E4BBE5004740309561B3701D56C0B0E5E4BB29014740BE1CC819E91D56C0F8FDB28822014740129361B34E1E56C0B0FF4B22F000474091C3C719D91E56C0B0FF4B22F0004740F099C7197B1F56C0EB8BAF882E014740CC2D61B38A2056C0507B7C55530247403A3FFA4C382156C07452B188E60247406430FB4CDE2156C024D27C553B03474042CC94E6632256C03FE9E4BB550347402C89FB4CE22256C0CB784B2244034740FA162E804F2356C0BC3E16EF14034740A20361B31A2456C0FBB5E4BB710247406629C819892456C07C9FAF8846024740CAF4C6190D2556C0507B7C5553024740C2612E80832556C0DF027E557F02474026DD2D80FF2556C080374922940247405C5061B36A2656C0E0507D556B02474062BA93E6CD2756C0D8B2B288E200474028CD94E65B2856C02BFB18EFC8004740B29394E6172956C058B7E5BB0901474090E1FA4C462B56C05407B188A6024740024BFA4CBA2C56C004C04B224C0347400E39FA4CB22D56C0471E7E5507044740CE4DFB4C5C2E56C0C086B28856044740EC6B2E80F52E56C050CD7F556F04474066C9C619732F56C0C0E57C5553044740FDD461B3C83056C0A85D7E559F03474062A961B34E3156C06CA5B18896034740DCDBC719F53156C01C62B188C6034740DC21C7196B3256C0B4977D5567044740D48E2E80E13256C090CAAF88AE044740E2F5FA4C503356C07C894C22B004474041DE61B3423456C050CD7F556F044740CAACC619C13456C0B4977D55670447401CB194E6953556C0389CB0888E0447401BE793E61F3756C09CAE4A22C8054740ECAB2D80EB3A56C033BCB188CE0847404AA92D80B73E56C0DCABB188D60B4740993561B3824256C0083CE3BBDD0E4740EF3261B34E4656C024FC7D55E711474074C42E80A14756C088C87D55F7124740BE6161B3E84956C03CD87D55D7134740169161B3944A56C05C944A2218144740687C2E807B4C56C0A0F27C55D31447408A81C7196F4F56C0E81D18EFF4154740A26FFA4C445356C07CCE17EF70174740FBFA93E6CB5756C0C00B7F552F1947407AFB60B3DA5C56C0649AB288221B474042372E80436256C067C8B188361D4740327DC719D96756C0E8D716EF5C1F474058BA61B36E6D56C0C0D57D558321474062C6C719D77256C040D417EF98234740EE3761B3E67756C0C880B2888A2547408A9393E66D7C56C0182FE6BB49274740524061B3428056C03F8017EFC4284740AB3CFB4C368356C013BDB088E6294740FE27C8191D8556C0D77AB188A22A47405CC894E6C98556C0740719EFE42A4740BC222E80958756C09C00E4BB992B47400ACFFA4CF08756C04F077E552B2C4740583E2E80238856C020F516EFD42C47405ADD2D80A38856C050B916EF682F4740BEA92D80B38956C000F816EFE83247405A88FB4C628B56C0E87CE4BB75384740FD7D94E67B8C56C060BA7E55173C4740AC9EFA4C208D56C028E2B188363E4740F6CFFA4CE88D56C04C56B088C63F47401E4E94E6BD8E56C007B5B0881E414740206961B35C8F56C0F4E4E3BBB941474061ADC719059056C0CC2918EF0442474022EFFA4CA29056C0EC9F4A221C42474008EBFA4C649156C0D46616EF784247403AD1FA4CEC9156C0DC49B0880643474058EF2D80859256C0E4D6E5BBE5434740EE632E801D9356C018154A223844474086B4C7195D9456C0C4354B2290444740610AC719B99456C0F47D4C22244547403DB161B35C9556C00FA84B2200474740F0ACFA4CD09556C0CCAAE5BB59474740EE312E803D9656C04CB77D5543474740BDFDFA4C5E9756C078AE7C55474647405967FA4CD89756C04BF2AF8806464740128F61B3629856C068C37D55F7454740B761C8191B9956C0E8D9B2882246474046902E80899956C07C17E4BB854647404A4094E6CD9956C0D88318EF0C4747407EE7FA4C129A56C0787DB1885E4847406E5EC719679A56C0978A4A22C84A47403E3D2AB5339A56C0E0EA4B38674B47406C9E91A9C49856C0B0021950CD4C47407CB9C44E289756C02859F309E54D4740AE610D046F9556C0C7BDD55E7F4E4740D277A171509356C088A3AA3EB94E474048DD8B4B889256C090AFCDC3FC4E4740DB030D6A2B8F56C08380EBC6F6514740CA74D6A3D18356C010D86F981657474000C382F81F8156C0EC84240C46594740BA5139F96C7556C0847F8EFB61684740ACFF286BD37256C004FAD144446A4740DF420F06735956C030079FE18F6E47401FFD5476B65356C0902274195E7247400459345A834E56C0B4D2B7BAD4774740644306DFD44956C037640610077F47409BF771195F4856C0944511C4C280474074BBC27F0D4756C0C3DE4959E980474050516CE7EC4356C0ECD40BEAE47F47403AF04B39334356C09FBAE0C91E8047400A4EDDB9A54056C04CB6169EA08147409D60AF80A63E56C0C881C05D148247408AC2D7B3FD3D56C063DA7F2D6B824740407FA4CCEA3C56C0A022524C00844740AC72AC3BA33A56C094395D5850894740E7064699473A56C050B685B7718A4740E0FA2214043A56C0F31A680C0C8B4740906E1589BE3856C070C35254BD8E474011A36BC94A3856C038B54AB93A8F47406A9B1270853656C0CBA45D08799047406AE76A95C32B56C010338C49359D47407A029E3A272A56C0A8229F98739E4740B8B60975B12856C0CFAFB4A8569E474058B52CE40F2856C0682B33F06F9B47401A5E4AA55A2856C0DC01561D1F984740DE8CF928C72856C08089F7E97B954740467D14FDA22856C0E802911B5693474061E12146392756C0CC3BB187609147404EE9AD18982556C0FC3D969D9F9047402A367DDC442256C05CD9B3480590474062EAE816CF2056C0F0F7A894498E47407E2E24837F2056C07F95AB55EE8C4740F22A62DC9E2056C0DF9975816C8B47406CB9547D232156C0DCB01174EB874740784B09C5882156C0A87462DA99864740C6AE0E89812156C004108085FF8547400103000000010000005E00000074124FC097EE55C0D400686B5BB74740EEB4F0B8BEED55C018843F0C3AB64740EEB4F0B8BEED55C070133A325CB547408BEDDDAB2FEF55C0F753B3F72BB54740D896D0787EF155C0D88CD36336B34740E2BFD83FCBF255C0149BDBFEB8B24740EA6E72C939F455C01CA7FE83FCB24740D2ADDB84CEF655C06870C32D31B44740E05C750E3DF855C0B8A234587EB447400F9924A88EF955C0F8BC5F7844B44740F06EE1E20AFD55C0149BDBFEB8B24740768078ABD4FF55C0875A6239E9B24740EA1F2D091F0156C02C28F10E9CB2474026573D6BEE0156C044066D9510B14740E53FFFE5040056C00855EEF562B047409B5955FAC6FD55C0283F8D011BAF47400AB31C4FBBFC55C058AA1E9872AD474048042558B70056C034912E76E3A8474054F07500150256C078140617C2A74740F0651A12750356C0F8485C574EA74740B694C995E10356C0305764F2D0A647406A4EA913F20456C0F05FF849CDA34740A1FF27B39F0556C050FB15F532A347406DD14D3B370756C09C8A101B55A24740C8D22ACCD80756C014B343D69DA14740264B89FF7B0A56C05759DAEE3E9D4740175C4BBC410B56C05CC2866F579C4740F01CAF87130C56C07F4F9C7F3A9C4740767A0D8FEC0C56C0209C38CA4D9C4740724E182DC30D56C0301D2B55ED9B4740B80BBA51B40E56C09421F5806B9A4740D02F23E17E0F56C03CB5B9D20B98474048B2F2FCBF0F56C0A022307FA2954740C1DA25B8080F56C0D48DC115FA934740C1DA25B8080F56C02C1DBC3B1C934740C440E59D441056C02C1DBC3B1C93474082BD0DFD651156C06C37E75BE2924740BEF41D5F351256C06BA093DCFA914740373A365C871256C098FF01EE0E90474002EF76A2151356C0F803CC198D8E4740BC94A7C8831556C0F0480F0BDB8C47408C49E80E121656C0E8A59806B08B474081C069B1131856C0D0D3D0EBAD84474046866CB4671956C0A45D57CE4981474081BD7C16371A56C02BEF360AAB7F47403AF1CAD1251B56C037640610077F474066B01E93BC1E56C087F36F4FFA86474000834CA0F11E56C0EBC8577E7288474018043F2B911E56C05C2B55BDCD894740F396FBF7931D56C068DAEE463C8B4740922F5F81B61B56C0580896450B8D47405C4129C3191B56C01785BEA42C8E47408FC99F9B7A1A56C0CBA45D08799047405EAAD543321A56C0642BC4D69E924740569EB2BEEE1956C09344B4F82D974740FBA8F8B2901956C0445830D736994740D8EFED40841A56C0BC8063927F9847402A7CFBCBC91B56C0782C6EEEA69647409A951E67F21C56C078E680E550944740F396FBF7931D56C074ACB6613E92474097783925E91B56C0B0F48880D39347405C4129C3191B56C0A445EFF664924740A4677768231B56C008B365A3FB8F474054D87C42011C56C070C35254BD8E47406A36B055DE1E56C0C8524D7ADF8D4740C4EEB2424D1F56C0381EF739538E47409EBB3993622056C0B41748F8959047408E466A8D062156C0CC3BB187609147409CB272C2CC2656C0DB53F791E79147406E73D68D9E2756C060C2175686934740479DE6D9882756C01CCB1AC7539947404091C354452756C0B0E8D414619C4740BE02D1B3C02656C08C958988909E474072FC54EB9C2556C05B2AF8F138A0474018FE64F5D72256C0A49633A098A24740CCF7E82CB42156C02805546437A44740B2BC7491991B56C0807D21B1ABAF47404849B595781956C0CBDD39DAC7B1474004553688511456C070133A325CB547405E1026109D1256C040C0EEA58BB747402CA88114221256C078654AC0F5B74740345A08396D1156C048CC112BCFB747408A6F9421B11056C038B4CB2048B74740740E7473F70F56C0E8815AF6FAB647400F4A4E01450F56C040C0EEA58BB7474016F0B1A04C0E56C034E2721F17B94740AEE2B18A670D56C07C9F144408BA4740EA7C251EC50856C038CBD62C98BC47403406D7F45C0356C000542211FDBD47403EDE9A1276F455C0B82DD46BF3BD47407BDBE0F032F355C0A8158E616CBD47400A5CFE6FCEF055C07C4EAECD76BB4740341509E2DAEF55C09C384DD92EBA474074124FC097EE55C0D400686B5BB747400103000000010000003B0000000C6F9D484F2056C018BB3F7A01164840388E67A0972056C0A06465C0E9144840B2132457B51E56C0706280AAAA15484049062441D01D56C0B013FF4958164840C22E57FC181D56C09029603EA017484082142CDC521D56C05078E19EF2164840D2469D06A01D56C068EDB0A44E164840A40701D2711E56C0A06465C0E914484008E90B862D2056C0C4B7B04CBA124840EA613FC5D42456C0D04F3FCAD80E4840D6C07A5D4F2656C02CB192F12B0C48401B248021482656C03F2662F7870B4840EE416DE8EE2556C034E074EE3109484031E229CBD62556C0A8FC8424370848403AEE4C501A2656C050BEF074A60748404E405DDEB32856C09807FE917204484029CD3F75FD2B56C0C4CF18249F014840F00F7C83AE3C56C038F8DCC516F84740F81B9F08F23C56C0486189462FF747400025D5F2583F56C04F27BFC21CF54740686F8C272D4056C0EB51D793A4F347401463C70F7F3A56C0EB51D793A4F347401463C70F7F3A56C044E1D1B9C6F24740863C46F1DB3D56C074E3B6CF05F24740F8AF7406CE4856C0849E04C5E6EA4740072257714D4A56C0DC4545F58FEA474037214FECAF4B56C0641D123A47EB47403A870ED2EB4C56C040CAC6AD76ED47401E43D3653B4D56C0A0FC37D8C3ED474052629DBD834D56C0B7894DE8A6ED4740E634CBCAB84D56C048D6E932BAED47407D816715CC4D56C0C02CC4ECD1EE47403A870ED2EB4C56C0444A7E3ADFF1474092222C7D514C56C05C6EE7C9A9F24740644306DFD44956C0A0C2DC6D82F44740644306DFD44956C05833E24760F547408A1609F80D4C56C0D7D0E40805F44740D4593CDF204D56C0F45DFA18E8F347407D816715CC4D56C05833E24760F547408EA274F0E84756C01C48083E71FB474016E37E9CE73E56C0449BC2E312024840F00F7C83AE3C56C0B49413A255044840360DC2616B3B56C06362A27708044840B09EA19DCC3956C0E7396FBCBF044840564328AC323856C0689C6CFB1A0648409C03B76B003756C0C47D77AFD60748408648FA5C4E3556C02731DB64C3074840943A253B653256C07491F38DDF0948404D43B992612F56C0B4885F36E30C48409F2F3DB4582D56C03B9AF6FEAC0F48409F2F3DB4582D56C03F6C4F00DE0D4840B26D2FD17E2856C044835A0C2E13484006C072D8B12756C0A01E78B793124840950FFCBDA12556C0370E8B06D2134840E2551C40912456C044835A0C2E13484069F31E01362356C0BCF17AD0CC144840A40701D2711E56C0A74DC9CD6A184840B0F3517ACF1F56C0075293F9E81648400C6F9D484F2056C018BB3F7A01164840,-23.0%,-245,822,64,758,Michigan,true
23,0106000020E6100000080000000103000000010000000A000000C298A2F94FB351C0F8F847F6C09F4440841FCFD3E5B351C0643106F7BF9F4440E8BE2BCEADB451C024690CE718A044408E22901D44B551C0F0C7DE46DBA04440081FFF6F26B551C0D0E5A2A853A14440F2F28A939AB451C060E2088C54A144403412EEE918B451C0D0766678AFA14440FCAD45BAC8B351C05CE358C337A14440D2CA7FA650B351C06472E350DEA04440C298A2F94FB351C0F8F847F6C09F444001030000000100000025000000C262969B3A8151C0677411FD5FAF44406689277E568051C0AC5ECF35DEAB4440EE717CD3657E51C038D5CE35AEA64440A414D8EF4B7D51C06F380AB54BA34440EE7AF3C5E57D51C07FE93412EE9F4440FAB41383128051C0BC3DF2F59F9E444018D48324C18251C0A823C090259F4440A28D8C033F8651C0FF340946F49E4440046F5DD1D08851C0B88C50B0A29F44401A837CD3EB8E51C0483CCF3552A444401E45F403689051C0F01DCA6479A544406681F197CC9151C064F0D77B69A744402A54BD506E9151C0C80ACF3CDAA74440D8E1E304679051C0F026C38E92A7444012DD0288698F51C088C5E0EF84A64440EA746A0BE88D51C010719E1712A64440445678A94E8A51C0F08DA6EF7FA544400E665056F48751C010DD5919DFA544405EFB7CD3D58651C0E893D035CAA54440D80A7CD3418651C02CB979E02CA54440AAB67CD3BD8551C0A05ECF351EA54440B244277E3E8551C0304FD03572A5444049947CD3918451C07C0AD0359AA644404E947CD3F18251C0A35ECF355EA74440C6AB277E028251C0BC107BE0A4A84440FD4AD228498151C050D2258B57AA4440F2717CD3E58051C088427AE01CAC44404C947CD3118251C04C877AE074AB4440A8F97BD3DB8351C0F035248B87A84440AE44277EDE8451C0503CCF35D2A7444062FB7CD3D58251C028B979E0ECAC4440DA0A7CD3618251C09CF7CE35BAAF4440A4E4102F778351C0D899148943B24440228C8B755A8351C03BA7378FC2B24440BA04DE318B8251C000AE6F5D7AB24440FE5DC701D98151C0A004FB5E6CB14440C262969B3A8151C0677411FD5FAF44400103000000010000000C0000006A89277E969C51C00336248B07AF4440ACF97BD3FB9C51C00717268BEFAD44400967277ECA9D51C094427AE01CAE4440309FD128CD9E51C01CE8CF354EAF44400C67277EAA9F51C01417268BEFB0444006D97CD309A051C0E0B2CE3562B2444003D97CD3299F51C0E093D0358AB34440BE607CD31F9E51C004CC7AE0CCB544400E67277E2A9D51C08C71D035FEB644401C837CD38B9C51C030D5CE35EEB44440944F7CD3799C51C0C82CD035E6B044406A89277E969C51C00336248B07AF4440010300000001000000100000003676B2FC62BB51C0D8098A5495B5444042A76F1813BC51C0B0D7D7DBA2B444402473A447B4BC51C00C5A350002B5444020278B0F34BC51C08873D1F3DBB54440A43DE01244BB51C020BA51BFE6B64440B07F9F5053BA51C0930AB69A00B74440B0CC070973B951C0E8200A08DBB74440DC26F159C1B751C0049A8F5226B84440B612757701B751C0AB49CFBF60B94440C4C454CAD0B651C00CB91469B8B84440425908704FB651C004BF143298B74440B6CE155EAFB651C0D0A4F4F6EEB64440D82E2F1E10B851C053A08BD713B64440195EF83D21B951C000CC43ED11B6444010C3AD3902BA51C01C32904110B644403676B2FC62BB51C0D8098A5495B5444001030000000100000023000000613E7CD3F3A551C0B87A248B5FBC4440C4AB277EA2A651C0BC7A248B5FB9444042BB267EAEA551C0E0B2CE3522BA44406689277E16A551C0D3B2CE35A2BB4440DA0A7CD381A451C00C81CF35AABC4440623E7CD393A351C0888D258BFFBB4440362D7CD3EDA251C0740AD0351ABA44405EFB7CD3F5A251C0AC5ECF35DEB84440B044277E9EA351C0AF7A248BDFB74440D6C77CD3E3A451C0C0C5CF35C2B64440382D7CD30DA451C04CD2258B97B54440061C7CD327A351C02C04258B0FB54440A128D2281DA151C030D5CE35EEB44440904F7CD379A051C00881CF356AAE4440924F7CD399A151C058A3CF35F6AD4440BE607CD39FAA51C0304FD035B2AD44402EEA7CD38FAC51C08871D035FEAC4440745AD12855AE51C0AC5ECF35DEAB4440904F7CD3D9AF51C09F5ECF355EAA44400CAA267EA8B151C060A3CF35F6A644406ECC267E54B251C034D5CE35EEA64440C0607CD37FB351C0B0C5CF3502A8444010AA267E28B451C00BCC7AE00CA94440D07CD12861B551C0B8C5CF3582AB44400EAA267E28B651C0BC7A248B5FAC44400EAA267E28B651C0403CCF3552AD444017837CD30BB251C040D2258B57AD444002D97CD349B051C030D5CE35AEAF4440BC607CD37FAF51C0BCC5CF3542B14440061C7CD3C7AD51C014E8CF35CEB5444078A57CD3F7AC51C0C0C5CF35C2B64440C4AB277E22AC51C00017268B6FB74440ACF97BD33BAA51C00817268B6FBA444098DD267EBAA651C02BB979E0ACBC4440613E7CD3F3A551C0B87A248B5FBC444001030000000100000014000000908DAFEC2BB151C033DE3469D2BA4440D2A727BC9CB251C0EC5E15597FB94440DE981FC4BDB351C030FD1F8835B9444001A06F104FB551C03B5BA0B4A2B844400EBDA046C0B551C040C2FAFDAAB944400A74D20000B551C0400E19EF84BA4440BEEBC6CA0EB451C0788E19063EBA4440528173A95EB351C05C2116F247BB4440D0C629510EB251C050DA3D8843BD4440D02901C48CAF51C068F9811819C04440987F7DD25BAE51C0849CA7B66BC144408EF977187BAD51C0F845839A75C244400681D6A879AC51C0B8CD12462EC244402C712BEA77AB51C0A0A33A6956C144408E4F2E44C9AC51C00C94313E4CC044405C7D3B3DFAAD51C0983FDCCBF9BE4440824212908BAF51C0E7B5B5D9A6BD4440C44CDF548CB051C047633E11E5BC4440F266CFC37BB051C07F25124AF4BB4440908DAFEC2BB151C033DE3469D2BA44400103000000010000000A000000C4AB277E228051C0D7B2CE35E2C64440C2607CD35F8151C08871D0357EC64440F94AD228C97E51C050D2258B57D04440F2717CD3457E51C020B979E0ACD34440D4C77CD3C37D51C0B87A248B5FD34440F2717CD3857D51C02004258BCFD244402EEA7CD36F7D51C0B8C5CF3502D24440F8FF267E667D51C098F7CE35FAD044409CDD267E7A7E51C0B47A248B5FCE4440C4AB277E228051C0D7B2CE35E2C64440010300000001000000170200000A20C819BDB751C078BDE3BBF56F4540623294E665B651C028F2E4BB716F4540D25C192F1DB451C0B8C39B374B70454040BB267E2EB451C0BF107BE0646F454002D97CD3A9B351C0B87A248BDF6A4540FB4AD228C9B351C0B0C5CF35C2694540B244277E5EB451C058A3CF3576694540081C7CD347B751C0B0C5CF35C2694540DE0A7CD3A1B651C0543CCF3592684540FAFF267E06B651C00C17268BEF674540071C7CD3A7B451C05FBF248BF7664540AE44277E7EB451C040877AE0F4664540C6AB277E02B451C0473CCF3512674540FB4AD228C9B351C05FBF248BF76645404C947CD391B351C02804258B8F664540C0607CD33FB351C01F4FD035726545409EDD267E7AB351C0B0F4258BE3634540A66BD1289BB151C020337BE0B05B45406689277E16B251C08471D035BE5A4540AE44277EFEB351C07871D035FE5E45405EFB7CD3B5B451C0A413248BFB5F45406ECC267E74B451C0988D258BFF5B4540934F7CD319B351C050D2258BD75945406689277E76AF51C08C8D258B3F5745406CCC267E74B051C060A3CF35765645409ADD267EFAB051C01804258B4F564540A66BD1289BB151C0A87A248B5F5645406CCC267E74B051C0B07A248B1F544540C3AB277EE2AC51C0B07A248B9F534540362D7CD3CDAC51C0888D258BFF5145400C67277EAAAB51C0179D248BEB504540B6D2D1285FAB51C050D2258B17524540A8B67CD37DAB51C0948D258B7F5545408233277EF8AA51C0189D248BAB5645402511277E2CAA51C040D2258B975745403EBB267E6EA851C0EF647AE0E85845403A2D7CD38DA851C0FCAF258B0B5745403478277E50A851C0E019CF3506564540C6AB277EC2A751C040D2258B97554540028ED128E7A651C0948D258B7F554540F6FF267E46A651C0AC5ECF351E554540949A277E5CA651C00017268B2F5445400E67277E8AA651C00036248B075345405FFB7CD335A651C0888D258BFF5145405FFB7CD335A651C054A3CF3536514540C2AB277E22A751C064BF248B375145406CCC267E94A751C08871D0357E504540F8FF267EE6A751C0189D248B6B4F45403EBB267E6EA851C038D5CE356E4E4540B044277E1EA951C0D848258BA74D4540352D7CD36DA951C0C09679E0604D4540A6B67CD39DAA51C0D49679E0A04D45404449D128AFAA51C0A0F4258BE34D45405022277ED2AA51C0F0AF258B4B4E45404949D1282FAB51C0B07A248B5F4E45403A2D7CD3EDAB51C0D49679E0A04D4540EE717CD385AC51C060BF248B774C4540C3AB277EE2AC51C044B6D035564B4540B244277E5EAD51C080DB79E0784A4540AAF97BD3DBB351C0E093D0350A484540CE7CD12821B751C0BFC5CF35024645404206D22831B851C01CE8CF35CE4445407AA57CD3B7B751C037D5CE35EE434540C0607CD33FB851C0403CCF3552434540F2717CD3A5B851C00CE8CF358E4245400A67277EEAB851C0483CCF35924145404406D22811B951C0700AD0355A4045403A2D7CD32DB851C0BCC5CF35024145404006D22851B751C044D2258B5742454006D97CD3A9B651C0F735248B07434540051C7CD367B651C0948D258BBF4145400A1C7CD3C7B551C0AC7A248B9F404540E8E3D128A5B551C0C0107BE0E43F45404406D22831B651C02804258B8F3F4540A228D228BDB651C0A05ECF355E3F45406889277E16B751C0C0107BE0E43E4540BE607CD35FB751C0503CCF35523E4540F2717CD3A5B851C0E419CF35863C45404406D22811B951C0403CCF35123C45402EEA7CD38FB951C024B979E0EC3B45407AA57CD397BA51C034B6D035163C4540D4C77CD303BB51C050D2258B973B4540944F7CD339BB51C0BFC5CF35023A45408EC1D128B9BA51C020B979E0AC384540C1607CD3DFB951C0740AD0359A3745404406D22811B951C03F3CCF35D2364540F0717CD3A5BA51C0543CCF3512364540E6E3D12865BC51C050A3CF3536394540C6AB277EA2BD51C0740AD0351A38454018837CD34BBE51C00881CF356A364540ACF97BD35BBE51C010E8CF354E35454060FB7CD3D5BD51C0888D258B3F334540C6AB277EA2BD51C034D5CE356E3045405BFB7CD375BD51C077557BE03C2F45405CFB7CD3F5BC51C0C0C5CF35022E4540061C7CD3E7BD51C02CB979E02C2E4540623E7CD3F3BE51C04C877AE0343045404C947CD3D1BF51C058A3CF35B63045406889277E76C051C0747479E054304540C2607CD35FC051C060A3CF35762F4540944F7CD3D9BF51C000CC7AE08C2E454042BB267E2EBF51C0C0C5CF35022E4540C2AB277E62C051C050A3CF35B62D4540663E7CD373C151C028D5CE35EE2E4540A8F97BD35BC251C028B979E0AC2F4540A8B67CD31DC351C0C0C5CF35022E4540E6E3D12865C251C0204FD035B22D4540EC717CD3C5C151C0BCC5CF35422D4540041C7CD347C151C0D893D0358A2C454040BB267EEEC051C0D8B2CE35622B4540FD4AD228E9C151C08071D0353E2B4540745AD128B5C251C068BF248B772A4540B244277EFEC251C0E448258B272945405EFB7CD375C251C00C81CF356A274540A6B67CD3BDC151C050A3CF3576264540D2C77CD323C151C020B979E06C264540745AD12895BF51C013E8CF35CE274540382D7CD3EDBF51C0543CCF35522445404A947CD3F1BE51C0D893D035CA234540BE607CD39FBD51C0975ECF35DE2345405CFB7CD3F5BC51C040877AE034224540D6C77CD323BD51C0C0C5CF358221454060FB7CD3D5BD51C068557BE07C20454060FB7CD3D5BD51C0284FD035F21F4540372D7CD38DBD51C0E4FD79E0841F4540D6C77CD323BD51C0C0107BE0241F4540EAE3D128C5BC51C0707479E0141F4540904F7CD399BC51C0F8CB7AE08C1F45404406D22831BC51C068557BE07C1F4540BD607CD33FBB51C0F7CB7AE00C20454060FB7CD335BA51C018B979E0EC204540D07CD12881B951C0EC19CF35C6214540081C7CD3C7B851C0503CCF3512204540F8FF267E06B851C0503CCF3592204540C2AB277E82B751C0C82CD035E6214540B244277E7EB751C0AF107BE0A4224540653E7CD353B851C00481CF356A234540745AD12815B951C058A3CF35362545400E67277E8AB951C07771D0353E274540D07CD12881B951C0C0C5CF35C2284540EAE3D128C5B651C048D2258B572445405EFB7CD335B551C0E0FD79E08422454004D97CD329B251C07B557BE03C214540AAB67CD3BDB051C0C82CD035E61F4540944F7CD379AF51C0FF80CF352A1E454074A57CD3D7AD51C09C5ECF351E1B4540372D7CD3ADAD51C0BFC5CF35421A454002D97CD3A9AD51C0304FD03572164540D2C77CD3A3AD51C0403CCF35121645405CFB7CD355AD51C0DF93D0350A164540FD4AD22889AC51C094F7CE35FA144540041C7CD367AB51C0284FD035721245400A67277ECAA951C040877AE0F40D4540D80A7CD361A851C054D2258BD70B45406589277EB6A851C0CF48258BA7094540309FD1282DA851C0503CCF3592074540B044277E3EA651C040877AE0F4024540FAFF267EE6A551C0483CCF359202454030EA7CD3CFA551C074BF248B370245404A947CD331A651C090427AE05C014540745AD128D5A651C030B6D03596004540DC0A7CD381A751C00081CF356A00454030EA7CD32FA851C058A3CF35B60045404A947CD3D1A851C090427AE05C014540CE7CD12881A851C008CC7AE08C014540FA4AD228E9A751C018E8CF350E024540DC0A7CD381A751C0C82CD03526024540F4FF267E46A851C01FB979E0AC054540D2C77CD3E3A851C0E393D0358A074540AB44277E7EA951C06C0AD0355A08454076A57CD3F7A951C018B979E06C0745404006D22891AA51C090427AE05C014540643E7CD333AB51C0D0B2CE35E2014540623E7CD3B3AB51C018E8CF350E02454042BB267E2EAC51C0D0B2CE35E2014540BE607CD3BFAD51C054D2258B570045400E67277EEAA951C0C4C5CF3582FA44400A67277EEAA751C08F8D258B3FFA444078A57CD3B7A651C01BB979E0ECF944406489277E36A451C0EC93D0354AFA4440CF7CD128E1A251C0C02CD03566F84440F0717CD3E5A151C0F035248B07F44440061C7CD387A151C0D448258B27EF4440F4FF267E06A251C0908D258BBFEB4440AF44277E1EA251C098F7CE357AE84440EE717CD345A051C0BB7A248B1FE54440AAF97BD31B9C51C0F035248BC7E044400A1C7CD3A79951C09C427AE05CDF4440705AD128959151C08371D0353EDE44402E9FD1288D9251C0C82CD035A6DD4440E8E3D128E59451C0985ECF359EDD44409BDD267EBA9551C0B0107BE0E4DC4440663E7CD3739551C02804258B0FDC4440309FD1282D9451C04CD2258B97DB4440705AD128959151C0E893D0358ADB44408AC1D128998F51C01417268BAFDC4440AF44277E3E8C51C0A87A248B9FDF4440623E7CD3738651C0E493D0350AE244404AA398D57E8451C0A0F302AF00E34440745AD128558251C034B6D03596E44440C2607CD35F8151C078557BE03CE54440D70A7CD3018051C07C557BE07CE84440CA55B1003F8051C070458D6F53EC4440A5B67CD31D8051C0E0B2CE35E2F04440C2607CD35F8151C030B6D03516F44440A8B67CD3BD8051C06C7479E014F44440613E7CD3338051C0F8CB7AE04CF44440ED717CD3257F51C050A3CF35F6F44440ED717CD3257F51C00B81CF35EAF54440C4AB277E628051C0A87A248B1FF644404A947CD3318151C007CC7AE00CF744402C9FD128CD8151C01804258B0FF84440309FD1286D8251C0F835248B87F844404106D228518351C060A3CF35B6F744401D837CD3AB8351C07871D035BEF34440E6E3D128658451C048D2258B57F24440D8525709998451C02C7D292FBEF644401FE3FA72C48451C040F46EEA4BF944400392A7471B8551C0FC51EE5A5CFF4440A82320BC5C8551C0876E20189801454088F3ABF7638651C0D4C32A34C904454080549891D68851C01C2E1D4D57074540FAA0957E998A51C04802FFC12B084540A83C9795258C51C08B91DD2D5206454018837CD34B8C51C07C0AD035DA04454040BB267E4E8B51C000CC7AE0CC044540ACF97BD3FB8A51C07C0AD035DA0445404A61FD83EE8A51C008DE2F8A910345409E48BC111D8C51C044096E3C49024540B064B8AEF68C51C0F44730A05A0345405863F519608E51C09893C5E172064540416EFC72CE8E51C01805BA9653074540CEBF47A45D8F51C050533CBC940745406A9010E5CB8F51C0F34BB82FDE0745403401A2CDA28F51C004482CC4CB08454032A53365248F51C0E00F0D9FB509454062AADC1BAE8E51C0589843A1510A4540DA925B14CF8D51C048650591D50A4540BDC5BC544D8C51C070307714040B4540704F2EF8BA8A51C06899E5FC9E0A4540347609B45F8951C0600FAF905E0A4540B21A54138B8751C028BC3B74720945407A082758328551C0385BF621780745405184689B458351C0F07A439D160545407AC79D90E58051C098E06D48DDFF44408E7718D7DB7E51C0B813204210FA44400204934B5E7C51C0071C20AAC6ED4440382D7CD32D7B51C0E419CF3546EB4440C2607CD35F7B51C09C427AE0DCEA44405CFB7CD3957B51C0985ECF359EEA44404C947CD3D17B51C0B8C5CF3582EA44406989277E167C51C098F7CE357AEA4440D4C77CD3037D51C0DFB2CE35A2EB4440A6AD3B8AB17D51C088E8A3E2F8EB44405EFB7CD3357E51C00881CF356AEB44405422277E727E51C0888D258BBFE744405CFB7CD3B57E51C0E019CF3506E64440944F7CD3397D51C0CF2CD03566E7444004D97CD3497C51C088F7CE353AE744400C67277ECA7B51C0908D258B7FE5444040BB267EAE7B51C07C0AD035DADE44406989277E167C51C008CC7AE04CD64440964F7CD3997E51C0E819CF3546D74440C6AB277EC28851C0F8CB7AE08CD44440AEF97BD3DB8B51C0F8CB7AE08CD44440FA4AD228E98D51C088F7CE35FAD244405022277EB28E51C070BF248BB7D244409ADD267E5A8F51C02FB6D03556D24440081C7CD3E78F51C0A05ECF355ED14440061C7CD3E79051C0A05ECF35DECE4440745AD128759151C0DC48258B27CE4440AEF97BD35B9151C08B71D0357ECF4440745AD128B59051C070BF248BB7D2444004D97CD3A99151C05CA3CF3576D24440EAE3D128659351C0948D258B3FD144401A837CD36B9451C098F7CE35FAD04440FAFF267E869651C010E8CF354ED144400E67277E6A9751C0988D258BFFD04440BE607CD35F9851C07871D035BECF444030EA7CD30F9951C0BFC5CF3542CF4440904F7CD3F99951C0680AD0359AD14440DE0A7CD3C19A51C028B979E0ECD144400A67277E6A9B51C0D0B2CE35E2D04440DE0A7CD3619D51C097F7CE35BACB444062FB7CD3B59E51C053877AE074C94440EE717CD345A051C0E048258B27C844407AA57CD317A251C0503CCF3592C744406489277E36A451C0284FD03572C74440F2717CD325A651C0EC93D035CAC6444056262FD727AA51C057544C91BBC24440CE7CD128E1AB51C0204FD035F2C34440964F7CD359AA51C058A3CF3576C64440C4AB277EC2A951C068557BE0FCC944409CDD267EBAA951C08071D035BED34440382D7CD30DAA51C0687479E0D4D54440D07CD12821AA51C090427AE09CD744409CDD267EBAA951C0543CCF35D2D84440765AD128F5A851C0BF107BE0E4D944404606D22871A851C0E019CF3506DB44404A947CD3D1A851C00C81CF356ADC4440663E7CD333A851C0344FD03532DD4440FA4AD228E9A751C0A05ECF355EDD4440AAF97BD35BA851C074557BE0BCDE44405EFB7CD3F5A851C040D2258BD7DE4440ACF97BD37BA951C098F7CE35FADD44404406D228B1A951C00C81CF356ADC4440D07CD12821AA51C00C81CF356ADC4440F2717CD325AC51C034D5CE35AEDE444078A57CD377AD51C0908D258BBFDF44402EEA7CD30FAE51C0B8C5CF3582DF44400C67277E4AAE51C090427AE05CDB4440663E7CD333AE51C008E8CF35CED94440C2607CD39FAD51C0E093D0350AD844404206D22851AF51C037B6D03556D844404406D228F1AF51C0C0C5CF3502D74440D6C77CD363B051C0A85ECF35DED4444040BB267E8EB151C070BF248BB7D244403EBB267E4EB251C0D893D0358AD444402EEA7CD30FB351C030B6D03556D444404406D22891B351C0607479E054D344404406D22891B351C070BF248BB7D24440E5E3D12885B351C0948D258B3FD24440329FD1288DB451C00036248B47D144401A837CD3CBB551C09C8D258B7FD04440051C7CD367B651C0687479E094D04440D3C77CD303B651C008E8CF354ECD444077A57CD317B651C038B6D035D6CB444078A57CD3D7B651C097F7CE35BACB4440924F7CD339B751C0304FD03572CC44403A2D7CD3ADB751C0707479E0D4CE4440623E7CD3F3B751C07871D035BECF4440C3AB277E62B851C0B07A248B5FD0444048947CD3F1B951C028B979E0ECD144404B947CD311BA51C058A3CF35B6CE44404606D228F1BA51C030B6D03596CC4440C0607CD39FBB51C0EC19CF3546CA44405EFB7CD335BB51C08871D0357EC64440EE717CD3A5BC51C00381CF35AAC444401C837CD36BBD51C08B71D035FEC3444030EA7CD34FBE51C0204FD035F2C344408AC1D12839BE51C08871D0357EC44440D4C77CD323BE51C0403CCF35D2C444409E28D228FDC051C04C3CCF3592C144404A947CD391C251C00081CF35EAC044407AA57CD377C451C0284FD03532C244400E67277E2AC351C0E893D0350AC3444040BB267ECEC251C070BF248BB7C44440061C7CD327C351C0D02CD035A6C64440AAB67CD3FDC351C06F557BE03CC84440924F7CD3F9C351C088427AE09CC5444079A57CD3B7C451C04C877AE0F4C444406989277E16C751C088427AE09CC54440BE607CD37FC651C0AB7A248B9FC3444078A57CD337C651C08C71D035FEC24440329FD128CDC751C0FC80CF35AAC14440F45DF648CEC751C068C835A7A8C14440A4CEFA4CCEC751C07F1C17EFA8C14440482D94E6DDC751C000BF4A22C0C24440AE2E61B30AC851C0FF6B7D55E7C544400C302E8037C851C05F07B2880EC944406C31FB4C64C851C04825B18836CC4440983BC71991C851C014284B2290CC4440F83C94E6BDC851C0D02AE5BBE9CC4440563E61B3EAC851C02B3F7D5543CD4440B33F2E8017C951C0F8B2E3BB9DCD4440563E61B3EAC851C04843B0885ECF4440F83C94E6BDC851C0A862B0881ED14440983BC71991C851C0F7F27C55DFD244406C31FB4C64C851C057834922A0D4444080B394E671C951C0B47EB18826D5444056CD60B37ECA51C0AC8B17EFACD54440664FFA4C8CCB51C088987D5533D644409866F0C569CC51C018EBFD44A3D644404EC469DB69CC51C038A7BB65A3D6444002D97CD369CC51C0A0F4258BA3D64440309FD1282DCC51C0B8C5CF35C2D744402E9FD128ADC851C044877AE0B4E044406989277E16C751C0E019CF3506E644404206D22811C851C034D5CE356EE544406889277ED6C851C0677479E0D4E34440944F7CD3D9CA51C090427AE0DCDD4440081C7CD347CB51C0BCC5CF3502DD4440F2717CD3E5CB51C00C81CF356ADC44402EEA7CD34FCD51C0607479E054DD4440F0717CD325CE51C0985ECF359EDD4440EAE3D12885CE51C0B0107BE0E4DC4440081C7CD3A7CE51C00036248B47DC44400EAA267E28CF51C06058248BD3DA44404811BBAF28CF51C098F19EFBD2DA4440DCD6FA4C24D151C0F0E9E2BBF9DF44407A7E94E651D251C0308FB0886AE14440094394E6F1D251C030394C22BCE144408698C719ADD351C03CBCE4BB59E244405441C719B9D451C0043AB2888EE34440CE96FA4C74D551C0A8497C5507E5444054A293E6CDD551C050FF17EF00E64440967D2D80EBD551C0A00F4B22D0E644406A09FB4CF0D551C08080B2887EE744406C0095E6A1D551C0B0574922D4EB4440A25860B3BAD551C07C69B0881EED4440229AC719BDD551C0800AB088BAED444026C5F94C94D551C084EE4A22D4EE44406413FB4C82D551C08BD5E4BB99EF44407A9C93E679D551C097D2AF8886F04440113360B39AD551C0005A16EFF8F14440B66FC819D5D551C0885B4A2274F244400ECAFA4C58D651C00C607D559BF24440B2C193E68DD751C03F73E5BB7DF244402A312E800FD851C098357E55B3F244406B2F95E641D851C0F8D54A2260F344409A8760B35AD851C0682D7E5537F444400ECDC71995D851C0B717B08846FC444012B160B3B2D851C098E04B224C004540D2FA93E6C5D851C0E80BB1880602454006562E8017DC51C0DC4CE5BB1902454086E494E6E1E151C040C5E3BBED014540D47BFA4CACE751C0104A4B22C0014540CED1FA4C76ED51C06F6FE4BB910145409630FA4C40F351C050D6E4BB65014540630CC7194DF351C0D8FEAF88C6024540F8FAFA4C9CFA51C0CCB0B088DA024540FA87C719110452C078A27F5523034540F2A3C719850D52C060D5B1886A034540F2BFC719F91652C0A8F6E5BBB10345402CB561B36E2052C0143B16EFF80345403667FA4CAC2352C0A09F4A221004454086C42D80D72452C040FB7D552B03454054CE2D80632552C088014A22200345401E9194E6352652C0DC11B38856034540D5232D80B32752C068584A2208044540EA6FFB4C7C3052C0B056B1883A044540DAA793E6D93052C0D071B0884E014540EA3DFB4C9C3352C014CF17EFE4004540B1F8FA4CB03352C0B056B1883A044540E01661B3263752C0C8F816EFB4044540361DC719413B52C0D8D24A22F404454070B660B3923F52C0DCCAE5BB31054540682094E65D4752C0B8B47E55A3054540A5F294E6294F52C0206FB28816064540A6CD94E6F55652C0A76A4922880645406C40C719C15E52C00F257D55FB0645406EC561B3766052C0485B4A221C0A4540E2E6FA4C106052C058F2B0886E0C454016D494E6355F52C0D49017EF24114540806F94E6895D52C03482B188621A4540EA99C719DD5B52C018F615EFA02345405A35C719315A52C0E8B74A22E02C4540C25FFA4C845852C048A9E4BB1D3645402C8A2D80D75652C0A89A7E555B3F45408EB460B32A5552C00B6EB1889A484540B00EFB4C7E5352C07C41E4BBD95145409A7194E6D15152C0C0327E55175B454057A0FA4C465152C0D8FE7D551B5E454042AC8635FE5052C030DA8FDC6F5F4540CA230927234D52C0BC8A247F675F4540838430CC6D4952C030C9AD5F415F4540A217EA1A404652C030C9AD5F415F4540D0DA7852324352C0A87A018E015F4540F46D32A1044052C060532BA5E15E45407E1D56E4E63C52C060532BA5E15E4540BC6E2E802F3A52C01FF14922EC5E4540ED1461B30A3752C000584A22C05E45400A4AC719E53352C070EEAF88925E454036F0F94CC03052C0B443B288665E45408A1C61B39A2D52C0244BE4BB395E4540D848C819752A52C0D85E7F550B5E45400AEFFA4C502752C04866B188DE5D4540262461B32A2452C028CDB188B25D4540CA912D80052152C08C6317EF845D45406DFFF94CE01D52C060CA17EF585D45405D1D61B3DE1D52C050E87E55575D454009D3FA4CDC1D52C050E87E55575D454042C1FA4CDA1D52C050E87E55575D45408220C719D91D52C050E87E55575D454064CD61B3D61D52C050E87E55575D45401EF4C719D51D52C050E87E55575D454092B260B3D21D52C050E87E55575D454082D0C719D11D52C050E87E55575D45403AF72D80CF1D52C050E87E55575D4540B4B5C619CD1D52C050E87E55575D45401E9BC719CB1D52C050E87E55575D45405689C719C91D52C050E87E55575D454008B02D80C71D52C050E87E55575D4540429E2D80C51D52C050E87E55575D4540A4832E80C31D52C050E87E55575D45401D42C719C11D52C050E87E55575D4540F43361B3361952C0EC13E4BB1D5D454086BD2D80AB1452C0E82D4B22E45C454026B8C619211052C0FF294B22AC5C45402EA161B3960B52C018B57E55735C4540CC9BFA4C0C0752C0C051B0883A5C45409E8D94E6810252C048AD7E55035C4540B64FC719F7FD51C03CC7E5BBC95B45408C4161B36CF951C0E0F24A22905B4540DE6B61B3E2F451C0EC0CB288565B454074F52D8057F051C07CA9E3BB1D5B45400C7FFA4CCCEB51C00494E5BBE55A4540DC7094E641E751C0AC3017EFAC5A4540AE622E80B7E251C0A84A7E55735A454044ECFA4C2CDE51C050587C553B5A454016DE94E6A1D951C0B060E5BB015A4540B4D82D8017D551C0C8EB18EFC8594540D2BF60B39AD351C0D8AAE4BBB5594540AED760B3F6D251C058AF17EFDC5945409856C81975D251C04476E3BB395A454044DF2D8083D151C00CA2B1884A5B454035D961B394D051C0747717EFA85C4540157394E6B5CF51C088BB7D554B5E45406C8FC71939CF51C0C83F7C55C75E4540AA12FB4C90CE51C068127E55335F45405292FA4C50CD51C08066E4BBC15F454024C661B38ECC51C0F8A2AF88466045401CE1C719E5CB51C014874A2260614540AE4B61B3A2CB51C09043E5BB3D624540749293E60DCB51C0888C4C22A46445406C82C7198DCA51C070204B220066454076432E8049CA51C040EB16EF94664540B051FA4CB4C951C014A618EFA46745407A90C7195DC951C0EF8FB188166845400AD893E605C951C0C80318EF70684540A60C95E681C851C030E97D55BB68454096062E80DFC751C0448EE2BBE16845403A5BFB4CC8C651C0A4E84A22CC684540849DFA4C0CC651C030977E5597684540D662C81955C551C020B5E5BB95684540A4CAC719B9C451C0448EE2BBE16845407C4C2E80E3C351C0FC024A22C8694540EE53FB4C6AC351C010BBB1887E6A45402215C71979C251C0A8514A22346C4540349EFA4C24C251C020EE16EFA86C45406A5761B370C151C0705E4B22686D454072F6FA4C3CBB51C060B5E3BB7971454032CC60B3A6BA51C0976DB08882714540BC262E80E3B951C0F00316EF547145400A20C819BDB751C078BDE3BBF56F4540,-16.2%,-184,949,34,915,Massachusetts,true
21,0106000020E61000001B0000000103000000010000000C00000084D47D2B32A751C07882875AF47D454074C61ED7EFA651C00CD8AC19EA7D454014B8E8D69EA651C0886431B9EA7D454052A268F580A651C0908A583B7F7D4540FC8DE6C3D1A651C07C9653EE3D7D4540A6BA8E0B23A751C07890FDB7887D4540AA8A2DC07BA751C0107D9437DE7D4540B20532D8A0A751C0DC32A45A297E45409FDA53E483A751C0243663A8B57E454032298ECE1CA751C0C4C02F3FC17E4540FA5F12BA0DA751C09CE12764607E454084D47D2B32A751C07882875AF47D454001030000000100000007000000765AD128D55351C054D2258B57E14540765AD128955451C027B979E0ACE04540BF607CD3BF5451C054D2258B57E14540C0607CD37F5451C0BCC5CF3582E24540765AD128155451C0BCC5CF3502E34540C2607CD33F5351C018B979E0ACE24540765AD128D55351C054D2258B57E1454001030000000100000008000000BE607CD3BF6951C024B979E02CE54540BE607CD37F6A51C0B8C5CF3502E54540705AD128D56B51C040D2258BD7E74540705AD128156C51C0C0C5CF3502EA4540725AD128156B51C028B979E02CED45400A67277E6A6951C028B979E02CEB4540BE607CD37F6951C04CD2258BD7E84540BE607CD3BF6951C024B979E02CE54540010300000001000000070000000E67277EAA3851C0AFC5CF3582ED45400E67277EAA3951C028B979E0ACEC4540705AD128D53951C0AFC5CF3582ED4540C2607CD37F3951C0BCC5CF3502EF4540725AD128553951C050D2258BD7EF4540725AD128953851C018B979E0ACEF45400E67277EAA3851C0AFC5CF3582ED454001030000000100000007000000C0607CD3BF5B51C040D2258B57F445400A67277E6A5C51C020B979E02CF445400A67277E6A5C51C0C0C5CF3502F64540745AD128155C51C027B979E0ACF74540C0607CD3BF5B51C054D2258BD7F94540C0607CD3FF5A51C028B979E02CF84540C0607CD3BF5B51C040D2258B57F445400103000000010000006D00000052A2A09FBF6D51C0EC17958302EE4540C0607CD3BF6D51C0AFC5CF3502EE45400967277E2A6E51C018B979E0ACEF4540C0607CD3BF6E51C0B8C5CF3502F24540C0607CD33F6E51C020B979E02CF44540765AD128D56C51C02CB979E0ACF645400B67277E6A6C51C0AFC5CF3502F945400E67277E6A6B51C050D2258BD7FB4540725AD128D56A51C054D2258B57FA4540725AD128D56A51C028B979E0ACF84540725AD128956B51C0C0C5CF3582F745400C67277E2A6C51C040D2258BD7F34540EEC4C6FE2A6C51C0986FFB8DD2F34540B636CF9C2B6C51C0970E4577CCF345403AFADD762C6C51C0B004B41CC4F345408EFB1F8B2D6C51C0D0796E97B9F345405ADBBDD72E6C51C0F32CA300ADF34540E45FE25A306C51C0F84578719EF34540BE3CB712326C51C0E7831C038EF34540144B68FD336C51C0A70EB6CE7BF34540822B1E19366C51C048A573ED67F3454066A40364386C51C0786F7B7852F34540147C43DC3A6C51C06C2CFC883BF345402E5306803D6C51C0E0031C3823F34540EE02784D406C51C0E8B4099F09F34540AA51C342436C51C06067EBD6EEF245401ACD0F5E466C51C038DAEFF8D2F245405D618A9D496C51C080353D1EB6F2454012AF5BFF4C6C51C00838026098F24540887CAE81506C51C0E00965D779F24540457DAC22546C51C0DF69949D5AF245407B8A81E0576C51C0F07FB6CB3AF24540CA4456B95B6C51C0200BFA7A1AF24540897255AB5F6C51C04C3385C4F9F1454019DAA9B4636C51C070B786C1D8F14540061C7CD3676C51C070BF248BB7F145409411F8056C6C51C0480A8E3A96F145402481484A706C51C0E0BFE8E874F1454066F8949E746C51C0309F63AF53F145407A630A01796C51C038D024A732F14540F462D16F7D6C51C0D0115BE911F1454036BD14E9816C51C0F48B2C8FF1F04540AF25FE6A866C51C090FDC7B1D1F04540A675B9F38A6C51C0888E536AB2F04540B04D6F818F6C51C0EFFDFDD193F045402E744A12946C51C0A873ED0176F045406EAF75A4986C51C0A4AE501359F0454012A019369D6C51C0B0D64D1F3DF04540561F62C5A16C51C004AB133F22F0454092F37950A66C51C05F53C88B08F045407EAA88D5AA6C51C0C48E9A1EF0EF45403230BB52AF6C51C0FF84B010D9EF454054253AC6B36C51C04BF5387BC3EF45403250302EB86C51C04B075A77AFEF45405264C788BC6C51C01C7A421E9DEF4540E73A2BD4C06C51C0B07518898CEF45408E74840EC56C51C0EFB80AD17DEF45409AD7FD35C96C51C0C86B3F0F71EF45406C2AC248CD6C51C0284DE55C66EF4540A50DFA44D16C51C00C8522D35DEF4540765AD128D56C51C050D2258B57EF454028676D55DD6C51C0B0F1FA824CEF45406E7B84C5E16C51C058A1B76E46EF4540A4FEEA6CE66C51C0704D530140EF4540F80F3948EB6C51C07C230C4039EF4540A6BB0554F06C51C07076223032EF4540B433EA8CF56C51C05728D0D62AEF454088717CEFFA6C51C0408C553923EF45403E945478006D51C080CFF05C1BEF454004BB0A24066D51C07F1FE04613EF454036DF34EF0B6D51C0C8A961FC0AEF4540D4326CD6116D51C040C1B58202EF454004D548D6176D51C0F84716DFF9EE454056AC5FEB1D6D51C0F090C316F1EE45409CFD4A12246D51C0A4C9FB2EE8EE454040C2A0472A6D51C06C1FFD2CDFEE45406A19F987306D51C0B0BF0516D6EE4540550FEBCF366D51C097FD55EFCCEE454009D60F1C3D6D51C0E8BA27BEC3EE4540E466FD68436D51C0CF4ABB87BAEE454016E14BB3496D51C0CFDA4E51B1EE4540B26393F74F6D51C020982020A8EE45402AE86932566D51C038B06EF99EEE45407AA068605C6D51C0407679E295EE4540C3AB277E626D51C008CC7AE08CEE454092F03B88686D51C0B004B3F883EE4540BAB33F7B6E6D51C0C04D60307BEE4540B2EEC853746D51C06BD4C08C72EE45408EC06F0E7A6D51C020C612136AEE45409A35CBA77F6D51C02C7696C861EE4540D07F741C856D51C038C685B259EE4540A29801698A6D51C0770921D651EE4540269F0A8A8F6D51C0546DA6384AEE454088B2277C946D51C0301F54DF42EE454026CCEE3B996D51C06F4C68CF3BEE4540081EF9C59D6D51C03C48230E35EE454050C7DE16A26D51C054F4BEA02EEE45407AAE342BA66D51C0FCA37B8C28EE4540711895FFA96D51C0938497D622EE454096FE9590AD6D51C068C350841DEE45401080CFDAB06D51C0D88DE59A18EE454020A9D8DAB36D51C04437961F14EE4540C2AB4A8DB66D51C040A19C1710EE45406881BBEEB86D51C0201F39880CEE45402849C3FBBA6D51C020DEA97609EE45402C22FAB0BC6D51C0C80B2DE806EE4540D605F60ABE6D51C060D500E204EE45402A265006BF6D51C0208E656903EE454052A2A09FBF6D51C0EC17958302EE454001030000000100000009000000715AD128955851C050D2258B57FD45400E67277EEA5851C050D2258B57FC4540C2607CD33F5951C050D2258BD7FC45400C67277E6A5951C040D2258B57FE4540C1607CD3FF5851C0B8C5CF3582FF45400E67277EAA5851C03FD2258B57004640BC607CD33F5851C0C4C5CF35820046400E67277E6A5851C0B7C5CF3582FE4540715AD128955851C050D2258B57FD45400103000000010000000D000000765AD128952851C04CD2258B57024640C0607CD3FF2951C04CD2258B570146400A67277E6A2A51C0C0C5CF3582024640BE607CD33F2A51C028B979E02C044640745AD128D52951C01BB979E0AC0646400A67277EAA2951C050D2258B57084640C0607CD3FF2851C0B7C5CF35020A4640765AD128152851C020B979E0AC0B4640725AD128D52651C040D2258B570B4640BB607CD37F2651C0BCC5CF3502094640725AD128552651C0B0C5CF35020646400E67277EEA2651C0C0C5CF3502034640765AD128952851C04CD2258B5702464001030000000100000012000000061C7CD3A73351C008E8CF35CE0446403678277E303451C033B6D0351604464004D97CD3693551C08471D0357E044640D90A7CD3A13751C018337BE0300646401C837CD30B3751C060EE7AE0580846403A2D7CD38D3751C0F4647AE0280A4640C3EE267EC03851C0A8A97AE0800B4640CAEE267E403A51C090F7CE353A0C46405CB0D128B33951C060EE7AE0980E464061FB7CD3953851C04F3CCF35920E4640061C7CD3473651C090F7CE353A0C4640623E7CD3F33451C08871D0357E0B46408233277E183251C030B6D035D60A46407E33277E783151C0A813248B7B0A4640623E7CD3933151C0109D248BEB074640924F7CD3593251C0386B258BB3064640939A277E3C3351C05FA3CF35F6054640061C7CD3A73351C008E8CF35CE044640010300000001000000070000000E67277E6A1F51C02CB979E0AC0E4640BC607CD33F2051C040D2258BD70C4640705AD128152151C0C0C5CF35020E46400C67277EEA2051C0BFC5CF35820F4640725AD128552051C028B979E02C104640725AD128D51F51C048D2258BD70F46400E67277E6A1F51C02CB979E0AC0E4640010300000001000000090000000A67277EEA1651C040D2258B570D46400A67277EAA1751C020B979E0AC0C4640745AD128151851C0C0C5CF35820E4640735AD128551751C02CB979E0AC0F4640765AD128551651C048D2258B57104640765AD128D51551C02CB979E0AC0F46400C67277E2A1551C020B979E02C0E4640765AD128951551C0C0C5CF35020E46400A67277EEA1651C040D2258B570D464001030000000100000011000000745AD128D53551C028B979E0AC114640C0607CD37F3651C0BFC5CF3502104640BE607CD33F3751C048D2258B570F4640715AD128D53851C028B979E0AC1046400E67277EAA3951C028B979E02C114640765AD128D53A51C0BFC5CF3502104640C0607CD3FF3B51C0C4C5CF35820D4640745AD128553C51C0C0C5CF35020F46400A67277E2A3C51C0BFC5CF35021046400C67277E6A3B51C028B979E02C1246400E67277EEA3851C0BCC5CF3502154640745AD128D53651C023B979E02C174640C2607CD37F3451C044D2258BD71646400C67277EEA3351C018B979E0AC1546400C67277EEA3351C0B0C5CF3502134640C0607CD3BF3451C0B0C5CF3582124640745AD128D53551C028B979E0AC114640010300000001000000140000000C67277E6A1C51C023B979E02C174640755AD128151C51C050D2258B57164640765AD128551B51C0B8C5CF35821646400C67277EAA1A51C03FD2258B57174640BC607CD3BF1951C0B8C5CF3582164640BE607CD3FF1851C050D2258BD7144640715AD128151951C028B979E0AC124640725AD128D51951C028B979E02C1146400C67277EAA1B51C0C0C5CF3582104640765AD128551C51C0B0C5CF3582124640745AD128151D51C054D2258B571346400A67277EAA1D51C01CB979E02C134640725AD128551F51C0B0C5CF35021246400E67277E2A2051C0B0C5CF35021346400E67277E6A2051C0BCC5CF3582144640BE607CD37F1F51C018B979E0AC1546400A67277E6A1E51C050D2258B57154640BE607CD33F1E51C024B979E0AC1646400A67277E6A1D51C023B979E0AC1746400C67277E6A1C51C023B979E02C17464001030000000100000009000000BF607CD33F0F51C048D2258B571E46400A67277E2A1051C028B979E0AC1D46400A67277E6A1151C028B979E02C1E4640735AD128D51151C0B0C5CF35021F4640735AD128D51151C0BCC5CF3502214640745AD128151151C0BCC5CF35822146400B67277EEA0F51C050D2258B57214640765AD128950F51C050D2258B57204640BF607CD33F0F51C048D2258B571E46400103000000010000001E0000003878277E502751C0189D248BAB1C46404C947CD3F12651C08B71D0353E1B46402EEA7CD3AF2751C030D5CE35AE1A4640929A277E3C2951C0C4C5CF35021A4640DE0A7CD3012A51C07871D0357E194640D4C77CD3A32951C08826258B5B1846400A1C7CD3272951C0DFB2CE35A2174640AEF97BD3DB2751C080DB79E0B8164640AEF97BD3DB2751C03BD5CE35EE154640BAD2D1285F2A51C08071D035FE134640F0717CD3A52B51C0DC777BE0881346408033277ED82D51C01C9D248B6B15464078A57CD3172E51C0D8777BE008164640949A277EBC2D51C0304FD03532174640BAD2D1287F2D51C0C89679E060184640FE8DD128A72D51C09CF7CE35BA194640BE607CD35F2E51C0E093D0350A1C46407017D228D72D51C064A3CF35F61B4640A46BD128BB2C51C0A05ECF351E1C46403678277E302C51C0E093D0350A1C4640ACF97BD37B2C51C0C8E1248B431D464078A57CD3972C51C0F8647AE0A81E4640BB607CD37F2C51C01CE8CF350E2046403678277E302C51C0D4777BE048214640663E7CD3732B51C0C8E1248B8322464078A57CD3B72A51C05858248B9322464076A57CD3172951C0D4777BE048214640C6EE267EE02751C0AC13248BFB1F46406CCC267E742751C058EE7AE0581E46403878277E502751C0189D248BAB1C46400103000000010000006A0000000E67277E2A2C51C044D2258B57234640725AD128152D51C0B8C5CF35022346404AD2B35B162D51C064C0BB0403234640A30BA8D2172D51C0FCCE3B04042346402A6798D5192D51C058CC4C6605234640B47FC05E1C2D51C058FFD7280723464040DD5A681F2D51C0883DC049092346407840A5EC222D51C0A4CDEEC60B2346405631DAE5262D51C088F64C9E0E234640BA4A354E2B2D51C0A08DBDCD112346409227F21F302D51C0E0D9295315234640A8624C55352D51C00C227B2C192346400C847EE83A2D51C0983B94571D234640624CC6D3402D51C0686D5ED221234640A0435E11472D51C040FEC29A26234640AA04829B4D2D51C0A0C3A4AE2B234640602A6D6C542D51C07C04ED0B31234640A84F5B7E5B2D51C0680785B0362346407FFC86CB622D51C014A24F9A3C23464088F12D4E6A2D51C03C1B36C742234640C6B68A00722D51C0C0B921354923464010E7D8DC792D51C00853F5E14F2346404E1D54DD812D51C00B2E9ACB562346405CF437FC892D51C07C91F9EF5D23464042F4BE33922D51C0E052F64C652346409EDD267E9A2D51C028B979E06C2346406838AAD5A22D51C0FC0A6DA8742346408D9F8434AB2D51C0E81DB3A27C234640ECADF194B32D51C0C83835CD8423464062FE2CF1BB2D51C058A2DC258D234640EA187143C42D51C038308CAA9523464034BEFB85CC2D51C034292D599E234640327607B3D42D51C0F8D3A82FA7234640CCDBCFC4DC2D51C02806E22BB0234640E08990B5E42D51C09C06C24BB9234640581B857FEC2D51C00C1C328DC22346402818E81CF42D51C0001C15EECB234640F440F787FB2D51C0604D546CD5234640C41DEDBA022E51C0DCF6D805DF2346406E4905B0092E51C004EE85B8E8234640DC5E7B61102E51C0A0794482F2234640E6F88AC9162E51C09CE0FD60FC234640929F6EE21C2E51C050F8945206244640881364A6222E51C0C807F35410244640BADCA50F282E51C0A05501661A24464014966F182D2E51C058B7A283242446406EDAFCBA312E51C0F073C0AB2E244640B44489F1352E51C010D243DC38244640DC5C4FB6392E51C050A70F134324464084E38C033D2E51C0743A0D4E4D244640C2607CD33F2E51C040D2258B572446405E631571452E51C0EF2143366C244640F8FC529A482E51C0F8D946AB76244640B6CFA8FB4B2E51C0C089113181244640E0B2F3914F2E51C0B8E27DC48B2446405C320C5A532E51C068966662962446406625CF50572E51C06356A607A1244640DA1715735B2E51C060D417B1AB2446400AE1BABD5F2E51C0D0C1955BB6244640C80C992D642E51C048D0FA03C124464064728CBF682E51C064B121A7CB244640AC9D6D706D2E51C0A016E541D6244640FA65193D722E51C0A8B11FD1E02446401E576822772E51C0F033AC51EB2446406648371D7C2E51C0384F65C0F5244640A6C55E2A812E51C0EFB4251A002546402EA6BB46862E51C0B816C85B0A254640D275266F8B2E51C00026278214254640E00B7CA0902E51C088941D8A1E25464034F494D7952E51C0E01386702825464018064E119B2E51C064553B32322546405CCD7F4AA02E51C0D70A18CC3B25464058210780A52E51C0C8E5F63A45254640D68DBCAEAA2E51C0C897B27B4E2546402CEA7CD3AF2E51C040D2258B5725464034C220EBB42E51C00C472B666025464034ED84F2B92E51C068A79D096925464004F781E6BE2E51C034A5577271254640F2B6F4C3C32E51C0CFF1339D79254640D0B8B587C82E51C0E03E0D8781254640F2D3A12ECD2E51C0E83DBE2C892546402E9491B5D12E51C087A0218B90254640CCD06119D62E51C05818129F97254640AE15EB56DA2E51C0D8566A659E2546400C3A0A6BDE2E51C0B00D05DBA4254640D6C99752E22E51C060EEBCFCAA254640449C700AE62E51C078AA6CC7B0254640363D6D8FE92E51C09CF3EE37B6254640FE836ADEEC2E51C04C7B1E4BBB2546406AFC40F4EF2E51C008F3D5FDBF254640C47DCDCDF22E51C0A40CF04CC4254640EC93E867F52E51C074794735C825464030166FBFF72E51C014EBB6B3CB2546405E9039D1F92E51C0281319C5CE254640CED9249AFB2E51C027A34866D12546404D7E0917FD2E51C0C84C2094D32546402655C444FE2E51C094C17A4BD52546403CEA2D20FF2E51C008B33289D6254640D21423A6FF2E51C0C8D2224AD7254640BF607CD3FF2E51C040D2258BD7254640BF607CD37F2F51C020B979E0AC2646400C67277E2A2F51C04CD2258B572746400C67277EAA2E51C020B979E02C2746400E67277EEA2C51C01FB979E0AC254640BE607CD3BF2B51C0B8C5CF35822446400E67277E2A2C51C044D2258B572346400103000000010000000C0000000E67277EAA3851C040D2258B572646400E67277EAA3951C040D2258BD72346400C67277EEA3A51C048D2258B571E4640C0607CD3BF3B51C028B979E02C1E4640C0607CD3BF3B51C028B979E02C1F4640755AD128553B51C018B979E02C2246400B67277E2A3B51C0B8C5CF3502244640C0607CD33F3C51C0B8C5CF3502244640745AD128553C51C020B979E02C2546400B67277E2A3B51C04CD2258B572746400E67277EAA3951C04CD2258BD72746400E67277EAA3851C040D2258B572646400103000000010000000C000000755AD128951B51C0B0C5CF35822A4640C0607CD33F1C51C028B979E0AC2946400C67277E6A1C51C0B0C5CF35822A4640745AD128D51C51C027B979E0AC2B46400A67277EEA1C51C018B979E02C2D4640C0607CD33F1C51C04FD2258B572E4640705AD128151B51C044D2258BD72F46406F5AD128D51A51C018B979E02C2F46400C67277EAA1A51C0BCC5CF35822D4640C2607CD33F1B51C0B0C5CF35822C4640755AD128951B51C0B0C5CF35022C4640755AD128951B51C0B0C5CF35822A4640010300000001000000100000000A67277E6A1E51C0C0C5CF3582294640BE607CD3FF1E51C02BB979E02C284640725AD128D51F51C0C0C5CF3502294640725AD128952051C048D2258B572946400B67277E6A2151C048D2258B572946400C67277EEA2151C048D2258B572A46400C67277EEA2151C01CB979E02C2C4640755AD128952151C0BCC5CF35022E4640C2607CD33F2151C0B8C5CF35022F4640C2607CD3BF2051C0B8C5CF35823046400E67277E2A2051C024B979E0AC304640BC607CD3BF1F51C024B979E02C304640BE607CD37F1F51C018B979E0AC2E4640725AD128551F51C0B0C5CF35822C46400867277E2A1F51C048D2258BD72A46400A67277E6A1E51C0C0C5CF35822946400103000000010000000B0000000E67277EAA3851C048D2258B572A4640705AD128D53951C047D2258BD72846400C67277EAA3A51C0B0C5CF35822A46400C67277EAA3A51C01CB979E02C2C4640705AD128553A51C050D2258BD72E4640725AD128953951C040D2258B57304640725AD128953851C020B979E02C324640735AD128953751C040D2258BD7304640BE607CD3FF3651C04FD2258BD72D4640735AD128953751C0B0C5CF35822C46400E67277EAA3851C048D2258B572A464001030000000100000029000000A46BD128BB0C51C0B0A97AE08027464004D97CD3690F51C0336B258BB3254640DA0A7CD3211251C038D5CE356E254640D0C77CD3A31351C094F7CE357A274640623E7CD3131451C094F7CE357A274640949A277E7C1451C078DB79E078244640382D7CD3CD1351C027D5CE35AE224640944F7CD3F91251C01C9D248B6B2146406E17D228F71251C0B0C5CF3502204640CC39D228C31351C0304FD035721E4640A5B67CD3DD1451C00481CF35EA1C464075A57CD3D71551C0A05ECF359E1C4640C739D228431651C08871D035BE1E46401E837CD38B1651C080DB79E0781E4640061C7CD3471751C0F0AF258B0B1E46405CB0D128931751C0D893D035CA1D4640643E7CD3531851C0FCAF258B8B1F4640C2607CD37F1A51C0780AD0351A214640AEF97BD31B1B51C07826258B1B234640DE55277E241A51C0D09679E0A02346405CB0D128F31951C0C8E1248B83244640DE55277E641A51C08826258B5B2546407F33277E581B51C0AC13248BBB254640663E7CD3D31B51C0C82CD03566264640DA55277EC41B51C024337BE0F02746403478277E701B51C01C337BE0B0294640BAD2D1283F1A51C03CB6D035162E46402EEA7CD3AF1951C037B6D035962F4640C0607CD31F1951C080DB79E038304640C6EE267E401851C06458248B93304640DE55277E841751C058A3CF35763146403678277E501751C0740AD0359A3246402411277E0C1851C088DB79E0B833464078A57CD3B71651C038D5CE352E36464074A57CD3371451C030D5CE35EE37464004D97CD3891151C087F7CE353A38464014F5D128AB0F51C038B6D03556364640AAF97BD37B0F51C03CB6D035D6334640AAF97BD3DB0B51C0334FD035B22D46402411277E4C0B51C0E419CF35062A4640A46BD128BB0C51C0B0A97AE0802746400103000000010000000B000000C0607CD33FE450C0BBC5CF35023B46400A67277E6AE550C054D2258BD7384640BE607CD3FFE550C0BCC5CF35823A4640BE607CD3BFE650C040D2258BD73D46400E67277E6AE750C02CB979E0AC404640725AD12855E750C048D2258BD74146400867277E6AE650C048D2258B57424640C0607CD33FE550C048D2258BD7414640C0607CD3FFE450C040D2258BD73E4640C0607CD33FE450C040D2258B573D4640C0607CD33FE450C0BBC5CF35023B4640010300000001000000080000000A67277EAAD150C02CB979E02C4D4640745AD12855D350C04CD2258B574C4640725AD12895D450C02CB979E02C4D46400E67277E6AD450C048D2258B574E46400A67277E6AD350C0AFC5CF35025046400967277E2AD250C048D2258B574F4640765AD12855D150C0C0C5CF35824E46400A67277EAAD150C02CB979E02C4D46400103000000010000000A000000ACF97BD31BBF50C0406B258B73744640745AD12855BF50C0B8107BE0E4724640F6FF267EC6C050C0A05ECF351E734640AAF97BD31BC150C098F7CE353A744640CE39D228E3C250C027B979E0AC764640CE39D228E3C250C0B4107BE0E47846404306D22871C250C090F7CE353A7A4640C839D228E3C150C0B4107BE0E47846408033277E38C050C0406B258B73764640ACF97BD31BBF50C0406B258B73744640010300000001000000160000000867277EEABA50C050D2258BD76C4640725AD128D5BA50C018B979E02C6B4640725AD12815BC50C050D2258B576B46400C67277E2ABD50C050D2258B576C46400C67277E6ABE50C023B979E02C6E4640765AD128D5BE50C020B979E0AC6F4640705AD12855BD50C040D2258B57704640705AD12815BD50C04CD2258BD7714640705AD12815BD50C02BB979E02C734640715AD12895BC50C028B979E02C7546400E67277E2ABC50C0B0C5CF3582764640BB607CD3BFBB50C0BCC5CF3582784640BE607CD3FFBA50C04FD2258B577946400A67277EEAB950C050D2258B577A46400A67277EEAB950C018B979E02C794640745AD128D5B950C0B0C5CF3582774640745AD12815B950C0B0C5CF35027646400A67277E2AB950C0C0C5CF35027446400A67277EAAB950C04CD2258BD77146400867277EAABA50C040D2258B57704640725AD12895BB50C040D2258B576F46400867277EEABA50C050D2258BD76C46400103000000010000000F000000765AD12895BE50C050D2258BD7774640745AD12815BF50C0B0C5CF3582764640745AD12855C050C04FD2258B577946400867277EEAC050C040D2258B577B4640725AD12815C150C040D2258B577D4640745AD12855C050C020B979E0AC7E4640745AD12855BF50C02CB979E02C804640765AD12855BE50C048D2258B57824640705AD12815BD50C0AFC5CF3582834640725AD12815BC50C028B979E02C8346400E67277E2ABC50C0B4C5CF3582814640C2607CD37FBC50C0C0C5CF35028046400E67277EAABC50C040D2258BD77D46400C67277EAABD50C0B8C5CF35027B4640765AD12895BE50C050D2258BD777464001030000000100000020040000E6BDF6A1924251C0E8DD6209E19F474024B43AA6FF3951C018683C2D599847403278AB23F13851C068F06CE0659847409675ACA3C13051C0D8C13056579E4740DCC28247F02D51C04023E1BA639F4740F497ACA3CD2A51C094269D76289F4740E07541A03A2951C0B4805E6C659F4740DC5475D3092851C054F8188BAAA04740F1001944E82651C0A741B5C189A2474068604F94742551C03750939F28A447409051C0D1892251C0E87B579561A647406EEEE410272151C0C40E337302A7474028A252317D1F51C09C4ED8E35DA747403055342CDF1D51C0B8CE14EE20A74740FEFA3A66DC1B51C0A446727D48A547404C96CE450B1B51C008F2749A84A547401ACD59EB401A51C0583B26FF11A64740C2D0F0E7AD1851C008D6188B9EA647404CFED37F891851C010CCE45750A74740D20FBD34A11851C0483F44846EA84740EC6F6A7C731851C0384F3AADF5A94740B4881FFE421651C0D7044584E3AD47404E69F9BE2E1351C080E7D02915AF47401CF129D5C50F51C00F46024027AE4740F0045A6B9C0C51C0B41DFA05B3AB47400E3CAB23CC0B51C090640917A4AA474072813E03FD0951C008EC731A41A747407C5934AC480951C04CB7A11396A64740EE4E9EAF620751C0B812908269A54740E67A05167E0651C07F7B59B2A1A447409274453D850251C04023E1BA639F4740D5C3BF5190FF50C028A9BA5E929C474040BA7B8D98FD50C008A502DD4D9947409E004C7709FD50C0A7F7707DE39747409E938981CCFC50C08848B4C122964740FED7B5FA60FC50C0984B0C970F954740C6A8D1628BF950C05CFD9D76C3914740F24BA806B8F750C0E848ABEABD8D474060F66D19B4F650C08779E657868C474024A5564E11F450C0789C33F37B8A47408A7726B8C1F350C0BC89941F9E8947402EEB602588F350C0E02EEC918F8447402E7D4CF75CF350C094BE820E5C734740827FB67A33F350C05C1CDB00266247403AC0602509F350C067CB741AEF504740CE130CD0DEF250C0E8D78BE5B93F474046037553B5F250C0A8672262862E4740DA5620FE8AF250C030EB7C54501D47409A97CAA860F250C04423D3461A0C47402EEB755336F250C03004ABEAE5FA4640F6D952B118F250C02854E9F4AAF94640E230BA17B3F150C05C3C6309B2F84640B4644F141EF150C06068CA6FCDF74640088B903B9EF050C0C0113E4ADBF64640B08C6E9980F050C0279F6A43B1F54640F294AF403EF150C05CF36943B5F346403A78C70B64F250C087253610ECF1464092BE82C726F350C0B420135115F046405241EF67BAF250C0D8383CADF0ED4640EAC00179ABF150C0700E9002A0EB464006B1F62176F150C00745B7C1FDE946409EDC8247E9F150C0A8B2CD0C69E846409E0197F5D2F250C04866EE2E4BE646402EEA0EED99F350C0E802AF8710E44640CA173F83E9F350C0D77525FF1CE24640BC1FB767E4F350C094D438C796E1464036A9520557F450C02496A970A0E04640B02B222198F450C028680272D1DE464098AA2F96F8F450C068822D9297DE4640EE228EC99BF750C0EC59FAD64EDF4640FA11CC0CD6F650C048BB4DFEA1DC4640183922377DF550C0D4B5D9BA1BDA4640DD1022F5CDF250C078A6270891D646405C1F5D09EAEE50C0603CD16F70D34640FA1D807848EE50C0F3F1193B9CD24640C0A9B8F789ED50C0C84CBE2032D24640589CB8E1A4EC50C0C8E311A019D346403AD5D84DAFEA50C0F414D9B25ECF464012E2035890E950C04498B0533DCE4640B29A39BE98E650C008E731B48FCD46405422DB8AF5E350C070F71E6551CC464048368AE297E250C020C5AD3A04CC464030B23BA34ADC50C0B3B4C08942CD4640D64E1C5738DC50C093F3141163CD464066633E839ADB50C0C8E5E45789CC4640C83956CE03DB50C00F0EA74DCEC8464074A652B146DB50C038E4371048C44640B38ABCB45ADC50C0DC4FAAEAD6C246409429A806ECDD50C03005F6680FC14640CA37C0D190DF50C0B85869431FBF46402580342CDEDE50C0385245844EBA46404E2768DF71DB50C027329AD98AB14640696048DACFDB50C06068D8E3D6AC46404AFF332C61DD50C000D4741AC2A8464030EA15A7FEDD50C0302A188BA2A646402AC5ECCA66DE50C0B0851B2824A446402E582AD529DE50C0103FAF8715A2464066F67B8D5DDB50C0C0A603DD479E46408AC01F7EFED850C0A02720C5B79846409A2A1627CDD650C09F8AA0133D954640E2E1B8176ED450C0F0BFAF87B293464000FB33AC37D250C0E0E7A4B0B8954640A6FF07B3E4D150C02C79EF2EEB964640FCFFCDC5DED150C0F0695BCFFB974640FE20AFC0BDD150C05C62DE1DF8984640C2A6110A1CD150C06716E8F4EB99464054039FAF51D050C0773716EE3E9A46407E592DF283CF50C0909967A6ED994640307BAF4005CE50C084E4BE98979846409839C0D331CD50C0645B45473E984640D0C77CD343CB50C0A85ECF35DE964640A8B67CD33DCC50C03FB6D035169746406CCC267E14CD50C02C04258BCF9646405EFB7CD375CD50C0CC2CD035E69546402411277E0CCD50C0F4647AE02894464014F5D128CBCC50C0ECAF258B0B944640C0607CD37FCB50C0F4647AE02894464010AA267E08CB50C08C26258BDB934640081C7CD3C7CA50C0A8F4258B23934640B6D2D1289FCA50C0D4777BE0489246407217D22837CA50C010337BE0F0904640A5B67CD3DDC950C0A8A97AE0408F4640AAF97BD3BBC950C00F9D248BEB8E464078A57CD357C950C08871D035BE8E46401E837CD3EBC850C0F735248B478E46406ECC267E34C850C0189D248B2B8D4640CC39D22843C750C0C09679E0208B464012F5D1286BC650C0C89679E0E0884640AAB67CD31DC750C0A05ECF35DE8646403878277EB0C650C07F26258BDB844640CE39D228C3C550C01804258B4F8346403A2D7CD3EDC450C00817268BAF8246405EFB7CD395C450C048D2258BD7814640603E7CD353C350C0B87A248BDF7D46403A78277E90C250C040207AE0907C464078A57CD357C350C0EBAF258B0B7B46405FFB7CD395C350C0CCE1248B03794640D2C77CD303C450C078DB79E03877464075A57CD357C550C0406B258B737646402611277E0CC650C030D5CE356E774640061C7CD3C7C650C02804258B0F794640DC0A7CD381C750C0A0F4258B637946406ECC267E34C850C0406B258B73764640969A277E3CC750C01C337BE0307546402011277E2CC750C088DB79E0B873464004D97CD3C9C750C0B0A97AE080724640A8F97BD3DBC850C0B0A97AE0007246402EEA7CD3AFC950C03CD5CE35AE7246405CB0D128D3CB50C057EE7AE0587546405CB0D12893CC50C05058248B93754640DE55277E04CD50C05858248BD37346404A947CD331CC50C07871D035FE714640008ED12807CB50C0DC777BE0487046403A2D7CD36DCA50C01B337BE0F06E4640D2C77CD383C950C0B3F4258B6368464078A57CD357C950C018337BE0B0694640633E7CD333C950C0D7777BE0886D4640623E7CD313C950C0A8A97AE0806E464078A57CD357C850C01017268BAF6E46404A947CD351C750C0D448258B676C464012F5D1286BC650C0AFA97AE0C06C4640DA55277EE4C650C060A3CF35B66D4640EE717CD305C650C0A8A97AE0806E46407017D22837C650C06358248B136F46401C837CD38BC650C0C89679E060704640DA55277EE4C650C0E8AF258B0B71464002D97CD3A9C550C030D5CE35AE71464010AA267EC8C450C058A3CF35766F464018837CD34BC450C03BB6D035166C4640AAF97BD33BC450C0A8A97AE04069464012F5D128CBC250C0888D258BBF6A46402EEA7CD3AFC250C0A05ECF355E6D46401A837CD3CBC350C0AC7A248BDF7246401A837CD3CBC250C01317268B6F724640A8F97BD31BC250C0306B258B33714640FE8DD128C7C050C060A3CF35B66D46406CCC267E94C050C0985ECF359E6D464002D97CD3A9BF50C060A3CF35B66D46405AB0D12873BF50C0E819CF35866D4640623E7CD373BF50C0F8AF258B0B6D4640DE0A7CD381BF50C060BF248B776C464078A57CD377BF50C060BF248BF76B464032EA7CD3AFBE50C007E8CF35CE6846402611277E8CBE50C0B3F4258B6368464006D97CD309BF50C00036248B07674640A6B67CD33DC150C01F337BE03063464060FB7CD315C250C020337BE03062464076A57CD3B7C250C06458248B1362464076A57CD317C450C0CC9679E06062464062FB7CD3B5C450C020337BE030624640A8B67CD3BDC450C0AFA97AE0C0614640D0C77CD343C550C02F6B258B735F464016F5D1288BC550C018337BE0B05E4640EE717CD305C650C0C82CD035A65F4640081C7CD3A7C650C01804258B4F5D4640B6D2D1283FC750C037D5CE35AE5B4640663E7CD3D3CA50C0CB9679E0E0554640D4C77CD363CB50C03C6B258B73554640C6EE267E80CC50C0C02CD035E65446402411277E0CCD50C0D49679E020544640CA39D228E3CC50C0E8647AE0A85346405CB0D12893CC50C050A3CF3576524640929A277E5CCE50C050A3CF3576524640D755277EE4CE50C0D4777BE0C85246401C837CD3EBCF50C0D048258BE753464047947CD311D050C0D49679E020544640DA55277EC4D050C01417268B2F5446408233277E38D150C034207AE0D05346407AA57CD337D150C09813248BBB52464018837CD38BD050C0C89679E0A05046406ACC267EF4D150C040207AE0D0504640A9B67CD3DDD250C0B47A248BDF5146406E17D228B7D350C0089D248B2B53464016F5D128EBD450C0D49679E02054464016F5D128EBD450C038B6D03516554640008ED128E7D350C068EE7AE058574640924F7CD319D450C010337BE0B0594640BC607CD33FD550C037207AE0D05A4640944F7CD319D750C0446B258B73594640A26BD1283BD650C0F0647AE0A85846406E17D22817D750C0A0A97AE0C0574640DC55277EE4D750C0FCAF258BCB574640F2717CD3A5D850C078DB79E078584640643E7CD353D950C0446B258B735946401A837CD3EBD850C08826258B5B57464002D97CD329D850C08C26258BDB554640D0C77CD3C3D750C01417268B2F544640623E7CD373D850C030B6D03596514640C8EE267E80D750C044207AE050504640623E7CD3B3D750C0D048258BA74F4640061C7CD347D850C0E419CF35864F4640623E7CD373D850C048D2258BD74F4640BE607CD37FD950C02804258B4F4E4640D2C77CD3E3D950C00036248B874D4640663E7CD333DA50C0C0E1248B434C4640DC55277E04DB50C06CBF248BB74E464032EA7CD34FDB50C054D2258BD75146404A947CD3D1DB50C0C09679E060544640D80A7CD341DD50C038B6D03516554640964F7CD3D9DC50C0CF2CD035E652464014F5D128EBDC50C030D5CE35EE5046406ECC267ED4DC50C0F735248B474F46405CB0D128F3DB50C0D0E1248B034E4640663E7CD313DD50C0A8F4258B634D4640A8B67CD33DDE50C0306B258B334D4640A9F97BD35BDF50C028D5CE356E4D4640AAF97BD35BE050C0D0E1248B034E46407017D228F7DF50C058EE7AE0D84F4640A8B67CD35DE050C068EE7AE0185146407217D22817E150C0D3E1248B4351464016F5D128ABE150C048D2258BD74F4640A66BD1281BE250C048D2258BD74F4640C2607CD37FE250C068BF248BB7524640A26BD1287BE350C010337BE070524640BE607CD3FFE550C0B4F4258BE34E46404849D128AFE450C0F0AF258B0B4F46407217D22837E450C00FE8CF350E4E464016F5D1284BE450C0985ECF351E4A46404949D1286FE450C07726258B1B49464032EA7CD3AFE450C0988D258BFF4746402611277ECCE450C05FEE7AE0D8464640DE0A7CD381E450C0888D258BBF45464011F5D1286BE450C0336B258BF3444640A8F97BD3FBE450C0C0E1248B83444640B6D2D128BFE550C0988D258B3F444640ADF97BD33BE650C060A3CF35F6434640B8D2D1289FE650C06CEE7AE0984346402611277E2CE750C0E448258B67434640CC39D228C3E750C0D09679E0604346407E33277E38E850C0E019CF3586434640C6EE267EE0E850C010E8CF350E4446404B947CD3F1E850C0406B258B73444640BE607CD3DFE850C0DC777BE0084546405CB0D128F3E850C03CB6D03516464640949A277EFCE850C0EB19CF35064746405CB0D12833E950C028D5CE352E48464010AA267E88E950C0F019CF35C64846403A78277E30EA50C0D8777BE08848464006D97CD3C9EA50C0A05ECF35DE474640DE0A7CD3C1EB50C0C82CD035264646406ECC267EB4ED50C060EE7AE01840464078A57CD397EE50C0E7647AE068404640B6D2D1285FEF50C05758248B534146401C837CD3EBEF50C044207AE0D0424640C6EE267E20F050C0B47A248BDF444640D6C77CD363EF50C0FCAF258B4B4B4640FE8DD128A7EF50C0C0E1248B434C4640ACF97BD35BF050C078DB79E0784B46402EEA7CD34FF250C064EE7AE058454640DA0A7CD321F250C0F419CF35C64446402EEA7CD34FF250C0E019CF35864346404C947CD391F250C01F04258B0F444640ACF97BD33BF350C0F419CF35464546407D33277EF8F250C088DB79E0F8464640EE717CD345F250C0CB777BE008494640C2607CD3DFF150C07C71D035FE4A46406C17D22817F250C07871D035FE4C46407AA57CD397F250C0D8777BE0C84C46402011277E2CF350C03FD2258B574B4640C0607CD39FF350C0D42CD035A64946402211277E4CF450C080DB79E0B84A4640D2C77CD303F550C0DB777BE0C84A4640603E7CD393F550C0386B258BF3494640D4C77CD323F650C037207AE090464640A6B67CD3DDF650C0D02CD035E6454640A4B67CD39DF750C0386B258BB3454640A8B67CD3FDF750C064EE7AE0584546402EEA7CD3CFF750C058EE7AE0D84346402011277E8CF650C08026258B1B414640B8D2D1283FF650C0C09679E0A03F464018837CD38BF650C0BFE1248BC33D4640D855277E44F750C08C26258B5B3D4640F2717CD325F850C08071D035BE3D4640071C7CD3E7F850C0EF35248B473E4640D2C77CD3A3F850C0D0E1248BC33B46405AB0D12893F950C00036248B07364640A6B67CD3BDF950C040D2258BD73246405EFB7CD3F5FA50C0D048258BA7344640964F7CD319FB50C0DC777BE00838464032EA7CD38FFA50C01017268BAF3B4640A6B67CD3BDF950C0EF35248B473E46404C947CD3B1FA50C0B0F4258BA33D4640DD55277E64FB50C01C337BE0F03B464047947CD3D1FB50C0F019CF35C63946407AA57CD3F7FB50C00817268BAF3746402111277ECCFB50C0F7AF258B4B3546407AA57CD3F7FB50C018E8CF354E344640B6D2D1289FFC50C0F019CF3506354640008ED12807FD50C0C02CD035A6354640C4EE267E60FD50C030207AE010364640B4D2D1289FFD50C0BC7A248B9F3646407017D228B7FD50C00817268BAF3746404849D128EFFD50C060EE7AE0184046405CFB7CD395FE50C0A8F4258BE33F4640071C7CD3E7FE50C09FA97AE0403F4640CE39D22803FF50C0908D258B3F3E4640ED717CD305FF50C038D5CE35EE3C4640061C7CD347FF50C060A3CF35B63B4640D70A7CD3E1FF50C060A3CF35B63B4640CC39D228030151C0CC777BE0883C464078A57CD3D70151C088DB79E0F83B4640D4C77CD3030151C0A413248BBB3A4640ED717CD305FF50C0DC777BE008394640C6EE267E00FF50C0DF48258B673846405CFB7CD355FE50C028D5CE35EE344640028ED12827FE50C03FB6D0359634464078A57CD337FE50C02FD5CE35AE334640DA0A7CD361FE50C064EE7AE098324640F0717CD3A5FE50C0D02CD035A6314640ED717CD305FF50C047D2258B17314640081C7CD3A7FF50C047D2258B17314640AAF97BD3DBFF50C05C58248BD33146406E17D228F7FF50C0C49679E0A032464062FB7CD3550051C040D2258BD73246405EFB7CD3F50051C0CC2CD03566324640A36BD128FB0051C07C71D035FE314640FE8DD128E70051C068EE7AE058314640C2607CD33F0151C070BF248B373046408233277E380351C03B207AE0902B4640BC607CD3DF0351C0E419CF35062A46401A837CD3AB0451C008E8CF354E2B4640D2C77CD3E30451C068BF248BB72C4640603E7CD3B30451C04FD2258B572E4640D6C77CD3430451C070BF248B37304640EE717CD3450551C0F4647AE0A82F46400FAA267EA80551C0D0E1248B432F4640A6B67CD33D0651C0B87A248B5F314640C0607CD3DF0651C00F337BE0303546404C947CD3310751C07F71D0357E38464006D97CD3E90651C050D2258B573B4640C839D228230751C0386B258B733D464014F5D128EB0851C0EF35248B473E464014F5D1282B0951C0CF9679E0A03E4640041C7CD3270951C08726258B5B3F46404A49D1282F0951C0B0A97AE0004046402611277E8C0951C060EE7AE018404640A4B67CD31D0A51C050D2258B973F4640929A277E3C0A51C018337BE0F03E4640A8F97BD33B0A51C020337BE0303E46402211277E6C0A51C05058248B533D464012AA267E680A51C0985ECF359E3C46401A837CD32B0A51C0948D258BBF3B4640B4D2D1281F0A51C0CCE1248B033B464002D97CD3A90A51C064A3CF35B63A4640B9D2D1289F0B51C0D0E1248BC33A4640969A277EFC0B51C0E8647AE0283B4640D80A7CD3210C51C058EE7AE0183C46402011277E2C0C51C00017268BAF3F4640DA55277E640C51C02004258B8F424640362D7CD3ED0C51C05CA3CF35364346401D837CD3EB0D51C060EE7AE01840464048947CD3110E51C0406B258B333E46400A1C7CD3070E51C0189D248B6B3C46406C17D228370E51C01017268BAF3B4640EE717CD3451051C0109D248B2B3F464076A57CD3971051C0D4777BE08840464016F5D1288B1051C0C02CD035A642464030EA7CD3AF1151C0BC7A248B9F42464061FB7CD3D51251C010E8CF358E4346407E33277EB81351C068BF248BB7434640623E7CD3131451C048D2258B57414640DE55277E041251C0089D248BEB3F4640DE55277E441151C070BF248B373E464069CC267E541251C0E8647AE0A83B4640CD39D228031251C084DB79E0383B46402EEA7CD3CF1151C0B0A97AE0C03A4640008ED128A71151C00036248B473A464068CC267E741151C040B6D035D639464012F5D1284B1451C0B0A97AE0C0394640ACF97BD39B1551C0B0A97AE0403A46405AB0D128B31651C0E8647AE0A83B464002D97CD3291751C03C207AE010394640ACF97BD3BB1851C044207AE050364640969A277E7C1851C03FB6D035963446404C947CD3311A51C0F8AF258BCB33464047947CD3111B51C08726258BDB3346404749D1284F1B51C0D848258B6735464078A57CD3171B51C0D0777BE0483C4640D3C77CD3A31B51C0DC777BE0483E46401E837CD3CB1C51C010337BE0303F4640A26BD1289B1E51C0E048258B273F4640382D7CD36D1D51C0C82CD035263B46401D837CD34B1D51C00017268B6F39464012AA267E681D51C018337BE0B0384640BAD2D1289F1D51C0CC2CD03526384640964F7CD3B91D51C030B6D03596374640CD39D228831D51C01704258BCF36464032EA7CD32F1D51C044207AE0503646401A837CD3EB1C51C010E8CF350E364640061C7CD3C71C51C060EE7AE0983546404C947CD3D11C51C03FB6D03596344640DA0A7CD3211D51C028D5CE356E334640B6D2D128BF1D51C0CC2CD035E63146407217D228571E51C0376B258BF3304640A26BD1289B1E51C040207AE090314640924F7CD3991E51C03FB6D03596344640964F7CD3B91E51C06FBF248BF735464014F5D1280B1F51C0C8777BE04837464012AA267E482051C0E7647AE0E834464004D97CD3A92151C0089D248BEB33464002D97CD3292351C01417268BEF334640CE39D228C32451C03FB6D035963446400EAA267E082451C0E019CF35463346401D837CD34B2351C0D0777BE048304640DE0A7CD3C12251C0A05ECF35DE2E46402411277EAC2251C01417268BAF2D464076A57CD3972351C08871D0353E2A4640944F7CD3D92351C0988D258BBF2846405CB0D128932351C010337BE0302746403A78277EF02251C04FA3CF35B626464062FB7CD3352251C09813248B7B26464004D97CD3A92151C0AC13248BBB25464060FB7CD3552151C040D2258BD7234640AAF97BD37B2151C0A8A97AE0802246402011277E0C2251C0D49679E020224640904F7CD3F92251C07826258B1B234640BE607CD39F2251C0AFA97AE0C0214640FC8DD128272251C040207AE0D02046404849D1288F2151C0A85ECF351E204640603E7CD3D32051C0DB777BE0881F4640F2717CD3A52251C0CF9679E0601E464010F5D1288B2851C00C9D248BEB2546404849D128AF2A51C0109D248B2B264640DC0A7CD3C12B51C014337BE0B02546403A78277E102D51C014E8CF350E274640944F7CD3D92E51C0E419CF35062A4640F2717CD3653051C01704258BCF2A46402611277EAC3251C0888D258B7F284640081C7CD3873451C0EC19CF35462846406CCC267EF43351C0A0A97AE0002D4640643E7CD3733351C0D0E1248B432F46401A837CD38B3251C070BF248B3730464030EA7CD3EF3151C01C337BE0F02F464062FB7CD3553151C07871D035BE2E46404C947CD3D13051C088DB79E0782E464060FB7CD3353051C0F8AF258B0B2F4640EE717CD3453051C0AC5ECF355E30464012F5D128AB3051C030B6D035D631464004D97CD3093151C040D2258BD73246406ACC267E343051C03CB6D035D6334640929A277E7C2F51C0F019CF35063546404649D1280F2F51C05058248B13354640BAD2D128BF2D51C0C89679E0E0334640A66BD1281B2D51C060BF248BB7334640DA0A7CD3C12C51C023337BE07034464004D97CD3E92D51C08871D0353E374640924F7CD3F92D51C0DC777BE008394640F2717CD3653051C0D048258B2737464004D97CD3093151C038B6D03556364640653E7CD3333251C013E8CF358E3346404649D128EF3251C08F8D258B3F324640061C7CD3A73351C0E8AF258B0B324640949A277E3C3451C068BF248B77334640B6D2D1281F3451C0B0A97AE08035464004D97CD3A93351C030207AE0903746407E33277E383351C0DC777BE008394640A46BD128FB3251C0F0647AE06839464076A57CD3373251C04BD2258B173A4640B8D2D128DF3151C064A3CF35B63A46406ECC267EB43151C0C8E1248B833B46408233277E983151C068BF248B773D46407E33277E783151C0EF35248B473E4640FE8DD128872F51C0F419CF35C6444640DE0A7CD3C12F51C0EB19CF3506474640B8D2D128DF3151C0BF2CD035E64746404649D128EF3251C0FF16268BEF474640382D7CD34D3351C073BF248BB7474640061C7CD3A73351C0D02CD035664446407AA57CD3F73451C05058248B533D46404E947CD3913451C08071D0353E3D4640061C7CD3A73351C0CC777BE0883C4640081C7CD3C73451C0CCE1248B033B46407E33277E183651C03CB6D035163A4640A26BD128DB3651C0C09679E0603A4640061C7CD3473651C0CC777BE0883C46407017D228373751C06CEE7AE0D83C46401C837CD34B3851C088DB79E0F83B4640D2C77CD3033A51C00017268B6F39464076A57CD3D73A51C0908D258B7F38464004D97CD3C93D51C0C8777BE048374640D755277E243F51C0F4647AE0E8354640A7B67CD3DD3E51C023337BE0F0344640663E7CD3333E51C024337BE0F0334640071C7CD3673E51C017337BE070324640DC0A7CD3413E51C0D09679E020314640623E7CD3733C51C0C82CD035A62C4640C0607CD3FF3B51C08071D0357E2A4640D6C77CD3833C51C060EE7AE098284640653E7CD3B33D51C0C82CD03566274640D4C77CD3033F51C008E8CF358E2646404649D128EF3F51C0AC13248BBB254640DC0A7CD3614151C068BF248BB71F46404C947CD3514251C0E819CF35C61D4640382D7CD36D4351C0149D248BAB1746408233277E584451C060EE7AE058144640944F7CD3F94451C01CE8CF358E124640FE8DD128A74551C080DB79E078114640FE8DD128A74551C037D5CE35AE1046403A2D7CD34D4551C0ACA97AE0C00E4640A46BD128BB4551C008E8CF358E0C464032EA7CD38F4551C057EE7AE0180B4640382D7CD36D4351C038D5CE356E0B46401F11277E2C4451C0D848258BA7084640924F7CD3D94451C078DB79E0B8064640A06BD128DB4551C08826258B9B054640944F7CD3994751C09813248B3B054640653E7CD3134851C080DB79E0F8034640949A277E5C4851C0B0A97AE0800146406D17D228174951C030B6D035D6FF4540F0717CD3E54A51C0386B258BF3004640B6D2D128FF4A51C0B0F4258BA3FF4540DC0A7CD3414B51C0C02CD035E6FE4540362D7CD3AD4B51C080DB79E0B8FE4540C2607CD33F4C51C0985ECF351EFF4540F0717CD3C54C51C034D5CE35AEFD454010AA267E084D51C0436B258B33FC4540061C7CD3E74C51C0C09679E0E0FA4540C2607CD33F4C51C0D09679E0E0F94540081C7CD3874E51C05CA3CF35B6F74540D6C77CD3434F51C0A8A97AE040F74540CE39D228835051C0D8777BE0C8F64540AAF97BD3DB5051C00036248B07F74540AAB67CD39D5051C0F419CF3546FA45401A837CD3AB4E51C06BEE7AE0D8FE454018837CD30B4E51C03FB6D03516014640D6C77CD3434F51C0386B258BF3004640C6EE267E205351C0CC2CD035A6F94540BE607CD3DF5351C0F035248B87F845406ECC267E145451C0DC48258B27FA4540FE8DD128675351C058EE7AE098FD454076A57CD3175451C08371D0353EFE4540C839D228035551C0BC7A248BDFFD4540949A277E9C5651C088DB79E078FC4540F0717CD3A55751C09C8D258B7FFC4540AAF97BD39B5651C030207AE050FF454078A57CD3375651C07871D035FE004640D6C77CD3835651C08C71D035BE014640D955277EA45751C00036248B070246403878277EB05751C0ABA97AE0C0024640D6C77CD3835651C008E8CF35CE044640964F7CD3395651C08F8D258B7F06464012F5D128AB5651C07771D035BE0746403478277E505751C0888D258BBF074640F0717CD3A55751C067BF248BB7054640904F7CD3195851C03C6B258BB3044640F2717CD3055951C033B6D03516044640AAB67CD3BD5951C0D848258B67034640EF717CD3455951C02C04258B4F00464076A57CD3175A51C0E019CF3546FF4540018ED128275B51C038D5CE35EEFE454016F5D1288B5B51C0985ECF351EFF454078A57CD3375C51C0985ECF359EFD454010AA267EA85C51C05FEE7AE0D8FB4540D855277EA45E51C028D5CE35AEF04540BE607CD39F5F51C01F337BE0F0EC4540663E7CD3D36051C0985ECF35DEEA454014F5D128EB6051C0E019CF3586ED4540CC39D228636151C0D448258B67EF454002D97CD3E96151C0E819CF3506F145402111277E2C6251C0ACF4258BE3F245405CB0D128936251C0ACF4258BE3F2454010AA267EE86251C02804258B0FF145401C837CD30B6351C03CB6D03516EF45402411277E0C6351C0985ECF35DEEA454018837CD3EB6351C00817268BAFEC45404D947CD3716351C0ACF4258BA3ED45401D837CD36B6451C0D848258B27EF4540CC39D228836451C0B07A248B5FF0454030EA7CD32F6451C0CC777BE088F1454018837CD3EB6351C0ACF4258BE3F24540623E7CD3D36351C08CDB79E0B8F34540D4C77CD3836351C087DB79E038F545404D947CD3716351C09B5ECF35DEF5454062FB7CD3956351C08871D035BEF645404649D1282F6451C034B6D03596F745404A947CD3516451C0F035248B87F84540DC55277EC46351C060BF248B77FB4540ACF97BD3DB6151C01804258B8F0046402111277E2C6251C010337BE0B0024640BAD2D128DF6251C00036248B870146405EFB7CD3756351C03C207AE0D0FF45404A947CD3516451C09C8D258B7FFC4540061C7CD3276551C0908D258B7FFA4540AAB67CD37D6551C0E048258B67F9454006D97CD3696551C0F035248B87F84540949A277E3C6551C0BC7A248B9FF74540D6C77CD3636551C0888D258B7FF645406B17D228B76551C0089D248B6BF545403878277E106651C0C09679E0A0F4454074A57CD3B76551C03C207AE0D0F34540964F7CD3996551C068EE7AE0D8F245406B17D228B76551C0BB7A248BDFF145403878277E106651C017E8CF350EF14540362D7CD36D6551C0306B258B73EF4540949A277EFC6451C0E019CF3586ED4540A8B67CD3DD6451C0B4F4258B63EB45404C947CD3316551C010337BE030E9454004D97CD3E96551C0ACF4258B63E74540FE8DD128276651C00817268B6FE845403878277E106651C00817268BAFEC454010AA267E086751C06FBF248B77EB45407017D228F76751C044207AE050EB454030EA7CD3EF6851C03FD2258B17EC454014F5D1280B6A51C0ACF4258BA3ED45404A49D128CF6A51C0A813248BFBEE4540C839D228E36A51C033207AE0D0EF45402BEA7CD38F6951C0ACF4258BE3F2454079A57CD3D76951C030B6D035D6F3454018837CD3EB6951C0E8AF258B8BF445404A947CD3D16951C0EC19CF3546F545402BEA7CD38F6951C018E8CF354EF64540AAB67CD31D6951C0089D248BEBF54540FE8DD128476851C0FC647AE0A8F54540ACF97BD3DB6751C028D5CE356EF54540F2717CD3656851C020337BE0F0F64540DA0A7CD3216951C09F13248B7BF74540DC55277EC46951C01B337BE030F8454014F5D1280B6A51C0F419CF3546FA454062FB7CD3D56951C0B07A248BDFFB4540A66BD128BB6851C078DB79E078004640643E7CD3536851C00436248B07014640C4EE267EA06751C08C71D0353E024640A6B67CD35D6751C038207AE05003464016F5D1284B6851C08471D0357E03464002D97CD3296951C00017268BAF0246401B837CD30B6A51C030D5CE352E014640A56BD128FB6F51C0DC777BE048F345407217D228977051C05CA3CF3576F1454018837CD32B7051C0F835248B87F04540CAEE267E606F51C0A813248BFBEF45407C33277ED86E51C014E8CF354EEF4540623E7CD3B36E51C02C04258B8FED4540D2C77CD3E36E51C0C8E1248BC3EB4540CE39D228C36F51C08071D0353EE845407C33277E186F51C0D4777BE008E94540A8F97BD33B6E51C02004258B0FEC4540663E7CD3936D51C00817268BAFEC4540944F7CD3196D51C0F835248BC7EB4540D2C77CD3436D51C058EE7AE0D8E94540DE55277EC46E51C034207AE050E34540382D7CD3AD6F51C0B87A248B1FE14540CC39D228837051C068BF248B37E145405AB0D128137151C030207AE0D0E4454002D97CD3097151C08071D035BEE54540B8D2D128DF7051C0C0E1248B43E645404649D128AF7051C08426258B9BE645407AA57CD3977051C068BF248BF7E64540ACF97BD3BB7051C0C89679E0E0E7454012F5D1280B7151C0CF2CD03526E84540A06BD1285B7151C0CF2CD03526E84540DA0A7CD3817151C08071D0353EE845404C947CD3F17151C00017268B6FEE4540FE8DD128277251C014E8CF35CEEF4540A66BD1289B7251C0988D258B7FF145404D947CD3D17251C0ACF4258BE3F24540EE717CD3E57251C0C8777BE088F44540B6D2D128DF7251C0D4777BE008F645402411277EEC7251C09F13248B7BF74540D80A7CD3417351C00F9D248BEBF845400C67277E6A7351C0BBC5CF3582FB45400C67277EAA7351C043D2258BD7FD4540C0607CD37F7351C020B979E0ACFF4540765AD128557351C04CD2258BD7014640705AD128957251C028B979E0AC034640C2607CD3FF7151C028B979E0AC044640725AD128557151C054D2258BD70546400E67277E2A7151C054D2258BD70646400E67277E2A7151C0B0C5CF3582074640725AD128957151C018B979E0AC074640705AD128157251C050D2258B57074640C2607CD37F7251C054D2258B570646400C67277E2A7351C028B979E0AC054640745AD128557451C028B979E0AC044640745AD128157651C04CD2258B57014640725AD128557751C020B979E0ACFF4540C2607CD3FF7751C040D2258B57FE4540C2607CD37F7851C0B8C5CF3502FD4540C2607CD37F7851C050D2258B57FB4540725AD128D57751C018B979E0ACFA45400867277EAA7651C018B979E0ACFA4540745AD128D57551C018B979E0ACFB4540BE607CD33F7551C018B979E0ACFC4540745AD128D57451C018B979E02CFC4540745AD128957451C0B0C5CF3502FB45400A67277E2A7451C0C0C5CF3582F7454076A57CD3577351C0C72CD03526EE4540D80A7CD3417351C0B07A248B9FE945404449D128AF7251C0948D258B3FE5454068CC267E147251C00017268BEFE245404C947CD3F17151C078DB79E0B8E14540CD39D228637251C0E348258B67DE4540964F7CD3997251C038B6D035D6DD4540FC8DD128677351C0C82CD03566DD4540949A277E1C7451C02804258B4FDC454002D97CD3A97451C0B87A248BDFDA4540C8EE267E007551C0CC9679E060D945407017D228B77551C0DC777BE0C8DA4540CAEE267EE07551C0A8A97AE0C0DE45400CAA267E887651C05058248B93DF4540081C7CD3E77651C0FCAF258B8BE0454030EA7CD3EF7651C0E8647AE0A8E24540C6EE267EC07651C0985ECF359EE54540D3C77CD3837651C0A8A97AE080E645405EFB7CD3357651C0C89679E0E0E64540663E7CD3F37551C0CC2CD03566E745407217D228D77551C050A3CF35B6E845403A2D7CD30D7651C05858248BD3E94540D4C77CD3037751C05058248B13EB4540A36BD1283B7751C0A8A97AE040EC45403A2D7CD30D7751C067EE7AE098ED45401C837CD3CB7651C060EE7AE058EE4540A26BD128DB7651C02404258BCFEE4540C0607CD39F7751C014E8CF354EEF4540F2717CD3457851C03CD5CE356EEF4540A6B67CD3DD7851C0C82CD03526EF4540EC717CD3657951C0D7777BE088EE4540944F7CD3D97951C0ACF4258BA3ED45404E947CD3117951C07FDB79E0F8EC4540061C7CD3677851C0D0777BE008EC4540F2717CD3057851C0D0777BE088EA45403A78277E107851C08071D0353EE84540CA39D228837851C078DB79E078E64540D2C77CD3437951C0CC777BE008E5454062FB7CD3F57951C0EF19CF35C6E44540C0607CD33F7A51C040207AE090E64540B8D2D128DF7C51C06058248B53E145405AB0D128537D51C01804258BCFE04540028ED128C77D51C03FD2258B97E04540C0607CD31F7E51C018337BE030E04540AEF97BD35B7E51C05058248B13DE4540BE607CD39F7E51C0985ECF355EDD4540071C7CD3077F51C084DB79E0F8DC4540081C7CD3877F51C0D49679E0E0DC45400EAA267E487B51C010E8CF350EEA45402EEA7CD38F7B51C00817268BAFEC45401C837CD34B7C51C05CA3CF35B6EB454062FB7CD3557D51C010337BE030E94540DA0A7CD3417E51C030B6D03556E64540061C7CD3A77E51C060EE7AE058E445400EAA267EE87E51C09813248B3BE245406DCC267E947F51C09813248B3BE045404E947CD3918051C0CF9679E0E0DE4540DE0A7CD3C18151C05CA3CF35B6DE4540A46BD1289B8051C0E8647AE028E24540A8F97BD39B7D51C050D2258B17E94540B8D2D128DF7C51C00817268BAFEC4540028ED128477E51C030D5CE356EEC454012AA267E688051C0985ECF35DEE94540061C7CD3478151C02F207AE010EA45404A947CD3B18051C0F8647AE0A8EA45400FF5D1280B8051C0CC9679E0A0EB45407AA57CD3777F51C0F0647AE0E8EC454078A57CD3177F51C00017268B6FEE454062FB7CD3F57F51C0F419CF3546EE4540C7EE267EC08051C0E019CF3586ED4540382D7CD36D8151C01F337BE070EC45400EAA267E888251C0988D258B3FEA4540653E7CD3338351C074BF248B77E94540028ED128C78451C08071D0353EE84540DC0A7CD3A18551C03C207AE0D0E745406ECC267E548651C0109D248BABE745407017D228F78651C0BFE1248B43E745401A837CD34B8A51C0A85ECF351EE245402EEA7CD3AF8B51C0E048258BE7E04540A46BD1285B8D51C008E8CF358EDB45403A2D7CD34D8F51C07826258B9BD94540CC39D228438F51C01C337BE0F0D7454060FB7CD3F58E51C0C82CD03526D64540AAB67CD3DD8E51C0C0E1248B03D545402411277E8C8F51C0386B258BB3D34540362D7CD36D9051C068BF248B37D34540AEF97BD35B9251C0C8E1248B43D34540AEF97BD35B9251C01C04258B4FD24540B3D2D1287F9051C0A013248BFBD145404B947CD3D18E51C0AC5ECF351ED24540B7D2D1287F8D51C0D8777BE048D14540392D7CD3AD8C51C0F419CF3506CE454032EA7CD3AF8C51C0D09679E0A0CC4540AAF97BD3FB8C51C0D848258BA7C84540A4B67CD31D8D51C05F58248BD3C745407C33277E188E51C02B04258B8FC74540ACF97BD3BB8F51C0A87A248B5FC64540FE8DD128A79051C04F58248B13C64540C8EE267E609051C05FA3CF35F6C645402611277E2C9051C05F58248BD3C74540C6EE267E609151C0C8777BE048C74540924F7CD3B99251C0089D248B6BC4454060FB7CD3B59351C0446B258B73C34540BC607CD3DF9351C01C337BE030C64540633E7CD3D39451C047D2258B57C64540BD607CD3FF9551C010E8CF350EC5454032EA7CD3CF9651C0446B258B73C34540CA39D228839751C02FD5CE35AEC04540924F7CD3B99751C0B0A97AE040BE4540603E7CD3939751C008E8CF35CEBB45406BCC267E349751C070BF248BF7B845406E17D228F79551C0C02CD03526BA45402411277E4C9551C030207AE090BA45405CFB7CD3959451C067BF248BB7BA45405CFB7CD3959451C0149D248BEBB945406DCC267E749551C0A8A97AE040B94540663E7CD3339651C0978D258B3FB845405CB0D128739751C0A85ECF35DEB54540EE717CD3A59751C00417268B2FB54540061C7CD3E79751C01C337BE070B3454068CC267E149851C06CEE7AE0D8B24540924F7CD3799851C0BF2CD03566B2454010AA267E489951C0B0A97AE040B24540643E7CD3D39951C0BF2CD035E6B145401C837CD30B9B51C07871D0353EB04540CC39D228039C51C060A3CF3576AE454060FB7CD3159D51C0D09679E0E0AC4540CE39D228A39E51C07826258BDBAB45404649D1288FA051C050A3CF35B6AB4540BE607CD33FA151C064A3CF3576AB4540663E7CD3F3A151C074BF248B77AA45405CFB7CD3F5A351C0CC777BE088A64540D2C77CD383A451C050877AE034A64540924F7CD339A551C00717268B2FA345404E947CD351A551C09C427AE01CA04540FC4AD22869A451C02804258B4F9D4540944F7CD359A551C0D8B2CE35629B45404A947CD331A651C0D8FD79E004994540F74AD22849A551C0B8107BE024984540AC44277E5EA651C06058248B53974540FAFF267E26A751C0BC107BE024964540D80A7CD361A851C05858248BD3924540C2607CD33FAA51C008CC7AE00C8C4540D27CD12801AB51C040877AE0F48A4540924F7CD3F9AB51C0F3AF258BCB8B45404C947CD3D1AC51C0DBB2CE35E28D45409E28D228BDAD51C08426258B9B8F454030EA7CD3EFAE51C00881CF356A8F4540329FD128CDAE51C020B979E0AC8E4540C4AB277E82AF51C0C0C5CF35428B4540EE96D1289FAF51C02F5FCF35BA8A454092012D8067B151C06FDD17EFC08D454092B4FA4C9CB351C0CC967D557F9145400CE861B3CEB451C04067B088AA944540DAC32E80DBB451C0A03C4C2270954540A8A960B3C6B451C0F8CF17EFDC964540765094E621B451C010174B22BC9A454066BCFA4C0CB451C08F96B188BE9B45404AB994E611B451C068D34A22E09C45403E2E61B34AB451C0B71518EFB49E4540821061B39AB451C0B8304A22A09F4540883C94E6FDB451C008EF7D554BA045400DD82D8077B751C01838E5BBB1A245408A63FB4C70B951C02CBC16EF04A74540FEDEC61981BB51C0686E18EF8CAB4540CAB4FA4C7CBD51C06701E4BBEDAE4540D6AAFA4CEABD51C030AAE3BBF9AF4540465A2D803FBE51C0F864E5BB09B14540B96961B384BE51C08CB07D557FB24540AE1261B396BE51C0F0CA7C557BB34540A89893E693BE51C0181CE4BB5DB4454090932D807DBE51C078DF7D551FB545407225FB4CDCBD51C05CAA17EF44B845407E002E80ABBD51C0F8D87F55AFB94540BE82C719BFBD51C0E035B188D2BB4540316F2E80EFBD51C078304B22B0BD4540AC2DC719EDBD51C0A849E4BBCDBE45407225FB4CDCBD51C0E8777E559BBF4540F070C719BDBD51C000DDAF883AC045402893FA4C94BD51C0433DE4BB0DC24540B6452E8097BD51C0D0D77C55FBC345401C69C7194DBD51C01418B188F6C74540BA7961B370BD51C0F488B088CECB4540A2CD60B3B0BD51C0D0724A22A8D2454039E0FA4CF0BD51C0BCCDB08882D945405A9CC71931BE51C087467E555BE045403A7FFA4C70BE51C0484E7F5533E7454052CAFA4CB0BE51C0D0BAE3BB0DEE4540F24D61B3F0BE51C0A033B188E6F445408A60FB4C30BF51C060AC7E55BFFB454072B4FA4C70BF51C05C78B1889A0246409870C719B1BF51C037D317EF74094640AA4AFB4CF0BF51C0F8DA18EF4C104640929EFA4C30C051C080D6B08826174640322261B370C051C0503117EF001E4640C234FB4CB0C051C0488C7D55DB244640AA88FA4CF0C051C007054B22B42B4640CAD3FA4C30C151C0D87D18EF8C324640E21EFB4C70C151C0C067B28866394640CA72FA4CB0C151C0A0C218EF40404640E2BDFA4CF0C151C00C4DE4BB194746400209FB4C30C251C0E7367E55F34D46401A54FB4C70C251C0B82018EFCC54464002A8FA4CB0C251C0A00AB288A65B46401AF3FA4CF0C251C070F44B22806246403A3EFB4C30C351C0ECEFE3BB596946401A92FA4C70C351C0C84A4A22347046403ADDFA4CB0C351C0B4A5B0880E774640D1EF94E6EFC351C080ADB188E67D46403A7CFA4C30C451C044267F55BF844640D28E94E66FC451C03781E5BB998B46407212FB4CB0C451C018DC4B22749246408A5DFB4CF0C451C0846617EF4C99464072B1FA4C30C551C0506E18EF24A04640586059DA6FC551C0A44A270FF3A6464008B3A8061CC451C0CC84EC914DA74640BA512A957BC351C044DC7DF1B9A74640C2F7AFC058C251C00FEACFA964A94640EC82A429C4C151C0B7585BCFD5AA46403CACDBF90EC151C040AD4384EBAB46409A76FEDB8FBF51C078CA299C85AC4640BE4E3BA6F5BD51C0344D963C19AC4640D212AC23E7BC51C07BA234737FAA46405622CEC50ABA51C0FCD94484849F46405AC55D481DB951C038464384079E4640701A685FF5B751C0103FD9E3719F4640324345FDB7B751C024EF9AD9ACA046407E5A86E4D6B751C000D3299C18A3464086430B10B2B751C09007838E3DA446403CE0E82D35B751C048FA929F2AA546404A3797B5E9B551C02C0C2D398EA64640609B8CDE74B551C0A01B1051A7A746404CB7A1CC40B551C068C124FF0DAA4640E08E8A4178B551C0586466A6C1AF4640E90605965DB551C0384651F850B24640CA5885E4DCB451C0E87115EE89B4464014BCBCF407B451C09BFCE7F432B646406A620833DFB251C0A4D0808E17B74640EE70C36E66B151C000F70EB40BB74640B43D82C729B051C05C248E650FB646400EC15DC8F3AD51C027004721DAB24640D4C71C6197AC51C05893E657BFB14640AC0C560E40AB51C0C0F06309C1B146405646A569D4A951C0880303DD9EB2464016964F540BA951C06011559549B4464061307CCD9DA951C080786309B7B6464042BC342CC3AA51C00489E55732B8464020F0ECCA45AD51C0F08EA74D6BBA46406E842DF242AE51C0601D492147BC4640B056B63AD9AE51C088A09E76ECBE4640082072B6BDAE51C05863FF3F05C1464082476165F4AB51C068A925FF4EC946405ED1443DBCA551C090BCF3CB6DD346405100A24CA2A451C050A9178BC5D44640A2B7596BF1A051C067F0963C42D746401C5C485A069F51C0F8B6C6D28DD94640CEFC6D59429E51C0385245840EDA464036AD1FBED39C51C010B6C19813DA46408A9EFABE1A9C51C0488C77B75ADA4640F6A3A10CD69A51C03FDC8B65C3DB4640B444C70B129A51C0404B2A9CA2DD46405E68D89CC19951C058AD51F8F4DF4640BE157F2ADA9951C0B80F8C65B5E24640A8243849219A51C05022B2240DE4464052C83EC3799A51C0245C6B43D3E4464055FDA4E9B29A51C073F3A1139BE546405037A529939A51C0C8C0C235F6E64640F4031D613C9A51C0989C727DC6E7464074B8489AF29851C0F043188B9BE9464064308387029451C0588699D90EEF4640379C89811F9251C07805A74DFBF1464000323E43CD9051C05015731A26F64640FE1E0B50619051C094951FC574F9464004C1336CD79051C0F886178B79FA4640C6D0F7A1F29151C0E024C6D2CAFA464018CEB2DD739351C0D058939FFBFB46406E8426383E9451C06783B85ED2FD464014BCBCF4479451C0986CA74DDFFF464076236ED9979351C098D977B785044740267D37C96E9351C0F8F28E02ED044740D58B71F6D59251C060AF3BADC005474026C63749B09251C06489C0983A06474036ACC6CBC09251C0FC210FB4EA064740D232342CF39251C0A0DC900268074740862E2638409351C0BBF48F02E7074740C03DA569819351C0EC3105DD71084740BC50D85CED9351C0D80742E73209474006D9231B029451C097DAC2352F0A47406AD16E99389351C0F890838E6D0B4740AAA0DE96EC9051C08039C8D2A40D4740B0D3B57AF78F51C0B86479B76F0F4740F22991BB9D8F51C078A355950C124740B49B59ABF38F51C0A424077AD5144740464AD162DA9051C03F0C65097417474026240F2D3A9251C01079C5D28E184740E22DAF40FA9151C00C5BB0241E1B4740562175D3379051C0F86A16EE3020474010E671761D8F51C06815D546E82447400A6820FE508E51C0B862B95E80264740E2E507B3EB8C51C0185A9D761A2747403A07AFC0C48C51C0F86DDB805A28474046B8D71C9C8C51C008B112511E2B4740F06E26B80E8C51C0E870CA6FE02D47406C5C00F9B68A51C0C884087A202F47401EC76D99CB8951C0F4F86CE0B82F4740B478E2B3C18451C0D89766A6B335474058A331CFF48351C014A1CF29033947402A69B29D348351C0ACB91251714147403466D122188251C060C85BCF0C4E4740E6AC671F838151C018653810A554474054572D327F8051C0F042B1241F5A4740C13BF3845B7F51C0508DEC91605C4740AAA6E6D0947951C07409D346E1674740352A1844CD7351C0F81B00C05D73474084D34BB7056E51C0F08BAAEADB7E4740D87C7F2A3E6851C0C7EF188B578A4740E8BB5231766251C0770E828ED69547403C6586A4AE5C51C00021AF0753A1474042BD78F0E75651C0EC905932D1AC4740ECBD0BD0205151C000CFC5D24CB847405AA17FEA0E5051C01C60973CF9B947405E0B61652F4F51C02036D446BABA47401C965DC8344E51C098983810D7BA4740D4E78F3B754451C090DDCD0C48B7474020DDB21D754351C0C8EF0A178EB54740361B2D327A4351C00018CD0CD3B14740141D8A813C4451C01BCFFDA232AA474088623A262B4451C0633DCA6FEEA54740DCBD055D114451C02F5AEF3C39A54740C8BAB9D7AD4351C0504241E77DA24740E6BDF6A1924251C0E8DD6209E19F4740,-3.3%,-5,146,21,125,Maine,true
26,0106000020E610000006000000010300000001000000060000005EFB7CD3553C56C057BD9E6BBC363E40FE4AD228093E56C0B8469F6BEC353E40FA4AD228E93D56C070AA9D6BDC363E4062FB7CD3353C56C0B8A44B16AF373E40DE0A7CD3613B56C0F714A06BB4373E405EFB7CD3553C56C057BD9E6BBC363E4001030000000100000006000000904F7CD3591B56C068AA9D6B5C373E4001D97CD3C91B56C01FD09F6B9C353E402EEA7CD30F1E56C0F0AAF6C0F9353E404E947CD3312056C068AA9D6B5C373E404E947CD3312056C08021F6C049393E40904F7CD3591B56C068AA9D6B5C373E40010300000001000000070000004606D228313956C0F0C9F4C0D13A3E40E4E3D128C53956C0A059A06B4C3A3E40BE607CD33F3956C01898F5C0993C3E40F8FF267EE63856C0D9339E6B8C3D3E40028ED128273856C02066F6C0613E3E4074A57CD3173856C060AA9D6B5C3D3E404606D228313956C0F0C9F4C0D13A3E4001030000000100000018000000F2717CD3254456C037D09F6B9C3C3E40A228D2285D4456C0B7914A16CF393E400A67277E6A4556C051084A161F323E40964F7CD3B94556C0F0019F6B54323E4018837CD3EB4556C00898F5C099323E408AC1D128194656C0D027A16B14333E40725AD128554656C0B9FBF3C009343E4049947CD3114656C09F659D6BC4343E409EDD267EBA4556C0C1659D6B44363E400A67277E6A4556C068AA9D6B5C373E40F0717CD3E54556C08021F6C049393E40725AD128554656C068AA9D6B5C373E40FE4AD228E94656C09F789E6B243A3E40EAE3D128C54756C0EF97F5C0193B3E40663E7CD3D34956C06FAA9D6BDC3A3E40663E7CD3D34956C037D09F6B9C3C3E40ACF97BD37B4656C0876CA16B2C3C3E40382D7CD3ED4456C090789E6BA43D3E40F2717CD3254456C0281B4B16FF413E4060FB7CD3B54356C0281B4B16FF413E403A2D7CD3AD4356C08FA44B16AF403E40061C7CD3074456C0E77E4916EF3F3E404A947CD3314456C01F85F4C0393F3E40F2717CD3254456C037D09F6B9C3C3E400103000000010000000C00000089C1D128F92256C09F0EF5C069383E40934F7CD3992356C008E3A06B7C373E40041C7CD3673056C0778B9F6B843E3E40041C7CD3673056C027D09F6B1C403E40382D7CD3CD2E56C04872F3C0D9413E40F84AD228A92C56C0808B9F6B04423E405622277E922A56C02FD09F6B9C403E40051C7CD3272956C0F86B48168F3D3E40DA0A7CD3C12756C0C0659D6B443B3E404E947CD3D12356C0896CA16B2C3B3E402C9FD1286D2256C020EF9D6B74393E4089C1D128F92256C09F0EF5C069383E40010300000001000000BA01000070B92E80AF1656C0E021B188BE7F4140564B94E65D0E56C0B82D16EFB87F4140CC4594E6150C56C0B82D16EFB87F41403C8194E6750B56C0B82D16EFB87F4140C2FF2D80570A56C028E1E4BB8D7A4140B44F61B3CA0856C058154A22DC764140523C61B3B80656C070C07D557B744140CA13FB4CA40556C054757D553B744140993FC719B90556C0002FB0882E724140089FFA4C060656C020664A22906D41408A8060B3180656C0A4A5AF887A6C414062A2C7194F0656C0E8104B224C69414010BAC719A50656C0505216EF2C644140088FFA4C1A0756C0F0A47D553F5D4140B49594E6AB0756C034FBB188A654414052952D80570856C0ACB8B088864A41404202FA4C1A0956C01C9BB088023F41406E8994E6F10956C0501218EF3C3241409E2AFB4CDC0A56C0EBF2B0885A244140FAD32D80D70B56C0A06B7E557F1541407A32C719E10C56C014E07D55CF05414039C3FA4CF60D56C0F04E49226CF54040B44461B3140F56C034C97C557BE44040A8DD60B33A1056C048D07C551FD34040EFC9C719651156C0E4924C227CC140404898C719911256C0583817EFB4AF4040DECE94E6BD1356C03C3DB088EE9D4040AEF361B3E81456C0E8E118EF4C8C40401A54FB4C0E1656C0FCE818EFF07A4040EA16C7192D1756C0C0037E55FF694040246F94E6411856C010D217EF9C594040945C61B34A1956C070647E55EB494040783EFA4C461A56C038BFE4BB113B4040600FC819311B56C0408E7F552F2D40405E102E80091C56C01417E5BB69204040527DFA4CCC1C56C0946AB188E6144040A23B2E80771D56C0FC4517EFC40A40404E42C819091E56C0D01E16EF2C024040CC4F61B37E1E56C0A81EC9777BF63F40FC9FC719D51E56C05760FCAA3EEC3F400E21FB4C0A1F56C037DDFDAAE6E53F404632C8191D1F56C017B6FDAAB6E33F406623C719C71E56C07F309544B0CB3F4038D360B3701E56C0DF69C977ABB33F4088BB60B31A1E56C048202FDEA19B3F4098D3C719C51D56C06F77CA779B833F4070F42D806F1D56C0EFB0FEAA966B3F40C2DC2D80191D56C0788A60118D533F40928CC719C31C56C0A0E1FBAA863B3F40EA74C7196D1C56C0211B30DE81233F403C5DC719171C56C0309032DE790B3F400B0D61B3C01B56C0072EC67773F33E4064662D806B1B56C0378561116DDB3E406C0DC819151B56C060FA631165C33E40442E2E80BF1A56C0C051FFAA5EAB3E401E4F94E6691A56C049AE2FDE59933E40EEFE2D80131A56C0A8649544507B3E40C61F94E6BD1956C0EF9DC9774B633E4022F941DDBD1956C038FD52DA48633E402C9FD128CD1956C02F85F4C039633E404A947CD3111A56C0409EA06BE4613E40E4E3D128051A56C0DF7E4916EF5E3E40715AD128151A56C007E3A06BFC5B3E406689277EB61A56C08F789E6BA45A3E40382D7CD38D1B56C020D09F6B1C5A3E40643E7CD3F31B56C038BD9E6BBC583E4074A57CD3371C56C0E77E4916EF563E40FC4AD228A91C56C0AF27A16B14553E40A4B67CD31D1E56C0900EF5C0E9523E406889277E361F56C0E0AAF6C079543E40F7FF267E662056C060F548163F573E40C0607CD31F2256C038BD9E6BBC583E40633E7CD3F32256C0C7659D6BC4583E40A8B67CD3BD2356C0DF14A06B34593E405EFB7CD3552456C06F8B9F6B845A3E40D07CD128C12456C09F0EF5C0E95F3E409ADD267E9A2556C0F014A06B34623E406489277ED62556C050084A161F653E404406D228512656C050084A161F653E40ACF97BD37B2756C0C1914A16CF5E3E40DC0A7CD3612A56C0C7659D6BC45A3E401C837CD38B2D56C0706CA16BAC593E40AAB67CD37D2F56C08F789E6BA45A3E40C4AB277E223656C0A8A44B162F6C3E40AE44277E5E3B56C0DF14A06B34713E401C837CD3EB3C56C0AFA44B16AF6E3E40643E7CD3D33D56C09759A06BCC6D3E40AAB67CD3DD3E56C0EF14A06BB46D3E40AAB67CD3DD3E56C00FD09F6B1C6C3E40C0607CD3FF3656C0E7AAF6C079683E404C947CD3113856C0786CA16B2C653E4042BB267E0E3A56C0006C48168F643E40A8B67CD3FD3D56C050084A161F653E40B144277EDE3E56C0D027A16B14643E40A7F97BD3DB4056C030084A169F603E40924F7CD3B94156C0609EA06BE45F3E40FFD87CD3C94256C0AF469F6B6C5F3E4078A57CD3574756C0DF14A06B345A3E40C2AB277E624B56C0FF019F6B54563E40BE607CD35F4F56C011D09F6B1C523E4088C1D128395056C058BD9E6BBC513E4074A57CD3575156C097789E6BA4523E40AE44277E7E5156C0B0A44B16AF543E40623E7CD3F35056C0C0FBF3C009573E40AAF97BD3FB4F56C038BD9E6BBC583E40FAFF267E265156C0E07E4916EF5A3E405EFB7CD3355356C04F9EA06B64603E4077A57CD3975456C0D0AAF6C079613E40B144277E3E5556C0E7339E6B8C603E40663E7CD3135656C0102E4C165F5E3E40725AD128B55656C0A859A06BCC5B3E40DE0A7CD3C15656C08FA44B16AF593E40924F7CD3395656C028EF9D6BF4583E405CFB7CD3B55456C098A44B16AF583E40E6E3D128655456C050AA9D6BDC573E40BE607CD35F5456C0CF7E4916EF523E40D2C77CD3835456C0589EA06BE44F3E40C5AB277E225556C0BFFBF3C0894D3E405322277EF25A56C0281B4B16FF413E40ACF97BD37B5A56C090789E6BA43E3E40DA0A7CD3C15A56C0CF7E4916EF3B3E405622277ED25B56C068AA9D6B5C373E40E8E3D128055C56C0806CA16BAC343E404E947CD3115C56C0808B9F6B84323E405622277E525C56C0C727A16B94303E40DA0A7CD3215D56C0D7AAF6C0792E3E404C947CD3915D56C0102E4C165F303E40A8F97BD33B5D56C019029F6BD4313E40FA4AD228695D56C0D0AAF6C079323E4078A57CD3F75D56C0B9FBF3C009343E40E6E3D128855E56C00F1B4B167F313E40352D7CD36D5F56C09059A06B4C303E40D07CD128616056C0111B4B167F303E404006D228116156C051084A161F323E40D17CD128816156C051084A161F323E4016ABB3A7A96156C0587B6B955A313E405CF4F94C146256C05F64CA7733333E402E6761B3DE6256C03750C6770B343E406AADC719A36356C0B8C4FAAA0E333E400670C719276456C0582BFEAA66303E40466594E69F6556C0A8A6FCAA4E363E40660961B37E6756C0274AC777F3453E405A5461B3B86856C03970FDAA664D3E40E68AC7199D6856C06FD2C877EB573E40EA932D80EB6856C08F389344405C3E4084AF94E6C16A56C0A7CAFDAA2E663E408234C8192F6B56C0106F62113D6A3E40581095E63B6B56C0F8EF9744686C3E4042022E80236B56C0A889C777F3703E408234C8192F6B56C090CE2EDE21733E407E5094E65D6B56C0885EC877F3743E405AE42D806D6C56C06F072EDEB97B3E40081861B33A6E56C09014CB771B803E40A23CC719176F56C05917FAAA0E883E40123395E6217056C08F4DFDAA968A3E40D9A8C7192D7256C0A0802CDE598D3E400464FA4C2A7356C027606211DD903E401A0161B3D67456C0905DF9AA3E9D3E408F2095E6077456C0B8C1964488A23E409D3061B3887456C0301BC977F3A63E403A4261B3847556C0D761C977E3AA3E4058B093E6257656C0970E9744B8AE3E403A3A61B30E7656C05F90FCAA4EB33E401D09C819957556C021B6FFAADEB83E40F65EFB4C5C7456C0316BC7771BC23E40A190C719C57456C070C1C777EBC63E40FC892D80337456C08FCE64114DCB3E40267861B39C7256C04002FAAAD6D13E406E0AFB4C9C7156C0980CFBAAB6E03E409462FA4C207056C068A3FDAA1EEA3E40EC1CC7194B6F56C0AF47FEAA4EF33E40DEB5FA4CDC6E56C061A7CA7733FC3E401AB461B30E6F56C03F95FBAA06003F40E605C819757156C03F95FBAA06003F407BCB94E6357456C03F95FBAA06003F40D60C61B37E7556C03F95FBAA06003F4014EB2E80217956C03F95FBAA06003F40FDD0C619C77E56C05F592DDE09003F40EFEBF94C1A8656C05F592DDE09003F40102DC719C58E56C05F592DDE09003F40FE3EDA31D79656C05F592DDE09003F4036B594E6719856C05F592DDE09003F40F43CFB4CCAA256C05F592DDE09003F40AAACFA4C78AD56C05F592DDE09003F40DEE393E625B856C05F592DDE09003F409C6BFA4C7EC256C05F592DDE09003F407C8BFA4C2ACC56C0983BC6770B003F409CCCC719D5D456C0983BC6770B003F4094E7FA4C28DC56C05FDCFBAA0E003F40A25CC819CFE156C05FDCFBAA0E003F40F8132E8071E556C05FDCFBAA0E003F40CA1C94E6B9E656C05FDCFBAA0E003F403804C819B1E956C05FDCFBAA0E003F40B6EE93E611EA56C05FDCFBAA0E003F40792061B30EE556C0FF809844600E3F40CC96FA4C74E556C021A2F8AAF6143F402EC661B368E756C0E7919444201D3F40C677FB4C28E856C049D8FDAA4E243F4093D7FA4C16E856C05002C777C3263F40B4FEC71969E756C017629644382B3F409CD694E63DE756C02036FBAAFE2D3F40EADA60B316E756C047DA9844F82E3F401819FB4CD0E656C0382B2FDEB9313F405605FB4CB2E656C0D05763119D343F40FF13FA4C06E756C06F339544F0353F40B49DC719E9E756C06F8DFDAACE373F40669A61B3E8E856C000059744383C3F40BEC060B392E956C0806F2FDE61413F400A272E8077E956C04843CA7783453F40D2BBFA4C82E856C090FD62113D473F40D446C71901E756C060E7FBAAAE473F40C509FB4CFCE356C0B7A32DDE41473F407C87FA4CA0E256C09F40C87753483F40AA1D94E6D7E156C0E85B2DDE214B3F40FAE2C6196DE156C06FA8CA771B4F3F4052D3C6198DE056C0C0A29544A85F3F40AC7C2D80F3DF56C0C0696511FD613F40C09BFA4CD0DF56C097E82CDE41643F40624C2E80B7DF56C0EF4E964448693F4025C8F94CD4DF56C0B0F330DEC96A3F4099CF2D80A3E056C0A03264112D703F408DC92D8049E156C0B12EFCAA1E733F40908294E68FE156C058D5F9AA06753F40F767FA4CDAE156C04926954428803F40729993E65FE056C0E09EFDAAAE873F40C22595E6E1DB56C098C06211BD923F40104D2E80CFDB56C020A4944480943F40FE582E807DDB56C0D0EF954440973F40B62694E671DB56C0605D9644609D3F40A05E60B33ADA56C0C741964480B33F40F23EFB4C22DA56C0B8535F118DB83F40BC9794E6DDD956C05F36FDAA06BD3F400C27C819E9D756C0B00B61113DC93F40F38AC71915D756C0501E2FDEC1D23F4056A5FA4C7CD656C0394230DE39D73F4079342E8081D556C0FF00CA77ABDB3F40DEA660B366D456C090DEFDAA16DE3F4016C661B3B4D156C00848C77723E03F40F88360B37AD056C0007B6211B5E13F406E1E61B33ECF56C06762F9AAF6E43F40E23CC8194FCC56C0FF366011A5F03F402A912E80E3CB56C0902F32DEC9F23F4068D52D8043CB56C0D8D432DE11F83F40E2FDC719C3CA56C0A871611155FA3F405239C81923CA56C0AFF9FAAAB6FB3F4068072E8023C856C05FB06111D5FD3F40982894E6D9C556C0D875B188CE0140401A9EC7196DC456C0A0117E552B064040847AC71969C456C0E0864B22D80A404098C793E659C656C068EC18EFA40E40408435FA4C60C656C09049E5BB810F404002AD94E657C656C0E807E3BBC5104040F84C2E801BC656C0D4EF7D5517124040A840FB4C84C556C050FE17EF18134040CFDDC71911C256C0E8CAB288E2124040566C61B3DEBF56C04047B2885619404088462E80DBBD56C01407E5BB7D214040BE4CC719F3BA56C074B5B08866264040BE4CC719F3BA56C01CC5B088462740407D45FA4C72BA56C030564B22B0274040187A60B33ABA56C010C87D5583294040566761B3A8BA56C0EF7F4A22802B4040F04D94E619BC56C00C8F17EF702C4040EC5061B356BE56C0E7CAAF88062D404000D3FA4C64BF56C0645F17EFB82D40401CB494E6D5BF56C06F6EE4BBA92E4040CD22FA4C66C056C070F716EFC03340406A122E80D9C156C0584CE3BB2136404036DF60B3D2C356C068C817EF883740404651FA4CF4C556C0F8CB17EFB43940408D112E80BBC656C0489D18EF883B4040CA5F94E6F5C656C0680016EFA03D40406B2894E6D3C656C084CFE2BBE14240407165C819AFC656C0AF1D4B2218444040F6DBC61967C656C01C93AF8886454040B1E660B336C656C0F49CB1880E47404098C793E659C656C028534A2290484040AC9061B3D4C656C028207D558F49404096E4C7195DC856C084ABE3BB394B40408ADEC71903C956C0C8D27E55234C4040A9BFC619C1C956C0FCCD4B22F04D4040B23194E64DCA56C028B417EF0C50404020EAC719A5CA56C08408B1887E524040E2FDC719C3CA56C017ADB08846554040A06061B310CA56C0C05AB18816574040D2B660B378C856C0BC5BB288A25740406444FB4CB6C656C0148AB188C2574040A840FB4C84C556C088D87E554B5840408E0E61B37EC456C0902A4C22005B40403CCD60B3CAC456C0B0F14A22405D4040E024FB4CF0C556C0A7BF7E55CB5E4040A2E32D8019C956C00C46E4BBB15F4040C297FA4CE4C956C060A117EFC0604040A06061B310CA56C0C0777E55AB6240400A682E8097C956C01FFB17EFBC674040364561B388C856C0E8AF18EFE46D40407C032E80EBC756C0D09116EF2C6F40404664C7191DC756C0748BE5BBE56F4040B83D61B324C656C070214B22AC714040D67594E63BC556C0BCBE7D55F37340407F1061B39AC456C0132D7E552B7640404ADE2D80D7C556C08CA94A22C87840407F7D94E6A5C656C0E4EA16EF107A40400A6761B376C756C0EC5CE4BB9D7A4040D2B660B378C856C05F0116EFD47A4040D2A660B38CC956C02F4FB0886E7B40409651FB4C68CA56C048FFB288627C4040E2FDC719C3CA56C06888B288A27D40403E3D2D80A7CA56C020DEE4BBD581404056C660B352CA56C0A8F0E5BB318F40407F4B94E6C5C956C07CF9B088C6904040A8922D8085C856C0C09D7D55AB914040FA332D802DC756C07438B1885292404098C793E659C656C0F000B1882A934040FE8061B3F4C556C0104B7E556F95404006BEFA4C1CC656C0E87717EFA49740406B2894E6D3C656C0145C4A22E89B40400A1661B3E2C656C06C26492248A2404042D793E639C756C08C59E4BBD9A340400EEAF94C14C856C0AB30E3BB05A54040A06061B310CA56C080A24B2240A64040E2FDC719C3CA56C0F8B7492278A6404076722D80A7CB56C098D6B188F6A84040BA162E80F7CA56C0D85118EFB4AB40403E0F2E8093C856C0E791B188F6B04040064EFB4C3CC856C03404B28866B340405F1A94E603C856C030A549222CB740407E40C71913C856C034657F55E3BA404068072E8023C856C09CD8E5BB31BD404072C9C6194DCA56C0D00E7D55EBC040401D0EFB4C92CB56C0046A4B22A8C24040E011FB4CC4CC56C0A8B67F5563C340401A11C819CFCD56C0F0FA4A2258C4404076402D80C7CE56C01CFF7D5573C6404008ACC71911CF56C03803B1888EC84040802C61B30ECE56C0E053E5BB81C940409C52C81989CC56C0286B7C5587C94040AE712E801DCB56C09F674A22ECC940404A4C2E8003CA56C0E7C67D5533CB4040B4272D8073C956C0C8B3E3BBE1CD40404643C819B5C956C074E97D5513D14040F88660B3BACA56C0FC2CB188C6D240401C8C94E661CD56C08CA17D55F3D44040797D61B3A2CE56C0A857B18822D7404094432E8075CE56C0381DB2884ED84040786A94E679CD56C0A885B08836D94040E23CC8194FCC56C0DC36E3BBA1DA4040EAF160B3CCC956C0D04F4A2244E0404078E2C7193BC956C04C597E552FE140403AF5C619CDC856C04437B288A6E1404076B42D8073C756C064FEB088E6E340406B2894E6D3C656C07038B088AEE44040EA6194E617C656C02C36E4BBF1E4404004E960B35EC456C08464E3BB11E540409030C819BBC356C018D7E3BB8DE540403E35FB4CE8C256C010B8E4BB41E840405A43C7194DC356C06C89AF88AEEA404096302D8007C456C0082F4B22BCEC4040627761B36EC456C06C7D4B221CF140404AAF2D8037C356C0A04AB188FEF340403D112D8047C256C03C7BE5BB19F74040848AC71955C356C0E09B7E559BFA40407A7361B336C456C077D54A2274FB404030A42E800FC556C02C4DB18806FC404024952D80B3C556C0A8094C22E4FC40404651FA4CF4C556C040CF16EFA8FE4040038961B36AC556C034797C5593FF40404011C819FBC156C0235CB188CE004140EC4FD91E28C156C0F39931108501414023622E8069BE56C014F818EFE4034140F6C8C719F5BC56C0A8474C224C0441407D8CFA4C74BB56C028F4E2BB45044140501861B330BA56C03CCE16EF840441401E8A60B326B956C0BB4D7D55870541404CC7F94C54B856C0E8974A22CC074140B8E993E679B856C064AB7D55BB0C41403E6E2E801DBD56C0A40519EF7C104140B2D5C6192DBD56C038134A221C14414002CFC7194FBC56C0D8007E557315414088E02D8025B956C0EBA6B188B61841403A4FC71921B856C0108FB1885A194140E15CFB4C50B756C0F4A87D55671A4140A491FA4CD6B456C0B8BCB188CA234140D2C693E68DB456C037B5492290244140CAD994E621B456C0AC89E4BBC92441400E38FB4C48B356C0285A7F55CB244140D6A9FA4C3EB256C0CBF5AF88062441408544C7199DB156C054E0B188CE2341402C4AFB4C56B156C050C34B225C244140E9DAC71923B156C044B74B22A8254140663FFA4C3EB056C0C82F18EF0C284140007460B306B056C07014E6BB152941401CF393E61FB056C06C7016EFAC2A4140960B2E80B3B056C0E0FAE4BB152D4140AE8360B3E6B056C0A4A8E5BBE52E4140D20094E6E3B056C028CDB0880E3041406A1B2E8099B056C094FCB088BA3041404A6761B3CEAF56C0F87C4A22B82F414066CBC71949AF56C0DFDAE4BB3D2F4140B88794E68FAE56C027B27E55232F41406FB52D80E3AB56C0144E18EFA82F41407299FA4C6CAA56C00487B188923041403E3561B314A856C0D8907D55B3324140188A2E8003A656C0D4204A2268364140CB1195E681A556C0A41B17EF283A4140BEF0C71989A556C044874B22983E4140F66AFA4CDEA456C0649F17EF68494140D2B094E601A656C0046B4A22385241407B6E2E8075A556C078504C22A4574140D86F94E659A456C028CD4B22245C4140A9CE2D806FA356C004A34922B85E4140FA702E80A3A256C0782E4B221C5F4140D4372E806BA156C0A01CE4BBD15D4140909260B3FA9F56C0E882B188B65D4140204C2E809B9E56C0C8D5B188665E4140DE2A95E6079E56C09CADE3BB815F4140F0DFF94C1A9D56C0EBBB18EF306141404AAD93E66D9D56C0385EB1888E6341406E5095E6279E56C0584C7D551B66414081E293E66D9E56C0B0BA7D5553684140E839FB4CB09D56C06422E4BBF969414079E4C6198D9656C0C0BBE4BB996E41407C9294E68B9356C05B0FE6BBC9714140105CC719659156C0C0BCB08826764140561294E6519156C0281FE4BB8D7B414046EB2D80479356C05BE9E5BB717F41403A10FB4C789356C08090B18802804140A069FA4C268B56C0F0FBE4BBFD7F41407422C819D58256C06449B188FA7F41405AB42D80837A56C0BC25B188F67F414070CCC719317256C01C2018EFF07F414094C6FA4CE06956C0049D4922EC7F4140AF4F61B38E6156C0D485B288E67F414046A061B33C5956C0B702E4BBE17F4140B46A2D80EB5056C028DFE3BBDD7F41404ABB2D80994856C0F0A9E5BBD97F41409E3B95E6474056C0F02617EFD47F414084CDFA4CF63756C053924A22D07F41409F5661B3A42F56C0A8FD7D55CB7F414006B060B3522756C09C09E3BBC57F4140DA682E80011F56C07C45B188C27F414070B92E80AF1656C0E021B188BE7F4140,-30.1%,-62,144,86,58,Mississippi,true
25,0106000020E610000001000000010300000001000000580200009AAC6B6F3B6556C0401A33D887FF4740F42BE22CC56556C0009833B6CBFE47403E6F1514D86656C0D80A1EA6E8FE47405A73ACC6BC6856C020C8BFCAD9FF4740B8FA1A1A806956C010B079C052FF474098C7A16A956A56C0701DF06CE9FC474040CFFAC35A6C56C06C7A7968BEFB4740846CCA0B666E56C0709D38E080F847408A0F4110916F56C0FC3A3BA125F747406CF69D3A758556C0F0804A77D9E74740DAE04DF2689256C0F45D1CE645E24740A2CF58BC099556C07764CB2703E0474010263376219656C0B072D3C285DF4740C3DC2559559956C058343F13F5DE4740EE2CF3631AA256C064CCCD9013DB47401C604A46A7B256C03C56E559DECE474009761A54C0BC56C09489226991C14740B30018D5CAC056C0B0D04A701EBF4740D058E0CBBFD056C06C8251CF5CA74740ECB0A8C2B4E056C02434582E9B8F4740632D9EA83CE556C0285717A65D8C4740567B1784F1E556C07C5BE1D1DB8A4740604A83EA45E656C0DC5FABFD59894740545B45A70BE756C00C629013998847400ACC4A81E9E756C0E4BC34F92E88474088E0CEE48FE856C0C7A4EEEEA78747400326E7E1E1E856C087F36F4FFA864740AC4D12188DE956C0782C90BB048547400643CC23EBE956C0A82E75D143844740A43B155D90ED56C0B4C6034F62804740C84BCF94B8EF56C0808A54B5107F4740CAAEA1DF17F356C05CDA10149A7947409CC6B47005F756C0980BD826DF754740C8E2912D71F956C090686122B47447406A616C2938FD56C0CC02D5B5117047400A1A11A9110357C02012184FCB6A4740712424241A0657C02CAAA6CCE9664740C2EDE8CD4E0757C00CA9FCB4E1624740E64DE6ED1D0757C0F48AACA555624740AFF260B3FA0757C0E007E5BBC16147401A6660B3000957C06FB816EFAC6047405A762E80830957C0DC0418EF845F47401A0F62B30E0A57C06C547D555B5D474016F5FA4C480A57C0AC1D4B22DC5C47403ED494E69D0A57C08CAF7D55875C4740FE0BC819A90B57C083127E55235C4740A673C719070C57C0F379B188E65B4740D04960B35A0C57C034D718EF7C5B4740FE7FFA4C9E0C57C0E8DBB088F65A4740403F2D80D90C57C017EE17EF4C5A4740EC7094E6F50C57C080E37D5583594740F079FA4C440D57C0603D4A2240564740BA57C7196D0D57C03C074B22B05547400A1EFB4C8E0D57C000B7E4BB595547408B45FB4CCA0D57C0F8A818EFF45447407C2D94E61F0E57C064ED7E55A3544740C82A61B30E0F57C0A7EAE4BB49544740902C61B3241057C07C62B0882E544740CA9EFA4C4C1157C06443E3BB51544740488AC719391257C0F8D34A22CC544740AAFE60B3821257C068D317EFDC544740A4CA2D80A91257C01C7E4B2270544740DE32FB4CAA1257C0E7327D559F5147407A4DFA4CAC1257C0EC4E17EF84494740C02694E6AD1257C0D38818EF6841474007002E80AF1257C058D417EF4C394740D6112E80B11257C03C0E19EF303147406B2C2D80B31257C0606B16EF142947406C352E80B51257C044A517EFF8204740FADE60B3B61257C0CC61E3BBDD184740C2F060B3B81257C0BC9BE4BBC1104740D0612D80B91257C014BFB188E20E4740D0612D80B91257C050E6B088AA0A47401A7161B3F81357C074017E554F0A4740AA7BFB4CC21457C0148CE3BB79094740A25B94E6A11557C0E74B7D550F084740C0EC93E6571657C0BB91E4BB550647405AC9FA4CA21657C0D0D1B288960447402AEDC619411757C040BEB2887E034740362AC719B11857C07C874A22980347406200C7194D1A57C0A03BB288160447403E4661B3701B57C04C6418EF300447409A25C719611C57C0D892B2880A03474012B093E6CD1D57C010B216EFA8FF4640BA7194E6C11E57C0CC477F55F3FE46409E05FA4C662157C0CC477F55F3FE46408A3E2E80032257C09B9717EFACFE46400234FB4C822257C0C0497D5513FE46406A3C2E80E12257C0E4FBE2BB79FD464092EFF94C202357C088287F5533FD46403DC860B3322357C094DEE4BBD1FC4640E4EAC619F32357C094B94B220CFB46405253FB4C422457C08FB84A2280FA4640CC0994E6C92457C0EBF74A2218FA464040122E80712657C0E8CB17EFB4F94640D29BC719E32957C0149517EFA4F646405A58C7190D2B57C0488D17EF34F646409F4594E60F2D57C028E14A22E0F44640640B61B3D62E57C018CFB088B2F146407E7CFB4C683157C0AC92E4BBC5EA464079C394E6213157C0086E4B220CE746403E8060B3E63257C07097B1883EE346406564FA4C723857C094D87F55A3DB4640EC672E80093957C0A06916EF14DA4640C0D093E6453957C0AB9B18EFF0D74640CCCF94E6B53957C0EFEF4A2240CE4640281FFA4C863857C03091B288BEC9464016D1C719BD3557C034D54A22D0C84640CE772D80873257C07C21B188EEC84640874461B30E3057C040107D5593C7464054C8C719552F57C0A8814922A0C54640889294E6652E57C03762B188B6C0464064E72D80E92D57C09014B288D6BE4640F85061B3CE2C57C030697D55C3BC4640FE3D94E6A52B57C088DE492208BB46400E05FB4CBC2A57C0DC3E4B2204B94640116D61B36E2A57C0148BE3BB91B646402C0861B3B62A57C01C774B2244B44640AE1761B3902C57C044E7E3BBE1AF4640BC7E2D80FF2C57C010687D55EBAC4640BAE093E6572D57C0EFEE7D5597AA464052B5FA4C2C2E57C0F8D24A2220A946401A942D802D2F57C0403716EFECA74640874461B30E3057C00CC317EF5CA646400A75C719993057C000124A2244A4464038A260B3DA3057C0783AB388E2A14640AA1BFB4CEE3057C03CE6B088329C46405A4DC719573157C04F887E55839946405BC994E6753157C0907217EF0098464034B4C7192B3157C0D06617EF58974640874461B30E3057C087ACB0880E934640909260B3FA2F57C050DF4A222C904640E2B8FA4C583057C004D9B088A68D4640422594E62B3157C08772B088DE8B4640FF9B60B37A3257C07CC0E5BB318B464066DBC7195B3357C044727D55FB894640B0A0FA4CF03257C0F4627D55278746407E7CFB4C683157C0CCF14A226C814640F678C719D13057C09406B088FA7B464056A561B3883057C0746FB1887E764640B5F62D80BD3057C0CCFFAF88AE754640C23B2E80A33157C0A0EAB18882734640208DFA4CD83157C0487416EF20724640000561B3703157C070EE4B22006E46407E7CFB4C683157C0ECDEB088726C46407EF82D80D33157C0F42818EFFC684640124B2E80773457C0409118EF00614640C4ECF94CC03257C068647F55CB5E4640E282FB4CCE2E57C0801516EF145B4640884761B34E2A57C06C8E17EF84544640EC6994E62B2957C05039B0886A534640A664C719C72857C0B4B4E3BB515246402794C719792857C05C96E4BB1D51464010F9C719312857C04FBBAF88525046401C6FC7196B2557C00438E4BBD14D464053A2C719751B57C09BA1B0886E4B4640BC0A2E80331957C0EFE84B22304A46406566FA4C061757C020A14A22A8474640F1D0C7192F1557C0F355B2883E44464036F894E6871357C054FA7D55BB3E4640447161B3FE1257C024BA17EF503D4640511E61B34E1257C0A09AB2883E3C4640C66AC719731157C0B8C94922A03B46406EA7C719FD0957C0B893E5BBC93946408E23C719910657C0CC1B16EFEC374640C8F561B3CEFC56C058B816EFF82A4640A2D6C61961FA56C0747919EFFC24464097952E808FF556C0CC04B08846174640ACF12D804BF456C0535DB188D21446401DE5C719D1F156C0F4EFB188261346401D36FB4C68EA56C0382117EF60094640AFA894E69BE956C09FEB4A22C0084640481B2E80CFE856C0709BE4BB6908464074162E809FE256C0D477E4BB65084640127FC71941E256C06F327D552B084640D4A9FA4CA0DE56C07761B288CA034640771094E625DE56C074A64B2268034640B87760B39ADD56C05479B28826034640C20AC81943DB56C027ABE3BBE102464054CD60B37EDA56C010577D555302464016F261B314DA56C01445B188B60146407565FA4CD2D956C0D4C817EFFC0046401EDEFA4CA8D956C0640018EF240046405CCAFA4C8AD956C010C8B1882AFF4540E42D2E8015D956C01402E3BB61FD4540A02F60B39AD756C09C517E559FFA45401858FA4C1AD756C0B0314B22F0F84540DE5661B35ED456C0F0AA17EF6CF7454020B5C71985D356C0C8FF4B22A4F645407C052E80E1D256C0D32017EFA0F545403C212E8075D256C01CE5E3BB5DF44540087AC71931D256C0C0ECB088EAF2454012E22D80E3D156C0A4FDE3BBD1EF4540420661B3D6D156C028134A22E0EC454004E42D80FFD156C048A7B0881EE9454044EAF94CF4D156C01C70B08802E84540AE532D80D3D156C0109E17EFECE64540055FFA4C92D156C0F05AB288D6E5454008FD93E639D156C09C4519EFF0E4454060ED93E659D056C0A8E8B18866E3454046D6C619F3CF56C0FC3216EF6CE24540DE9960B3BACF56C0E0CCE3BB41E145409CA4FA4C8ACF56C080677F55BFDE4540068AFB4C88CF56C0809B492254DC4540988293E64DD056C0E888492260D54540B48EFA4C4AD056C0ABCFB18832D445405884C719CFCF56C0B8484B22CCD045406E1661B3C8CF56C0F8787E5573CF45406A55FA4C0CD056C0EC6E7F556FCB45409CEAF94C00D056C0642B4C22BCC945409CC7C7199FCF56C0004A7D556BC645409CA4FA4C8ACF56C084184C22BCC44540405C94E6A3CF56C09C7AB0881EC34540A2F3FA4C02D056C038437D551FC04540F6F860B3D2E456C02C61E4BB1DC0454081F5C719A3F956C09CAEB0881AC04540D6FA2D80730E57C0903DE4BB19C04540A9C72D80432357C08CCC17EF18C045408405FA4C143857C090BA15EF14C04540F8B88C547A4657C08BF1B8D313C0454090C9FA4CE44C57C073D87C5513C045405E96FA4CB46157C073D87C5513C0454070CBC719857657C048144B2210C04540FCC72E80558B57C043A37E550FC04540989D2D8025A057C03832B2880EC04540249A94E6F5B457C0A87F7E550BC04540F66694E6C5C957C0A80EB2880AC04540CA3394E695DE57C0989DE5BB09C0454026AAC61967F357C09CFCAF8806C04540326EC719370858C07FA94A2204C04540043BC719071D58C07FA94A2204C04540043BC719071D58C018EBB28822DC4540043BC719071D58C0D04F17EF40F84540043BC719071D58C0F8A27D555F144640043BC719071D58C074E4E5BB7D304640043BC719071D58C03BBA16EF9C4C4640043BC719071D58C0D36C4B22BC684640043BC719071D58C0EBDD18EFD88446403EA394E6071D58C0A8427D55F7A046403EA394E6071D58C03BBB17EFECA546403EA394E6071D58C07873E4BBF5A54640AE52C7195D1D58C00CC317EF5CA6464039812D80CB1D58C000B717EFA8A746409911FA4C8C1F58C034607D557BAC464022652D802B2058C0DC217E556FAD4640769E94E6B12158C0573A7F554BAF464078D32D80632258C0C0A67D556BB04640DAD6C619412458C068A67D555FB24640704C94E6F92658C0A453B08892B34640BC5E61B30A2C58C01C9A18EF58B4464096D893E6532D58C033CC7C55F7B5464084B92D80BF2E58C0B04FB188C2B9464086DFC719113158C00C96E4BB89C14640445694E65F3258C040A47E557FC44640360CC819893558C04F3217EFACC94640B64FFB4C3C3758C0243EE5BBE5CC4640C10761B3F63658C0AC30E4BB99CF46401A1B2E802B3658C0982F4C224CD24640BE81C719B13558C04C8D4B2218D346403EF860B31C3558C03CCE4922C4D3464008002E80AF3258C02FC9B1883ED6464018C693E6393158C097DC16EF9CD846404D49C719913058C0CC8D7F556FD946401D4EC719E72B58C0BBEC7C5543DD4640B816FB4C302A58C0F49EB0883ADF4640CCDDC619932958C044C64B2224E04640F0BBFA4C102958C0D4B67E5527E14640342C2D80D32858C034227C55BBE146403644C819E92658C0141D17EF0CE84640952061B39C2558C028F27C555FEB4640485AC8192F2558C0EF1E16EF94ED46401C1BC8199D2458C06859E4BB61F546408E9CC719732458C0B81718EF0CF6464060BF2D80392458C0249A7D55BBF64640006E61B3042458C0D47D4A2238F7464015D4C7199B2358C0E8477E558BF846405A2AFA4CE02458C0CC657E551B0247403ED794E6DD2458C0F396E5BB25054740DE0AFA4C1A2458C0D45819EFFC074740A0D6FA4CA62358C0A46C16EF900B47404A12C719A12358C09CEC4A22300D474016A9FA4C102458C0DC72E3BBED114740F55EFB4C5C2458C0746CB288A61247405A182E80432458C0188E7E55231447402C5E61B31E2458C0DCA2E4BB1915474025AE60B3262458C03C894B22F0154740DEF9FA4C9E2558C0C0F117EF681947407DCD60B3E62558C05C0518EF801A47400E162E801B2658C0B869B188DE1B4740D0F3FA4C442658C08351B188761E47400E162E801B2658C040F216EFC02647402995C619812658C047B5B088762947407B1562B3742758C02C5316EFAC2B4740704561B3A42958C0CB204A222C2F474078DE2E805B2D58C0CBFC4A2284374740446C61B3C82D58C0503718EFE838474078CD2D80E32D58C01C497F55333A474062EB94E6E12D58C0909716EF543B47408061C719F92D58C0C8F94822483C47407E1C2E805B2E58C09C7316EF443D47408624FA4C662F58C0DB107F55F33E474050A161B3C22F58C05C797D55DB3F47405A8DFA4C562F58C098C04B227442474022F8FA4C622F58C04006B0882A45474050A161B3C22F58C000EC16EFE8494740E54094E6313058C0C0B049226C4C474050FB93E6393258C09C974C2270504740E0C894E6DB3258C038CEE3BB355247404CE22D80FF3258C024DE16EFF8544740FA3F61B3363258C0F00D7D556B594740BEF1FA4CFC3158C0875818EF4C5C4740E454C719333258C0CCE449221C5F4740942E94E61D3358C05C0EE4BB9963474082D993E64B3358C0BF0718EF986547408E8794E6273358C094197F55E366474046EC2D80913258C0DC7017EF00694740116894E6613258C00351B288E269474033C2FA4C4A3258C098DEE4BB496B4740116894E6613258C09C807D559B6F47407F1FC7192D3258C03CEBE2BBED704740F6122D80473158C07C3A4C22B07247407EF22D80F13058C0C48019EFBC7447407392C719B53058C0E8454C224C7547403AB72D80973058C048B14922E075474084F02D80D53058C06C6E17EFAC764740A678C7193D3158C003F2E2BB397747409BE593E6FF3158C0ECA7E3BB8577474077FDFA4CA43258C02C847E552F7847408F762E80633358C0A44B7D557B78474006A02E80BB3358C0D40CB088D27847406713C719793358C0D49BE3BBD1784740122261B3803358C0607B4B22C479474006A02E80BB3358C03CB9E5BB717B4740F665FB4C883458C0BC057F55737D47406C86FA4CDE3458C04CB97D559B7E4740D22EC719013558C0A8387F554B804740034894E6893458C0A8B47E55B3884740B0AF2E809B3458C0BC1317EF408B47405EBF2E807B3558C0B0004B2280904740BCEB2D807F3558C0E0D44A2200924740E422C719533558C0C8457C5547934740368794E61B3558C0C8B84A2260944740D22EC719013558C0009E4B2258954740C0A393E6393558C0D04817EF14984740A8CD61B32E3658C0884AB1884A9E47401001C719653658C0CCF9AF882EA147407A97C719EB3558C033627E5577B147401A1B2E802B3658C063DF18EFBCB24740B8A7FA4CBA3658C00064E5BBD5B34740B0F8FA4C4E3758C064EA4A22BCB4474092F5F94CA03758C0F81F17EF5CB547409F16C719993758C03CE97C5507B847404A8E61B3963658C0A0777E557FBE4740DA3794E6973658C0C78316EF5CC047400C4161B3343758C0D8C87D558BC2474038D860B3443758C0687E7E55CBC44740FEFCC619273758C06CFB7D5557C747403E7F60B33A3758C0D0E4B1886ACA474068E2C719253758C0D8A47E55E3CA4740C8282E80EF3658C0D0D4B1887ECB474030C894E6C33658C004C217EF38CC47409C6E61B3CA3658C0C7A2E5BB09CD4740BC7A2D80133758C0881FB288B2CD47406056FA4C1A3858C09C85E4BBDDCE47401664FA4CDE3858C064B87F5563D247403C9C94E63D3958C0D08D7D55EBD647405463C719E93958C0A4CC18EF24D947403661C719C73A58C093F5B18822DB4740FF7C2E80A33B58C0D89B4A22B8DD47409AEF93E66B3C58C0145AB1883AE24740FC02C819E93C58C07B987E55D7E347409A03C7196D3E58C0DB20B0886EE6474014BAFA4CA83E58C08C874B22F0E64740909B60B3BA3E58C02B257E5543E747402D05FB4CE83E58C014777D5567E74740E21AFB4C223F58C04CE14A2284E747409727FA4C5A3F58C07C0EE4BBC5E747409F1494E6793F58C02C157E5557E847405368C7191F3F58C0B7F4E5BB49E94740E21AFB4C223F58C0987618EF08EA47408697C719C54058C044897D554FF04740DE9894E6F14058C0177AE3BB35F347400AF294E6014058C0ECB0E3BB45F64740C68C94E63D4258C08BA1E4BBD9F947408CC4C719494358C09CC64B2230FE4740B2CF94E6014458C0EC407F55F3024840A0A093E6CD4658C027B34A22640C4840D064C719CD4758C0D46419EFFC104840CA92FA4C4C4858C05F2516EFD415484058452E804F4858C0A4BEB188221B4840C46EC7195F4758C01CD77D55FF234840423FC719AD4758C03CB8E3BB052648408023C719194858C06F954922D4274840427EC719394958C070834C223030484084F7FA4CFE4858C08492E3BBB93148406CB4FA4C344858C0E823B1880634484004CF94E6E94758C0FC817E556F3548402682FB4CDC4758C03CA47D55DB364840B18D94E6354858C0E4557E55E3384840EA57C8198F4858C09B7718EFF03C4840282CC8190F4A58C038BBB1885E4448400CCF60B37E4958C030DC7D55C34948408A8B2D80CB4758C09804B288624E4840E2A6FA4C764658C0CCDC4922445348405B6694E6FF4658C0AB0217EF6C594840300E95E67B4858C0F8DF4A22CC5D48402FFD93E6034958C0CCFB18EFF05F4840EE7BFB4C7C4958C0E4A318EFE4644840EC1361B35E4B58C088E6B088C66B4840C07461B3D84B58C06487E3BB39704840F0C4C7192F4C58C0D8584922607148400C9D60B39E4C58C0588AB08876724840B40D61B3FE4C58C077F0E2BBA1734840AAA5FA4C4C4D58C06C0E18EF307648406CDCC7197F4D58C0F4514B22E4774840DAED60B32C4E58C0732D18EFE47948404AE32D80AB4E58C0000E4B22FC7B4840405E2D3C784E58C0F031F4CB0F7F48409CFFEBCAF14958C08F79F4CB0F7F4840F8DF5AEBE03B58C08F79F4CB0F7F48405630679FCF2D58C08F79F4CB0F7F484093937453BE1F58C08F79F4CB0F7F48401661E273AD1158C08F79F4CB0F7F484040BED1E29A0358C08F79F4CB0F7F484028CA7F2A89F557C08F79F4CB0F7F4840C284EC4A78E757C08F79F4CB0F7F48403E525A6B67D957C08F79F4CB0F7F4840205E08B355CB57C08F79F4CB0F7F48408AC31527C9CA57C0D436A6B05D7F4840EEEE225B5CCA57C018CEDC8025804840EA992D7232CA57C0ECF87A5482814840324208F337CA57C05CD1606C048E4840DE4142E03DCA57C0E04D30D6969C4840F67FBCF442CA57C0782E1FC510A8484064DC18C446CA57C0E43457954BAF48402A69B29D94C657C0FFD7D8E34DAD48409C5F7593E1BE57C084310EB496AD4840D247190445BB57C01464ED913BAC48405B233CE6CBB657C078E6707DBDA84840994BD47FB4B557C0FBD1A64D89A74840420519C4F1B457C0800EBA5E7CA548403844B31D79B457C0A045FDA242A048404A72F0E7DCB357C00C49E3BA639D484092E6B67A97B357C090004CBEFE9A4840EBE1E273EAB357C0F81E04DD51954840E9075E8870B357C00CFF9E76BD9248401A253EC3B0B257C08F7A31D62F904840743B57CE3DB057C09023A01359834840C2DE749384AD57C0B783852B117548405A10ED0A8DAD57C0AC90B6C16E6E4840B6BEE5D093AD57C018E7D246D56B4840527F5371A6AD57C010A53AAD73694840AFA0FA7E7FAD57C0CC3F57955C6748400890310FEAAC57C0A8B615EE21654840C450E6D016AC57C0302288C8B06348403A9B3749F1A557C0906E4BBEFB5C4840CBF078F039A157C0272CA0132C5A484052A4671FB09E57C0C0F49D76B0594840B0421CE1F09357C0189EE7F4615B4840CAB7B5BAB99257C0E005ACEA1F5B48406C87239B2D9257C0A36889C8C25A48407EB56065919157C0D42C2C39205A4840400215A7FD9057C0D0767EF14F59484083E989818A9057C0082665096D584840EAB9B57A5E9057C0508AD3467E57484054FBEB4A289057C038270DB4C9544840DE666402119057C054AD3510225448404C4C7C8DDB8E57C0071BE65775534840D2C6B5FA3A8257C08C56450458524840A483681FFE7757C064CDEE2E6F514840E055CEC57C7557C060ABE557FE4E48400DF700F9CC7357C020C021E293454840B8571DA1D57157C02F567FF17D42484092BCE5106F7057C0F8861E451E424840CAB81567716757C0608578B7014448402CED0496646657C08F491B285F434840AC7BCAE8426457C068591151E6444840A4109EEF785F57C05CD58C656A4548401408AC636F5D57C0A0FE99D95847484036E3C9A8F15C57C090BD61EC4E494840B20DD2A20A5D57C0E358CB6F214B4840263597F5E45C57C0E8963056784C4840A2FC0A50B55A57C0789D939F534D48400E2C7593AF5857C0C4CE30D6B34E4840821057CE7E5057C04FF7B124AE5048401BA837C96D4857C0C8BC6CE0F34F484022A244BDB33E57C048BD941F104F4840C6159458283D57C0C4F2077A5D4E4840271E0EAD963857C0687E3373394A4840FE11CB686F2E57C0073AF9853B464840AC5701B9822957C0709BD346A444484015ADD1E2542857C02F567FF17D42484002399F6F282857C0B8CB25FF5A404840BC971F3E642957C0900798BCAB3F4840426FDE563F2C57C03CC4D2A9B33E4840BEF360257B2D57C06FCA3710CF3D4840673DD89C022E57C0882CB324DA3A4840C8E02D320F2D57C08CBD14EEFA384840A6A12915562B57C06085862B8B384840A02A16270D2A57C0E846F90518384840BFDCC968832457C00C3E64092C3948408555FA3EB92157C07C9D852B0A39484064767176661F57C0D0F2236270374840D0E8DAB95E1E57C0200F0EB48A34484007E96ED9EC1D57C02039E6D77732484077B7F661E41D57C04700717D362D4840142C8307991D57C01C83077A262A484028EB596BE31C57C0942AEC1106284840B4985C48C41A57C000F860EC19244840685308F39D1857C0F089067ABF1D484070843B66CC1757C0AC184BBE7D1C4840DC30A5E9A41657C09CBA41E7871C48405093D1E2FB1457C0605D281C5E1D484024DB00396F1357C020A3A4B0A01E4840183E7236A01257C060F4D0A9F11F4840608E6125B11257C0205823629A2248400CD786644A1357C000DC04DD33254840B40DCBE8651357C0478B257FCC27484075DC2DB2051257C00421B6C1772A4840921C6165951057C09057B324792B484068041C21E70957C00F6AD9E3D02C484000A20B10830457C02F0C4921612C4840DA43CA68C70257C0D4E9170BD42A484032568664ED0157C007DF1D28162848405132F6E15D0157C06C3F6EE0CA244840F295F304830057C0A02126FF982148409BAA19847FFF56C0CC35077ABB1F4840BE3C4C776EFE56C040953DCA471E48401DCA787044FD56C098B00DB4391D48403E747F2A8BF656C0483C39AD15194840EF39C091F5F056C078CFD8E3FA174840FA0179F09FEF56C0D053D6E3FC1648406E042A9590EE56C028E54ABE8B154840DCC3DB3983EC56C008D2C2359C114840C8144220DAED56C060190FB4570E484032568D1E52EC56C098DB22E2860C484024CBD16297E756C09899751A770B484092996E193DE656C028535832920B484006ADAE40BDE556C08C5D9F764E0B48405025BDB430E556C02CE110515C0A4840AA45128A1BE556C0DC31DB801509484062D0F9BE72E556C0981E299CC90748405490DB3991E556C0508B3AADBA064840C2A76342CAE456C090E40B972B064840FAB88D9E2CDF56C0809C5D4FD806484080563E03BEDD56C0E891B224440648408854AFC08FDC56C0105C41E736054840E4C29E2F63DB56C047E7505BAA044840984C26B862D756C050438C65670748402E7EA5E9AFD156C0F0B9A74D4A0848404B2A5E883CCF56C0FF225A32940A484086A090BB0DCD56C0309E1FC5C70D48400200E3F38CC456C0440679B7DE154840424C675FCDC156C0C0826BC3A8174840912CB3DD84C056C0A826F12EE1184840FCB72DF214BB56C03723F6E8111D4840827A1C61ECB756C0CC3B08FAFE1D484052927FAACDB556C078A09E762C1C484000B4ECCAA0B556C020285832F31A4840847E797053B656C0B01E616C6F194840E69C2AD561B656C0E4280EB44318484060AF18C4F3B556C0404C6E60A71648409808EAAD64B556C078A05832FD154840A66FD57FBAB456C028E54ABE8B1548405E6794D8FCB356C0C8113E4A9B1448402B7CEC4A65B356C058D3C552D61248402AA11527FDB256C0E08CE7F4FB0E484044273E8355B256C06F34CC8CDB0C484062D152B105B056C0A73F2D39C00A4840E0E4BC34E2AC56C048009BD9D20A484044940EED1BA756C0E092E8743F0D4840BB84DED68EA556C0F400FDA26A0D4840623F7553BAA456C04F8AE1BA870C4840CEC6B5FAFAA356C0EB9A8D655F0B484076DF235BB0A256C0F820B6C1B70A48404BDCAEC005A256C048009BD9D20A4840FE225AEB1EA056C0E7905932110C484000A4B63A649F56C070F1198B510C484062782A15F19E56C0405253F8170C48401CF42638959E56C050D43373B70B4840B7FA9EAF1E9E56C0B7156A43810B4840EE6094986E8B56C0DC6EFCA2E70E4840CE4A1667B48756C09896A213C40E48401BBA1F3EB08456C08C07751AF40C484074CB8901E88356C0F0964584A60B484060B071B6868056C0300C2D39CE0348401C712678B37F56C0D82C5D4F6102484070F53E83BD7E56C09729B6C14A0148405A573BA6E87A56C0EB45A01365FE4740225B0496C17956C0B08DD54632FE4740620CC8CB6B7356C06880BBFBC20148409C39FA7EFB7156C0008D0A973302484094F89EEFD97056C0986D07FA36024840183A1CE1BD6F56C06880BBFBC20148408BD05CC85F6E56C0906FC098C10048402AA3C0519E6D56C0804E929F6E004840E8D494186F6B56C0A78963091D01484061C3C091056A56C0078B7B5405014840C4157870F56556C0205BF6688DFF47409AAC6B6F3B6556C0401A33D887FF4740,-6.1%,-18,279,31,248,Minnesota,true
34,0106000020E61000000D0000000103000000010000000E000000362D7CD3ED5852C02F4FD035F24E44406093F561BE6452C0E076CAA59C494440F6BF3EC83F6452C064C71A9D8F4B4440C2494FFB675C52C020A5B14E394F444056C4FD9BA55952C0307A791198504440AE80B5DC2C5852C0480358213B5144409151ACEDE25652C0F82FFB42F651444092E34678B85552C0E000340382524440D40DCD355F5452C0576109D1C5524440E2AAA9C73E5152C074A8F71F1C5344404A37D5CFE54F52C090669D7FE85244405A7E61AB645052C0938D4874CC514440646BF030805452C084A7B58249514440362D7CD3ED5852C02F4FD035F24E444001030000000100000026000000FC39907EC68452C02C0E41FE27514440820F97AF9A8452C0FCB33555C94F4440CFCB06D1EE8352C0589DF87EAB4E4440CA018CAB6D8352C01CF87A66254D4440CE0393D9888652C0D03B772AFC4644401268BC1C928852C087062C772E4444407ECCF86BF08852C0E407AC386F4444409EC98D6E798952C097AFA4B96E444440B19A4E48718A52C0C498EC6083434440602A83BE828B52C0487147D28A4244404CD260A64F8C52C0A4E7CE7478414440ED2B0B63618D52C01C790612364144406A6B8B989D8E52C0C812A8FB494044401CD94F0B8D8F52C03024C378ED3F4440EA48499D0D9052C0A06515C42D404440EC46CA3C309052C09CA849FDF0404440E8CF1F7CE38F52C0203ECBEEA74144409EB58F33528F52C0889DF5122B424440EDA10EA24A8F52C05CD4AB387D43444012E65C6E768F52C02808A45F03454440E464FB86E58E52C038EE5F892246444094A47D9CFE8D52C0E845900BCD464440D8E7F5B0428D52C06F943849B84744408035572BE58C52C0C45E150DF1484440B600E64DAA8C52C088E8E2D9DF4A4440B281C642708C52C0E8D4FF206F4E44404A34A37A468C52C04C7774F66A504440CE67F2C0AC8B52C0F370E70E97514440D0BF3879F08A52C06092E6435B52444049862918D58952C0E0A6EB42995144404C947CD3118852C02FB6D035165144403EBB267E0E8752C0D8B2CE35A25144409ADD267E3A8652C0A05ECF355E524440FAA5AAA8588552C06C9BCE67235344403EF1FBE8E88452C057D3260F0A5344409A45E5E2AC8452C07B6D49CA7A524440CE6EFEA3928452C03C8891FDAA514440FC39907EC68452C02C0E41FE27514440010300000001000000170000004106D228714952C088DB79E0785244406457D3E8BA4F52C0A0D4D0E0D84F4440DA1EFD8F095352C038308C17B24F44403EB603E0855352C093714D47A1504440F5405AB2565052C00C0E92F99850444064269D50014E52C0A064C38BDF514440BEE1E0934D4B52C000B939E653534440D2992FBAB24652C0EC028E79675544405A44AFFA944252C0545BC09E4B574440D6C77CD3E34052C0C89679E0605844407C0B10D7BA3C52C030E936C2915B44405C504860833A52C0F009CF4EBD5C4440DCCC7FAD6A3852C0C81D77D0005E4440C8984E8D453552C064261A16B65F44406A4A01E8DE3152C0FFBD4BEB27624440A0C1320B743052C0A4BD781B6862444054CBA19B763052C07CBA517D4A614440D4C77CD3833352C07826258B1B6044407AA57CD3373552C03CD5CE35EE5E44409CA64566763A52C02C71DE58405B4440735AD128753F52C040B6D03516584440BB607CD39F4252C064EE7AE0185644404106D228714952C088DB79E07852444001030000000100000013000000DC55277E248052C0A05ECF351E5A4440745AD128158152C0BFC5CF3582594440C284C93BC48052C04026ACE3715D4440B21A1DB3338052C04C5F1A63C06044400C67277E2A7F52C020B979E0AC634440A26BD1281B7C52C05CD2258B576D444058B0D128B37B52C05FA3CF35366F4440EAE3D128657B52C04C3CCF3552704440BF607CD3BF7A52C0C4C5CF35027044400A67277EAA7A52C0B8C5CF35826E4440C0607CD37F7B52C0BCC5CF35026C4440745AD128157C52C0B0C5CF35026A44400A67277E2A7C52C028B979E02C684440909A277EBC7B52C0E393D0350A6644405619EE38927C52C060AE7A6A7C63444016AA48D6387E52C0DC9A5394CE5E4440E8EA370E3A7E52C00C2190FA145D4440B18A7C99737E52C00C2B78C5645B4440DC55277E248052C0A05ECF351E5A4440010300000001000000150000004856A473D21152C0BCF87D9A7B874440F66C6FAD121252C01C22FFF72086444066661A6BA41152C0680542D606854440C075AF3AA21152C090F8601C1384444010D1B2F8511252C0B01CE5C36084444010F098A5101352C04CA3C39C5085444012810005561452C0B083BA8A3D8644406C88530ECF1552C000E9E27635864440F4A7AC8AF61652C0187C6AC7DD854440A4A23679C31752C0B03589F80987444044322D42D51752C0608D0679C8884440BEA11EA5291752C0ACC4F6E6398A444012F9941ADC1552C0939012799A8B4440A51B5829C51552C01001F37C458D444064746069FB1452C07FFF8576728D4440EED3FE55A71452C0BBFED0F21A8C4440D8A3FF31891352C094CC2EA8C78A4440301D32CCE61252C0A8546BC9798A44405B7BAE68F31152C060B2EF39198A4440549451E6181252C06010E975D38844404856A473D21152C0BCF87D9A7B87444001030000000100000014000000164EEAE20E0552C0B4EF8DDF238C4440C6EC6C28720552C0181067A6BD8B44408097522A700552C0E89E1789B18A44405803D17C360552C064620FA19589444014AECBAC820552C057CA666CBA88444004C43E43F00552C00B78A789DE87444078AF03E2730652C0ACF4798AF1864440D823531F770652C07076D557A5884440667098BE900652C018585375698A4440D87D4DBDEB0652C0C051C7B1958B4440482F9108D60752C08085A239E58B4440F8E343A4B40852C0B403901CE18B44405E2362AD0E0952C05FD3A08E658C444056FCFAAFA00852C0405611310F8D444050154250330852C0A40137CAFB8D444038D38FA9620852C0F8B720A26B8F444058A67708FB0652C01026139EAD8D4440B841F9BDD80552C028C6580B0B8D44402A0E4402050552C0374631A1CB8C4440164EEAE20E0552C0B4EF8DDF238C44400103000000010000004E0100002E9FD128CD0F52C040B6D035569144400A1C7CD3A71052C0A0A97AE0009044402F9FD128AD1152C0AC13248BFB8E4440F4FF267E861252C0B0C5CF35828E4440ACF97BD37B1352C0B0F4258BE3904440A7B67CD3FD1552C0A85ECF359E8E4440D6C77CD3631A52C01CE8CF354E8844403E38E95A941A52C074D6B01EF88644408AC1D128991952C0543CCF3592864440D2C77CD3231952C0E893D0350A864440E7E3D128A51852C024337BE0B08544404C86CDA7FE1852C008027A3A078444408063C6765F1A52C074362C735E844440B03E517E971B52C050F67940E4834440B044277EFE1B52C0D793D0354A8344405EFB7CD3151C52C0FCAF258B0B824440C4AB277EE21B52C0A8A97AE0C0804440AAB67CD3BD1B52C0CFB2CE35227F4440D1C77CD3031C52C094F7CE35FA7D44406689277E961C52C0C82CD035E67E4440A4B67CD31D1D52C090F7CE357A8044403A70E86FDA1D52C0D0A4A0647D804440E46EAD153E1E52C0D05B183DC57E44402E9FD128AD1F52C0204FD035B27E44408CC1D128F91F52C03FB6D035967E4440FA9F37D3AC2052C0F80EE02F117E44405022277E522152C06F0AD0351A7E4440582102C72B2252C0CB9415F8C77C444082DFFBB8C92252C03C0ABC4CBA7B4440D80A7CD3C12252C01C337BE0707A444074C5D20EFF2352C05070597BDB784440DC4F32711F2552C054F24B8D6877444066A1363A5F2652C0DCDB42AB21774440FACC19846B2752C0102DBC7CBF764440924F7CD3F92752C03B6B258B33744440C2AB277E422752C038B6D03556744440725AD128952652C0E719CF3546744440663E7CD3F32552C0304FD035F2734440E8E3D128652552C0A8A97AE0407344404C947CD3112452C0C8777BE0C874444030EA7CD3CF2252C08471D0357E744440F8FF267E862152C040B6D03596734440107A594D162052C05C1DD0A4DD7244403AFBB431C61E52C0D8465C9DEF724440DD0A7CD3411D52C0C4E1248B837444404EE2CEE0CA1C52C08CE3C6F5BB754440EB717CD3651C52C0D4E1248B43774440924F7CD3391C52C0446B258BB378444022033AA5791B52C078B1718335794440FABCC79E1F1A52C0D8C408CFAE794440D2C8E85FB61852C028745639647C4440BADD31F37F1752C0549DA30F4F7F4440E4E3D128E51552C090F7CE35FA7F444056E8F202E61452C088765C94E67F4440FAA2AEFC8C1452C010A4BCAAC18044405D5569FD401552C08841E4F7ED834440603E7CD3931452C03CB6D0359684444082CDC1B2A01352C0136DB2138C844440BAC434E0471352C090CD1DB69A82444038EC47E8191352C0F88ACC9BC480444014066463491152C0F412498C4F80444052F2014CDC1052C024EF966AFA8144407207F69AE90F52C0185127CE41824440E2F921D6850F52C027E03EBCB88344408641639D5F0F52C0C4E6D942D6844440B95D5B17F50E52C09FB54FF2A385444046A265AAAE0D52C0486F744C18854440CA1BAFBFF30B52C0BC66B3432C81444048D51F5CBF0B52C0BC546EA78F834440EE717CD3850B52C0E819CF35068644408EB479EEAD0A52C0C8F8EE38408744404A947CD3F10952C0DC93D0350A874440A028D228DD0752C088F7CE353A82444032EA7CD38F0752C0D09679E0E0804440944F7CD3F90652C038D5CE352E804440C2AB277EA20552C0AC5ECF359E8044404206D228310352C0D4E1248B43824440BC607CD3BF0052C0A0F4258B63854440FC4AD22889FF51C07C0AD0355A864440D9FE84FC71FE51C023056E088E85444072B3FD335CFD51C0045ED297EC8544405657ADFB50FD51C0DFBD6787EC884440FEDE17DE7FFC51C0B08978A467894440CC3E1E46BDFB51C0D0AB757A4F88444031EA7CD3CFFA51C0B7C5CF358287444031EA7CD3CFFA51C01CE8CF354E884440D07F0DF093FB51C0BC2A4ACF158A444062F78FABCFF951C018A65D89D68A4440DE0A7CD301F851C010337BE0B0894440BE607CD3DFF651C030D5CE352E8944409CDD267E5AF751C0284FD035F2874440B0B58B57A3F851C0607AF091CF85444000E9651E7DFB51C0ACACFC32D8844440F6DE405D910052C03C3A6A03F2804440643E7CD3930552C0C89679E0E07D444098DD267E3A0A52C0F019CF35467A44401F2D6C38120E52C0F0044E657A77444096268E97491452C054737EA6B87244400B67277ECA1752C08426258B1B70444037E70FAF061A52C0334F3561586E4440A8B67CD33D1C52C01B337BE0706D44409F28D2287D1D52C0E4B2CE35226D44404A947CD3B11C52C0E0B2CE35226F4440C4AB277EA21C52C0F419CF3586704440C4AB277E621D52C05858248B53714440E4E3D128051F52C040B6D035967144400A1C7CD3C71F52C0FF80CF352A71444002D97CD3092052C0E0B2CE3522704440E8E3D128E51F52C0403CCF35D26E4440765AD128751F52C0543CCF35926D4440F84AD228691F52C0C02CD035666C4440EE717CD3252052C0D02CD035666B4440329FD128AD2252C0E019CF350669444006FBBDE7BC2652C0D86FF7FD91664440564E7C94152D52C0FC9999C459634440CC8B2D46552E52C0BF64B4199D6244408CC1D128D92E52C008E8CF358E624440924F7CD3392F52C0E8AF258B0B6344407EC3EC14D42E52C0401CDEFF896344409410D5BC6C2E52C0EC1AF2EBA163444099BD39DD6B2B52C010FED87A3F654440C07DBE0FA22952C0E8AA380313664440B0E55218782A52C0303C0BBC7F66444096A9910F7A2B52C0E49A70338566444042226773D22C52C088C20954586644404A12AA85862E52C03CEF19A565674440784BF1D29C2F52C0247227D6FE654440F66C7D8EF83052C0C847DB303E644440622C6F4E523352C0E0E255DB2F6444409CCB0D19FE3452C080FF802A156544404F22277E123452C0E8AF258B0B6444408EC1D128593452C08C26258B5B62444018837CD34B3552C0A013248B3B614440DE438125943652C050C30319ED5F444087BC86C2423852C05457E2A1725F44406080CD97E93852C0684FFA7000624440AEEE8D5E433A52C03C6B751B0F614440081C7CD3473B52C03F3CCF35D260444044F2D6A5983C52C02CFB004EF65E4440071C7CD3C74052C0204FD035F25F444049947CD3714152C024337BE0B05F4440805D8893234252C0D8FDEFA49F5D4440662AA25E844352C0945A5BD1565D444014B2822B554552C0E4499261C15C444018881DA7574652C060BDF6DE355C444008CA97C4574752C0D8341FB9305D444032D3EED1474852C0F09E5711755D4440E8A921E6FC4852C034A6EB59F55C44409C28D2281D4952C00881CF35AA5B4440004E7B1F4E4952C0607DCF9E445A44409FC506291D4A52C0600C9320915944409E28D2287D4B52C03C6B258B335A44403490AB47904D52C074858775525A4440D2CF23C5EE4E52C0746499E3745B444056E21348CF4F52C00BC90D29805A44408CC2AB9BC15052C04F12A65D09594440221690A7995152C040F38F51ED574440DE2750BC515452C0CC0BD5537F5744408E286767D25752C088096864C85444409DD75EF2BC5952C048741D24305444408213537A4A6052C00058A60469524440A71E5267E96352C0B81C2696AB514440DEBBF89B236852C0BC8C0690A44E4440D1372F022E6952C0701AB9806D4D44409C706689C86952C0B89B4F13F94C4440A07ADAFD846A52C02C10500A484D444019EFC780FB6952C0B0485C9FF04D4440AE1FAF5BF26952C054EA1AF31B4F4440E8B2E9B2BF6A52C064BD253B21504440081C7CD3876C52C010E8CF358E4F4440B05C34CC7F6D52C03443EF691B4E4440204529F6776D52C0A00E31B92C4C444068811038CE6652C0584C99060B4C4440D0E42BACD46452C0F0C7FA2EEE4B4440CE4F5F393C6552C0901DAB73D04A444048A3931C456D52C060264101994A44407062097D267052C0002D079BF64A4440927B12BC277152C070E3376E794B444078DBD777017452C0F4021BDAB74A44409C2AF05F6A7952C0982501B1FF46444012098E47207C52C0875C85E85E45444060E20F6C207C52C018CC1DDF19474440B82E2B636F7652C000D4866A5A4A44407C0198F38B7252C0D898335CD64C44407229418EAC7152C09CB12263284E4440EC83AB1D347152C010B825812C4F44408E02B1F05E7152C0E34C35E8C84F4440B4C1126DF97152C0C4B44EBA7F5044409A2F078B147352C0EC22BEEDAB514440D06B61B32F7452C0B4D3C0EAA35244407C411D7F177552C0649600800C534440F0373005807652C08C79ECC7635244405CB290379B7752C080690FF0EE51444036B56988247852C0900943E76C51444024D7AEE5827852C01F87F0C5DD5044401A837CD30B7952C0543CCF35D24F44409E00E1DB257952C0644C9D08A14E444078D95A858B7852C008360E39D94C44403EEBE93C2D7852C060720F1B824A44406085BFB2147952C0ECE6E903D9494440F4660500737952C06403C375A94A4440DAC09B705A7A52C04791E398B64A44400869A06E4A7B52C08C42EAA1B64A44406ED837A9A87B52C03C5A874AF349444076C70DE5427C52C08079581A8B49444090BA82723D7F52C0707D4F21E14844402BE381893E8052C080CF50CF07494440E2389343BF8052C0C0E43F1E264A44400714AC620B8052C00C3E25A5A84A44404AE62EA8E07F52C0A8558E12794B4440E6362A35508052C00CE5FC75704C44408C5065DEEB8152C008C815F3804D4440B0CF26318F8252C06C079123554F44400C1DF71D4B8252C078CEF424C65144407CFD6C1E868152C0B864C6FC185344405CF08C5DD28052C07CB086E41455444010B8B69CFD8052C09351D345C2564440863CC4CA1E8052C044E7011556584440AF8EEC42DA7F52C0FC743D6419594440EE717CD3657F52C0443CCF3592594440AAB67CD3BD7E52C01C337BE0305A444052BBB397097E52C0B807E34CB85A4440C6067A57667D52C0DC93C8C4C15C444092A347263C7D52C07091073E205F4440848A52F1887B52C0DC9186A1F56244403E72FF7F267A52C0E85F9F61F364444032355E27C67852C0E0B646E3D4634440424D1B0BB37752C0F4B796D322644440AE4BC054187752C09837597A5F6344407140A1EAAC7452C004A8DE9E10664440BC89D6F4DA7152C0AC13A30A66654440FBD24E3F7B7052C0183409C5B36244409EA1323D027052C070132BD34A654440D9E4BEA2E97052C0A89BBE1DAF6744409ADD267E5A7052C067EE7AE0986A444089C1D128596F52C0F3AF258BCB6A4440382D7CD3AD6E52C0AC13248B7B6944404A947CD3316E52C038B6D035D6674440AAF97BD3BB6D52C0CFE1248B03674440AAB67CD3FD6C52C03C6B258BB3674440964F7CD3996C52C0386B258B336944405F3E7CD3D36C52C0386B258BB36A44400967277EEA6E52C08C71D035FE6B44402E9FD128CD6E52C0AB5ECF355E6D444076A57CD3176E52C0CC9679E0E06E44407A78AFBD236D52C0B03CB47BF16E44407A14AF91286B52C040185727AA6D44406A5547CB976A52C01F0AA265526B44402BEA7CD3CF6952C060A3CF3576694440C0A69AFB596952C0A4CC9BD7596A4440B481B3A8D06952C0C0ADB298136F444038B4576B7D6852C0682F999F25734440CC96C4702D6452C0802C9ACE0E75444066310C464F6152C080B94DFA7375444030EA7CD3CF6052C0680AD035DA7344409ADD267EFA6052C0A8A97AE040734440ECBB5EA4D46152C03C1959F5237244400A2803569A6252C09023D3719A7244401676BB6B246352C014FDD0CF0B724440180DC3213D6252C00FB598DF767044402F8045EBB96052C0ECDE11FC4C704440EE2985489F6052C0A8015C6D5E714440B6D1170D7C6052C088727DBA6272444075AE9BC4935F52C0EC7CECC62C7244408ACC9F468C5F52C01776BBB2D970444016A89081B55E52C0248FDC8B497044400AF748853C5E52C01C2E0F6CF1704440C849BA296F5E52C0CCF369BA037244405EFB7CD3F55D52C0E3B2CE3562724440F4FF267E065E52C0985ECF355E73444032EA7CD30F5F52C08071D0357E754440B4BF11429F5F52C050EA17A8A9764440FFE1A47F155F52C0EC4947430A79444088CE6AC8925D52C0308F1C60DB7744409CDD267E9A5B52C050A3CF35767744406889277E365C52C05058248B13754440FA4AD228A95B52C038D5CE352E744440F4FF267EE65A52C0A8A97AE04073444070F442DEEB5952C0686D50CBB4734440C0607CD3DF5852C060A3CF35F67344409E28D228BD5752C05CA3CF3536734440382D7CD3ED5652C0A8A97AE040734440603E7CD3B35652C0B0C5CF3502754440063AA5AC145752C08009D96F6976444050EFFCE4405852C00CA308D95476444020BD3889925952C09007751A74764440AAB67CD33D5A52C014E8CF354E784440E8D4CEC3185A52C04FA1279D3C794440D043B53AB95952C04CF27EEB297A4440B71A66894A5952C0103F22BA287A4440E00935574E5852C07895B1B837794440A8C469ACF05752C0B86E2141D1774440F6768D21765652C094E1A04D2677444053D8FE8EDB5452C0084A5FE2F1764440BCAAC687C35252C090D395B15C764440DA2CFD02DC5052C04855389BF17444408CC1D128994F52C0C4E1248B837444402EEA7CD30F4F52C03B6B258B33744440BE607CD35F4E52C0B8C5CF35427444402FEA7CD36F4B52C0D8B2CE35A2754440705AD128354A52C04C3CCF351277444098DD267E7A4952C0E893D0350A794440061C7CD3C74952C0304FD035327B444002D97CD3A94852C058A3CF35F67B4440AAB67CD33D4752C0740AD0359A7C44404A947CD3514652C064EE7AE0187C44403CBB267EAE4652C02C4FD0357279444078A57CD3D74552C0A0F4258B63794440DC0A7CD3414552C010E8CF35CE7944404106D228114552C02F4FD035B27A444006D97CD3694552C0503CCF35127C444070D21CD5E04452C0D898A1AF687C444088BA56A8194352C0409B6813447B44403FC9D2F1924052C0B44E04D4C87B44406AC3DDC39F3952C0A473C6F04B7B44409E9B8F2E203552C0A0A9F3EF0D7C4440D3BD8FE2FD3152C0841415BB877B4440D2CD33C68C2C52C0D88486FB917D44406A89277E362852C0C82CD035E67D44400A67277ECA2652C050A3CF35B67E444004773E6EA52252C0741CEC780C834440FD32B38A2F1E52C0B4C7B47829874440E7A6C6110C1D52C0F077C3B8868944403C61EEC57D1C52C0CC3A8018FD8A4440120209556D1A52C0EFD826F47E8B4440D6C77CD3831852C020337BE0F08D4440725AD128F51652C0D4777BE0C89044409ADD267EFA1552C0ACA97AE000924440F4FF267E861252C0D09679E0A0944440C2AB277EA21152C03C207AE0D0944440D4C77CD3A31052C044B6D035969444405622277ED20F52C038D5CE35EE9344407AA57CD3770F52C0E093D035CA9244402E9FD128CD0F52C040B6D035569144400103000000010000001300000092A842FC16FE51C0FCC5100D06A344400F083FC740FF51C000D5237A4AA1444088F80640EBFF51C09B81429836A044401DDE72A9750152C008E3384172A04440A6B043A97B0252C077E1A3DFED9F44409695170D570252C01CBEDE0764A144402EA235B8AD0152C060CB55E729A24440B6AC7F936A0152C0C8945B1670A344404CA01AF2B90052C07FC26DC85AA34440E6179016370052C038018D792DA244403EC72A7FE0FF51C0B846931E15A3444066DD25C29DFF51C0B4505BFF3BA44440B589620B84FE51C0184BAD3E71A4444080A05E810CFD51C0C0A55EEFB2A444400C5068F924FC51C0509B8DB666A544400C6E4B47EDFA51C06036EB7A4CA544409A15525D64FB51C0F481DEE117A4444022B01BB194FC51C0C8A1A19366A3444092A842FC16FE51C0FCC5100D06A3444001030000000100000010000000A070D28169BA53C013941679BD844540A6105CEBB7BD53C02CC43374FA7C45403A7ADD77D4BE53C0D41CF343517D4540CA201623E0BF53C0BC3E77BDDC7E45409EA4C2CFC2C053C0D0F933CC8E80454022B9463369C153C0E71D9D5B59814540247C8F147AC153C0476854902D8245409A1E310DA1C053C0BC9B6FD282864540E407C893BBC053C0F4EF64765B88454050DBFD258EBF53C0D8624F66788845402EE828306FBE53C0582EF925EC884540722E49B25EBD53C07CC731BB12894540BD37B2155FBC53C0F4EF64765B884540F8A243ACB6BA53C04C7F5F9C7D8745409864AFFC25BA53C043DCE89752864540A070D28169BA53C013941679BD8445400103000000010000000B000000BAD3CDDB760F53C00456942D9CFF4540E16919D6C01153C0B4DD35FAF8FC45405229A010F11153C0A451CA011E0146406AAA929B901153C020B4C740790246406A071C97651053C05CFC995F0E04464096C02609720F53C0BF465194E2044640FC56A57C550E53C0431E1ED9990546407C7FD8379E0D53C060AB33E97C05464082C8B2DBD00D53C05CFC995F0E0446409AEC1B6B9B0E53C0409E664C31014640BAD3CDDB760F53C00456942D9CFF4540010300000001000000120000006E368F7A9A0453C0F4D3220A0A28464064672314460453C0DCAFB97A3F274640A707E0F62D0453C0A40A5E60D5264640147E8C8D2B0453C094F217564E26464024F06EF8AA0553C0904FA15123254640E4959F1E190853C05864582E63224640CCB72398A40953C00026C47ED22146406F96742A1D0A53C080F16D3E46224640731C06ED3E0A53C0A021FA52542346409AA91BFD210A53C0A8C470577F244640B0B09F4AE30953C0985BC4D666254640E275CD41330953C094F217564E2646401CE15ED88A0753C0AC1681E5182746404CE343EEC90653C0F4D3220A0A28464077A871E5190653C0B422A46A5C274640FC563663840553C013551595A927464034653EFE060553C08F20BF541D2846406E368F7A9A0453C0F4D3220A0A2846400103000000010000002200000044C9DC2DCCFA52C0444B463F762F4640F4FC2AE9BAFB52C0802BA7DB292D4640DA128CDD02FD52C0183E79A22A2B4640BEAE7E946CFE52C0DBF5A683952946407C2BA7F38DFF52C0A84428E4E728464024F6482E640153C00CB29E907E264640A84784B0F90153C094F217564E264640FEC2CF7E790253C09C958E5A792746406C763334660253C0F46A7689F1284640DAAF28AC740253C040343B33262A4640D683334A4B0353C078D9964D902A4640D683334A4B0353C008BD86178B2B4640EA7E9412C90253C02856BFACB12B46406C763334660253C02856BFACB12B4640D0E0BC45200253C0980923629E2B4640A84784B0F90153C008BD86178B2B464008EFC4E0A20153C0F853DA96722C46401BEA25A9200153C0076C20A1F92C4640BBE848187F0053C0589E91CB462D464082748197C0FF52C0589E91CB462D464086FA125AE2FF52C048864BC1BF2C464087BD5B3BF3FF52C028ED122C992C4640180AF885060053C028ED122C992C46406AB6D7ED310053C020E1EFA6552C464082748197C0FF52C008BD86178B2B4640961546FF45FE52C08465715F3C2F46407EF1DC6F7BFD52C074FCC4DE23304640480FCA3622FD52C00C0F97A5242E4640D9B8EF7C0AFC52C074FCC4DE23304640C61A18B061FB52C0CC3A598EB430464016AA12D683FA52C06B87F5D8C7304640AC33663F86FA52C0BC2213842D304640F61CFDC5A0FA52C0DCA3050FCD2F464044C9DC2DCCFA52C0444B463F762F464001030000000100000057020000CEC4031695B752C0D4E93AAD4B814640E65034AC75AF52C0287BAF87DA7F4640D27CD128A1AD52C0D848258BE77F4640BAD1263889AC52C0D89BCA6FBF7F46402FAFB5BA26A652C0E07B3BADCE7F4640A48C443DC49F52C040B9299CDF7F464038E7342C629952C07B7398D9EE7F4640081C231B009352C0A8D688C8FF7F4640BC63120A9E8C52C098B6F9050F8046401054A28C3B8652C0F8F3E7F41F804640E288907BD97F52C0FFD358322F804640387920FE767952C017374921408046400AAE0EED147352C09074371051804640BCF5FDDBB26C52C08054A84D6080464011E68D5E506652C07034198B6F804640E41A7C4DEE5F52C0E871077A8080464058F80AD08B5952C0D85178B78F804640D6FF5E5E7C5652C07853D5D5978046407251FB4C3C5652C0D8CBB0881A7F4640A62D94E6E95552C0308EB188267C46407E57FB4C965552C018C37C55477A464061A294E6875552C000D77C556B7946405A81C7198F5552C0E0D44B2268784640567061B3CA5552C078554A22B8764640AA112D80075652C0306BE3BBA9754640F23261B34E5652C0C013B088D2744640D537C7195F5752C0C88A4B224C7246401A00FB4C9C5752C078A94A228C714640F455FA4CF85752C098ACE4BBF16F4640EE57FA4C145852C0B8A7E3BB2D6F4640940F94E62D5852C0088617EFB06D46405A57C719255852C06F7B7D55E76C46409FBD94E6095852C0E45F18EF0C6C4640B296C719BD5752C0B899E4BBF16A4640DE5A94E6735752C084AC7E55376A4640706C2D80275752C0975EE4BB9D694640DEEE61B3F45552C0A8E74B22B4674640242961B3C25552C0789F4A22206746407EA7FA4C9E5552C0C4454B228C6646408C6FC7198D5552C090CE17EFE8654640701361B3885552C0581EE6BB096546403EEF2D80955552C0E75D4B22F463464073C3C619CD5552C0988C4A2220624640ADCA2E80015652C068447F55F3604640D9502D80995652C0F0C7B288565E46403AABFA4CD05652C0E817E6BBC95C4640C880FB4CE85652C060CD4A22E8594640E2462D80075752C0246A17EF68584640A00D94E6115852C008F1492284534640940F94E62D5852C070F8B188BE524640E82CC8193D5852C0A0C9E4BB0152464062C893E6255852C0E86C18EF304F464006BE60B3AA5752C074624B22904A4640F4B6FA4C785752C0E44E4B2278494640B083FA4C945652C030D417EFA8464640129D60B3DA5352C0C81DE3BB0540464082D860B33A5352C0845AE4BBFD3D4640DA7061B3DC5252C0E87DB1881E3C4640AED060B3CA5252C078494B225C3B4640B48061B3C25252C0B43C4A22283A4640EE382E80CB5252C0688F17EFF4384640E25DFB4CFC5252C05CE24922143746403C2294E64D5352C07B494A22F43446409E09FA4CB45352C0102E4A226C334640BC42FA4CEC5452C0545FB0880E3046400E2CFB4C225552C09C42E5BB552F46401EDA60B34A5552C0B0AEB088922E46406603FA4C545552C0C07517EFA82D46401EDA60B34A5552C0300216EFA02C4640E8172D80675452C0F0AE4A22E42646401D9C61B34A5452C00CBB4A22982546404ADA60B3505452C0A055E6BB15234640703D2D80875452C0784B4C2258204640811761B3C65452C030B74922F81E4640621D61B31A5552C0179C17EF0C1E4640567061B3CA5552C060FC7D554F1D464068E994E6895652C03C147E55AB1C4640C5D960B33E5752C0342DE4BBE51B4640349BFA4CE45752C0B4D04A22F81A4640E809FB4C285852C0E8D515EF601A46409E16FA4C605852C0B0ACB288BE19464034ADC619815852C01CB3E3BB051946402AD293E6B15852C0107F7D554F164640481D94E6F15852C0D035B18896144640981AC819295B52C088D7E5BB490A4640BE7594E6E95B52C09C7D7D556B084640407AC719115C52C068437E55A3074640407AC719115C52C03FF216EFC006464028DFC719C95B52C068B57D559F054640809194E67D5B52C0C07A4B22E8044640BC3FFA4CAC5A52C0E4EEB1884E034640B13894E6795A52C0C09A4B22C0024640303461B3525A52C04FD24B22E801464021A0C7193D5A52C0082A7F55CB0046405AB194E64F5A52C0903EE4BB4DFD454075EA2D803F5A52C0ECAFB0885AFB4540D19394E6A55952C04843B188C6F54540800194E65D5952C0CF04E4BB29F44540BBB0FA4C185952C060B515EF14F3454060A6C7199D5852C0E824E4BB01F24540E44894E66B5852C058654A2278F14540C67961B34A5852C05CE2B188DAF0454062EB60B33A5852C018D27E550BF045400C302E80375852C018054C220CEF454080C394E65D5852C0D8D8AF885EED4540F03C94E6BD5852C0D85CB1885EEB454023D493E6CD5852C0DC044B2298EA4540A2F22D80BB5852C0E08E7D55D3E945403BB361B38E5752C0CF2EE4BBB9E64540248B2E80635752C0F8C2E2BB21E64540080CFB4C4A5752C04C0E7E551BE54540548C94E6415752C02862B188C6E34540E3B194E6615752C030047F5517E1454018362E80915752C0C83A7E55B3DF4540DEFBC619ED5A52C08075E4BB01D34540420695E61B5B52C0D41AE4BBE1D14540C4B1C719395B52C0F845B18872D045406EED93E6335B52C0A8D6AF88AECD45404A6E60B31A5B52C0E8204A221CCC454076892D80BF5A52C050824C22A4CA4540FEEC60B34A5A52C088527E555BC94540DAA360B3265A52C0B00D4A2210C945408AE62D80075A52C0CCDE17EF00C9454028CB94E6C75952C05C25E5BB19C94540D24294E6115952C0F485E3BB91C9454008FCFA4C5E5852C060BA492254CA4540929CC719115852C0A0C116EFD4CA4540548494E6CB5752C0CF984B2268CB45401A00FB4C9C5752C0E8204A221CCC45407241FB4C505752C0C0D0B18856CE4540751C2E801F5752C090BE4A2200CF4540FF15FB4CDC5652C0E059B18896CF4540DA3661B3865652C020AF7D5503D04540A21C2E80255652C083417E554BD04540AC08C719B95552C094F8E4BB75D0454072D4C719455552C0782717EF84D0454090882D80C75452C0C0B0B1887ED04540FC97FA4CC45352C0A042E4BB29D04540E56661B34A5352C08CE618EFD8CF4540041162B3EE5252C06792B2884ACF4540888760B3A65252C060DA4A2294CE4540D8B694E6BD5152C094D516EFF8C945407C5361B3385152C0582D4A22DCC845402AF793E6E55052C04830492288C84540355694E6495052C020E57E55AFC745400CB42E80CF4F52C000D14B22A8C645401CE6C619D94F52C06838B188DAC34540EA00C819DD4F52C034D67E55E7C24540F2C193E6E54F52C0F07DE5BB3DC045404EDFC719F54F52C038397E551BBC45400229FB4C085052C0607D19EFBCB64540269F2D801F5052C0543B7E5563B04540441E61B3385052C0F429E4BB4DA945407EF0F94C545052C0E052E4BBB9A14540AAE9FA4C705052C0A430E4BBE5994540A65CC7198D5052C0807FB0881292454090EDFA4CA85052C0EC784B22808A4540BCDDFA4CC25052C0708518EF68834540541BC719D95052C060D2B0880E7D45400BF42D80EB5052C098F8E4BBB17745402A1A61B3FA5052C0D042B1888E734540A43AFB4C045152C078EA17EFE4704540C8FE2C80075152C0686A7E55F36F454029CC61B30E5152C0F4A07D558F6E454081CD2E803B5152C074A2E3BB796C4540627C93E6ED5152C017AF7E55F3674540525E6FA7705252C0084BB0611266454076C727DFAD5152C0889C6297805F454042AC8635FE5052C030DA8FDC6F5F454057A0FA4C465152C0D8FE7D551B5E45409A7194E6D15152C0C0327E55175B4540B00EFB4C7E5352C07C41E4BBD95145408EB460B32A5552C00B6EB1889A4845402C8A2D80D75652C0A89A7E555B3F4540C25FFA4C845852C048A9E4BB1D3645405A35C719315A52C0E8B74A22E02C4540EA99C719DD5B52C018F615EFA0234540806F94E6895D52C03482B188621A454016D494E6355F52C0D49017EF24114540E2E6FA4C106052C058F2B0886E0C45406EC561B3766052C0485B4A221C0A45406C40C719C15E52C00F257D55FB064540CC5B60B3005F52C098B5E3BB0D014540646EFA4C405F52C0B887B18822FB444004F260B3805F52C047A74B2234F544409E75C719C15F52C0882B492248EF444086C9C619016052C098AAB1885AE94440A414C719416052C0CCBDE2BB6DE34440362761B3806052C0C03C4B2280DD4440A4B3C619C16052C0742017EF94D74440BEFEC619016152C014B17D55A7D14440CED8FA4C406152C0C0237D55BBCB4440C49DC619816152C0544317EFCCC54440DCE8C619C16152C0F826E3BBE1BF4440AE632E80016252C008A64B22F4B94440CCAE2E80416252C037B97C5507B44440F6D2C619816252C03038E5BB19AE4440141EC719C16252C0F81BB1882EA8444000AFFA4CDC6252C0207A4B22C0A54440142EC719AD6152C03CCD18EF98A244407A4895E6C76052C0F0FA16EF38A04440989A94E6F15F52C00CECE4BB019E4440DA852E80FB5E52C0D00519EFE49B444076E72D80FF5F52C060937D55BB9A4440684461B31E6352C064CCE3BBCD97444088FC60B3FE6652C0A377B288269444400C88FA4C8C6A52C094904A22D0904440104D94E65D6D52C0D37918EF288E4440AA3BC719456E52C0E4407F553F8D4440DEC760B3EA6D52C02CBA15EF548C4440E6022E80616C52C0145AB288A2884440BA852E80CF6A52C0384DE3BBDD844440EAD493E6996A52C04033B2887E8444403C1694E64D6A52C040FAE2BB2D844440C0822D80276A52C0F0374A22F8834440A2902D80F16952C01824E5BB8D8344408E9C2D809F6952C007CF7D55738244408A636585706952C0B02D3EAF9381444002F423A9246952C0B444A8F422804440A9B67CD39D6952C02004258B8F7F44408EC1D128796952C068557BE0FC7E44402C9FD128CD6952C050A3CF35B67D4440FE4AD228296B52C090F7CE35BA7A4440623E7CD3536B52C060A3CF35367A444074A57CD3B76C52C060A3CF35367A4440A028D2287D6D52C077557BE0FC7944409CDD267E1A6E52C074BF248B3779444018837CD3EB7052C08471D0357E744440CC7CD128C17152C0344FD03572724440904F7CD3197252C0E0B2CE35227044404406D228717252C043B6D035966F44404C947CD3317352C0D02CD035A66F44405222277EF27352C08871D0357E6F4440FE4AD228497452C030B6D035566E4440B01C0E69797452C03858F89A686B4440DE8A9515867352C07855DE30BF694440CE98A7450D7352C0D4310DBB16684440580DB1431A7552C09472477ECB674440F07C6D006D7752C04097B04AEA67444064A2C88D347952C0F848BEAAE46644404406D228517B52C0CFE1248B036744400A67277EAA7B52C028B979E0AC6844400A67277EAA7B52C027B979E0AC694440BF607CD33F7B52C0BCC5CF35026B4440765AD128957A52C024B979E0AC6D44400C67277E2A7A52C020B979E02C6F44400C67277E6A7A52C04CD2258BD7704440C0607CD3FF7A52C0C0C5CF35827144408AC1D128797952C0780AD0351A7744402C9FD128ED7852C00817268B6F7C4440FAFF267E067852C048877AE0B48144404A947CD3D17752C014E8CF354E8444400A1C7CD3C77752C0D793D035CA8E4440EAE3D128057852C0985ECF359E9344405422277EB27852C0C0C5CF3502984440603E7CD3537952C0B4C5CF35029A44405EFB7CD3157A52C01804258B4F9B44404006D228317C52C053877AE0349E4440BE607CD33F7D52C08871D035FEA04440EC717CD3057D52C00081CF352AA344409E28D2287D7C52C0988D258B3FA54440D17CD128A17C52C0503CCF35D2A744405122277ED27D52C00481CF356AA644405EFB7CD3757E52C0D42CD03566A54440964F7CD3D97E52C0483CCF3552A4444002D97CD3097F52C0C4C5CF3582A24440AEF97BD3DB7E52C028B979E06CA144404106D228917E52C0AC5ECF355EA0444078A57CD3177E52C0EC93D0350A9C44406C5855EDA27D52C0B86A1656549A4440B4D53927F27C52C0C8FF36C83A98444026492425AB7B52C0B419E984D1964440B044277EBE7A52C038D5CE35EE9444400A67277EAA7A52C0D42CD035A69244401A837CD3EB7A52C000CC7AE00C8D4440D80A7CD3017A52C06C7479E014824440E886497B0E7A52C0747193F2D27E44407CBFFA4C628052C054CCB188AA8444403E1FFB4CB88652C0CC187E55838A44408BB761B30E8D52C038D616EF5C90444094E7FA4C649352C0F810E5BB359644402A50FA4CBA9952C064ECE4BB0D9C4440F2AFFA4C10A052C0D0A97D55E7A14440085160B366A652C08FE44B22C0A744407A6FFB4CBCAC52C00CA2E4BB99AD4440067B94E615AD52C004AE17EF24B04440B0FD60B312AE52C0D4DBB188E6B2444005BA94E6A1AE52C0F0F3E4BB25B44440CCF0C61921AF52C0E43F4B2238B6444026C761B376AF52C0E47D4A2238B7444052DA93E6F1AF52C084DF7F55A3B74440C4BEFA4CACB052C09B297F5557B74440646593E64DB152C0248DB288E2B64440C29493E6F9B152C0C0217F55E7B64440DA3094E6CDB252C0985E18EF08B844401E37C7190BB452C0A8537E5533B94440DEA5FA4C2CB752C0B04A18EFE4B84440EB55C719B9B852C058107E5563B944408C44FA4CA0B952C0E8E64922A0BA44405671C71941BA52C0331B4B2210BC4440FC5DFA4C0CBB52C088C87D5543BD4440BA13C719E7BD52C0E0947D5553BE4440D65F2D80FFBE52C0586F4922C8BF4440621CC819DDBF52C0B786E4BBC5C144401C84FA4C18C352C0C8954A2248CC444058942D80E7C352C0901318EF7CCD44404C482E8017C452C0307E7D55CFCE44403AA22D80B1C352C0F08DE3BB69D544402AC094E6AFC352C00340B2880ED8444052972E808FC452C000607D55E7DC44400828FB4C5CC452C0AC8AE5BB19DE44406889C7197DC352C0BCCD4A2230DF4440D549FB4C4AC352C090BCE4BB65E04440788E2D8093C352C09CA24B2230E344406C04FB4C58C452C0A097B1885AE44440EC8561B376C552C0885618EFF4E44440B8E7C719C9C652C09728B1880AE644408063C71951C552C094A9B088CEE844404C2D2D800DC552C0B092B188FEE94440167FC719DFC552C0E04619EF7CEA44408AE760B37AC652C06C5918EF08EB4440BAF993E665C752C078A27F556FED44403C96C71923C952C0A7E64A2264EE4440965361B38ACA52C068237F5533F04440D9D460B35ACB52C09884B0889AF04440BCCB2D80E3CE52C0F4E57C55BBEF444010B694E6F1CF52C048A5B188F2F04440724DFB4C50D052C017F618EFC8F344409E07C81975D052C0F060B188FEF6444056E994E6D5D052C010CE4B2258F94440229BFA4C30D252C05C7F7E55C3FA44409876C71931D452C0F08F7F552FFC44408ACA2D80B9D552C07CE47D55F3FD444010B394E6B1D552C0904BB188AAFF4440A2BD2E807BD652C0904BB188AAFF4440A87760B3E6D752C0B09E16EFACFF44403AD9C7199BE052C0C80FE3BBADFF4440AAB4FA4C50E952C0BCB018EFB0FF444089E6FA4C04F252C0C892B188B2FF44406C89C719B9FA52C058B6B188B6FF4440929461B36E0353C080984A22B8FF44406CC661B3220C53C0A05C7C55BBFF4440DCA194E6D71453C0801B19EFBCFF4440447DC7198D1D53C0A0DF4A22C0FF4440EEB7C619412653C0B0C1E3BBC1FF44408E8AFA4CF62E53C058E5E3BBC5FF4440FB652D80AB3753C068C77C55C7FF4440D6972D805F4053C05768B288CAFF4440BE3AFA4C144953C0674A4B22CCFF4440E64594E6C95153C09F0E7D55CFFF4440C07794E67D5A53C014DF17EFD0FF4440B68B2D80336353C0401416EFD4FF444048ED94E6E76B53C03B447F55D7FF4440A857FB4C9C7453C04097E4BBD9FF444090FAC719517D53C068EA4922DCFF4440FAD5FA4C068653C0E82BB188DEFF4440A810FA4CBA8E53C008F0E2BBE1FF444048E32D806F9753C0F81F4C22E4FF4440B2BE60B324A053C02073B188E6FF44401229C719D9A853C034C616EFE8FF4440FACB93E68DB153C0CC077E55EBFF44409A9EC71943BA53C0D05AE3BBEDFF4440FB082E80F7C253C0D8FB18EFF0FF4440E3ABFA4CACCB53C0EC4E7E55F3FF4440CB4EC71961D453C008A2E3BBF5FF4440E6E894E615DD53C088E34A22F8FF4440CE8B61B3CAE553C0B036B088FAFF4440366794E67FEE53C0C0A77C55FBFF4440CEA72D80D3F053C0C0A77C55FBFF444056E093E6D3F053C0D0CCE3BB5104454056E093E6D3F053C0E4DF7E550B08454056E093E6D3F053C098E6B088C60B454056E093E6D3F053C0BBDBE4BB810F45408D4861B3D4F053C0D05F4C223C1345404C78C819D5F053C078F5B188F61645404C78C819D5F053C02B8B17EFB01A45404C78C819D5F053C0CFAFB0886A1E45404C78C819D5F053C0F4A4E4BB252245404C78C819D5F053C0D4C050A05E224540771E29131DF053C08CD6AF3CD02245406EF5204CD0EE53C0BC1E825B652445409CDA202006ED53C09B34E34FAD2545408CC8B44B38E853C080CAFBD05D2B4540D86E4B64D9E353C0BCA9216FDA2D45404405CAD7BCE253C058A557435C2F4540D87138FFB5E153C000ADB09C21314540363C38A721DE53C0F77DCE9F1B34454085CE1F6820DB53C0C892F4952C3A4540DB40354C39D953C0D3418E1F9B3B4540552CB1E892D853C0F4711A34A93C45402101C40B07D853C0433BDFDDDD3D4540A2351A4C93D753C0A3859612B23E45408E97427FEAD653C050EA78674C3F4540FEF3F66EBBD353C064B158FB414145401AA4CBF660D053C0B4B4E728894445405EDEC8F30CCF53C0EC9F304C49474540D01D98A1D4CA53C0781A74952B494540D4498D03FEC953C0B8CBF234D9494540A6677ACAA4C953C0C7E3383F604A454041E00B77E1C853C0485E7C88424C45408B262CF9D0C753C00F2192F0B94F4540600762A188C753C02039D8FA40504540541B11F92AC653C05CF6791F32514540E8877F2024C553C08CC97C386B53454006AFD54ACBC353C0E07BA5EF205845403394D51E01C253C0287F341D685B4540C214F39D9CBF53C0042CE990975D45403C43008F9EBA53C0E87B1409F26045405C2D9F9A56B953C010B8C3A243624540CD49AFD05BB853C0E04C320CEC63454001D225A9BCB753C04C4683CA2E664540D175A43285B753C0288A8BBD45694540D175A43285B753C01C5BA9C03F6C45404672E28BA4B753C0DCD7D11F616D45400ADE482E00B853C05446F2E3FF6E45408040466D5BB953C0008815C1D7724540AE2259A6B4B953C0B81061A53C7445405201AA382DBA53C054802B81E37945407E20749075BA53C0D857F8C59A7A45403E60E5D0A7BB53C0A8EC662F437C4540D4F55BBFEDBB53C064698F8E647D45403054C24B64BB53C074C7C2A14180454074F76BC928B953C084B026AFC28345406A280063D4B853C04CE80B1D968645403A80B7AD8DBA53C0FF9EFEFFC98945402AC569B8ACC153C0E0B45FF4118B454077C208BF2CC453C0AB5B7C91888D4540D7530E6D2DC453C004FB64098E8D4540D5C3C60B35C453C0E076CBEF638F45400A326F59EEC353C038583F4AAD904540DE620EAD8EC353C01F5C72FDB79145408666907B4DC353C0802DDB00CC92454037F8B53A28C353C0F8666CE075944540DCF841601CC353C0A46CCAEFD69545408864EC0A71C353C06859F56853A1454084B11F3EBDC353C04091F5E88EA345401E8D2F9EC0C353C0C8CDCA119CA345402642C59067BF53C0E09043B1BAA44540A29391F92BB753C0C48F08B383A94540DCAA606544B053C07897610C49AB4540E036CC5D1FAC53C06C687F0F43AE4540B32634F3549853C0B80E8541B5B245408AB981A6868E53C0B4D4BABDA2B0454016239419D28653C0B00262BC71B24540EABB4CE9EB6F53C0D8E118411DAC454024EA2661546E53C02865F0E1FBAA4540FAD67F8E4F6E53C0A802F3A2A0A945405E9E929BDE6C53C050C45EF30FA9454078E2CD078F6C53C090DE8913D6A8454028B63613FB6753C077A31578BBA24540A62A310D536553C07C756E79ECA04540D82F03BE6E6253C0344F20D4E2A045405ACAA9CA655A53C0A4823B1638A5454042A92DD6775753C0A3198F951FA64540DE36CBA5EB3E53C0443884E163A44540C4F28F393B3F53C0582223ED1BA3454082151C38643F53C090302B889EA24540265D194BF53E53C04B738963ADA145403A587A13733E53C060E8586909A14540287DEB27DB3D53C058DC35E4C5A04540A36867C4343D53C0344F20D4E2A04540928DD8D89C3C53C0838191FE2FA14540D02D95BB843C53C0988DB48373A14540FA403C8E893C53C0780CC2F8D3A14540A6D113454D3C53C090302B889EA245405CE87CBE323C53C088BB5B8242A34540EC341909463C53C0A0DFC4110DA445403A981ECD3E3C53C0E79C6636FEA44540BC8FBDEEDB3B53C0A3198F951FA64540B2C05188873B53C084989C0A80A64540420A921EED3453C034AC18E988A8454069A9A4E9CC3053C0C0BDAFB152AB4540CC50E519763053C0CFD5F5BBD9AB4540BFBE30D2103053C0DC848F4548AD4540C827DD52292F53C0372CD075F1AC4540D90559D99D2D53C008E4FD565CAB4540301ED25CBE2A53C0F7BF03E162B345400A4BCF43852853C03CC3920EAAB645402492F74A122653C05015A39C43B945408E05482D621F53C0A3C7CB53F9BD45401329DCB0281E53C0B47665DD67BF4540F075AB74D51A53C0C80E637457C44540A46F2FACB11953C01841D49EA4C445402AE429A6091753C078459ECA22C345405C4FBB3C611553C0F879F40AAFC24540AAB89A36131153C020B6A3A400C445400A063F06C40F53C0204DF723E8C44540459DC5FE440D53C0B4194BFB63C9454046370619090C53C0C8D4070A16CB4540C82BB89FC90D53C0584F4B53F8CC45404CE69FA2770D53C0288730C1CBCF4540F4AAF88DC30A53C09B69E58C8FD5454038E208F0920B53C06B67007750D6454094A62E62450C53C07FE8F201F0D545403A0B11B7DF0C53C03B1F2E58BBD445407636FE936B0D53C08817D5FEF5D24540607854EADC0D53C044C2A45CE6D545404271D09C1B0E53C01406AD4FFDD8454088118D7F030E53C0778A2E08E4DB45407636FE936B0D53C0A46954A660DE4540CAEE0081DA0D53C0D4B126C5F5DF4540282D95306B0E53C0E89A8AD276E34540421447A1460F53C0147AB070F3E5454068EA36555C0F53C0A45DA03AEEE64540FE738ABE5E0F53C034419004E9E7454004BD6462910F53C077FE3129DAE8454080027D5FE30F53C01C63147E74E9454050C3E02AB51053C06020B6A265EA4540AAB89A36131153C0008598F7FFEA45405BAF31D3121253C080E795365BEC454032F62661061353C06872C630FFEC45401A7534D6661353C068091AB0E6ED45406E8AC0BEAA1253C0201D968EEFEF4540E42C62B7D11153C064E65A3824F14540789CBD79A70E53C098B95D515DF345408A774C653F0F53C083674DC3C3F0454004BD6462910F53C0201D968EEFEF454082C8B2DBD00D53C024EFEE8F20EE4540907A39001C0D53C0201D968EEFEF45400A69A237520A53C098B95D515DF34540E6FB5E04550953C0FCA68B8A5CF54540DEEF3B7F110953C02CEF5DA9F1F645404EA39F34FE0853C0683730C886F84540CED7F5748A0853C034D8C1B672FA4540AEF04304AF0753C0C8C7D405B1FB4540FD197F44950553C0E4DF1A1038FC45406E368F7A9A0453C0B4DD35FAF8FC45402DC2C7F9DB0353C09CFFB97384FE454006298F64B50353C0ACAE53FDF2FF4540147E8C8D2B0453C0CBDEDF1101014640C8376C0B3C0553C000843B2C6B01464036CBFDE3420653C0F06BF521E40046404E4903D4050853C054D96BCE7AFE454078FF20AB350953C0F09AD71EEAFD454020C7D54A2F0D53C0F09AD71EEAFD45402C598A92940D53C08472A463A1FE45408A315F5CE90C53C0CC478C921900464014DB84A2D10B53C06C43C2669B0146409AA91BFD210A53C01033D5B5D9024640329C1BE73C0953C0386F844F2B044640F02754667E0853C04C2A415EDD054640E4959F1E190853C01BBFAFC78507464046977CAFBA0853C07C72137D72074640345F64C84D0953C0E31954AD1B0746404377AAD2D40953C08CDBBFFD8A0646400A69A237520A53C0B0DDA413CA054640025D7FB20E0A53C07C72137D7207464022274CE1E00953C0B3176F97DC0746407E48FB4E680953C0A8A29F91800846400A69A237520A53C0642BEB75E5094640AC81BD4DDD0C53C0307A6CD6370946407636FE936B0D53C0905B778AF30A464096BD396E951153C043640BE2EF07464036221CC32F1253C03CA94ED33D064640667E9D39671253C0D8D366A4C50446402E70959EE41253C0386F844F2B044640B1C1D0207A1353C010E26E3F48044640C016CE49F01353C098B93B84FF04464074761167081453C070C379F303064640907D95B4C91353C0DC0D3128D806464044D1B54C9E1353C06CF120F2D2074640C016CE49F01353C0C0C608214B0946400C1D4A12141553C0F00EDB3FE00A4640C2997271351653C0B800D3A45D0B46400294CBB4151753C0B8972624450C46403676DEED6E1753C0EC826F47050F46406CC19DA7E01653C0E8B01646D4104640848EE857BE0B53C0483507188C1C4640FD1C6CDF710353C077E54AB9022246404E98489420FB52C088A076E1852C464016AA12D683FA52C0D8693B8BBA2D4640785153062DFA52C044B4F2BF8E2E46409A01288ED2F652C0ACA120F98D3046404C92FF4496F652C06B87F5D8C73046406899839257F652C0541226D36B314640AC3940753FF652C0BF5CDD07403246403A004BFD30F652C04834AA4CF7324640142A5B491BF652C070D9056761334640AE3F1AABF8F152C0048E1334563746406E8E9B0B4BF152C0A7956C8D1B39464072142DCE6CF152C0178FBD4B5E3B46405C568324DEF152C06CFBF8F9BD3D4640387AD1DFA7F252C0BCE936BA8D3F46409A6120BEA2F252C080C4751A963F464038E0DAB94BF052C01C357B5487434640BA8826B8C7EC52C0D004FF3F744A4640D60FBD3401E552C0F4993473AC544640622D7F6A2EDD52C004665932F25E46408A757B8DE0D552C02C7A2C398B6846402EB0F97E4BD152C0E7BA1C28906E4640123CAB234CC852C0980030D66B764640EA02A886D6C452C04CAFD980BE7746402EDADF16C2C352C0FC85A2B07378464032F5B11DF4C052C078C9EC91A57B46407A5BDFD6E9BF52C0E0DC178B777C4640BA6464422CBC52C0A34A9E766E7E4640B0539DEFD6B952C02C315DCFAA804640422B9B92BCB852C028EB52F833814640CEC4031695B752C0D4E93AAD4B814640,-48.0%,"-1,151","1,248",92,"1,156",New York,true
35,0106000020E61000000D0000000103000000010000000D0000000C67277E4A7C53C0700AD0355AF540407AA57CD3977D53C03CD5CE35AEED4040623E7CD3137E53C0D893D0358AEC4040382D7CD3CD7E53C0E793D0354AED40409EDD267EDA7F53C0344FD035F2ED4040F84AD228C98053C008CC7AE0CCEE4040D4C77CD3238153C09C427AE01CF04040E4E3D128A58053C038D5CE352EF240404C947CD3B17F53C098427AE01CF34040643E7CD3B37E53C060BF248BF7F24040623E7CD3137E53C094427AE0DCF14040F8FF267EA67D53C07F71D0357EF240400C67277E4A7C53C0700AD0355AF540400103000000010000000C000000EC717CD3657453C07C0AD0351A164140E8E3D128857453C060A3CF35F61541404A947CD3B17453C0948D258BFF1541409C28D228DD7453C048D2258BD7154140D2C77CD3237653C05CD2258BD70F4140319FD1280D7753C0700AD035DA0C41406689277EF67753C00336248B470B41401C837CD34B7753C008CC7AE08C0E41404A947CD3D17653C0AFC5CF3542124140061C7CD3077653C0747479E054154140392D7CD36D7453C068BF248BB7164140EC717CD3657453C07C0AD0351A164140010300000001000000120000002EEA7CD38F5653C0780AD035DA4241403FBB267EAE5653C060A3CF35B6424140C2607CD3DF5653C070557BE0BC4241404C947CD3115753C0543CCF3592424140944F7CD3B95853C074BF248B3740414030EA7CD3EF5D53C0403CCF35923B41401A837CD30B6053C05CA3CF35B63A414041BB267EEE6053C0607479E0143A414000D97CD3896753C044B6D035563041406689277E966853C0D42CD035662E414076A57CD3576753C0A85ECF359E32414002D97CD3096553C0284FD0357236414003D97CD3C95C53C01F4FD035723F4140D4C77CD3A35B53C040877AE0F43F41409ADD267E7A5A53C0B8C5CF35824041404E947CD3F15753C058A3CF35F642414074A57CD3975653C00436248B874341402EEA7CD38F5653C0780AD035DA4241400103000000010000000C00000004D97CD3692253C0204FD035325241403DBB267E4E2353C0E0FD79E0845141408CC1D128992353C0888D258BFF5141403EBB267EEE2553C034D5CE35EE5441400C67277E2A2953C044B6D035D6564140091C7CD3E72953C0B87A248B9F574140091C7CD3E72953C0BCC5CF358258414076A57CD3972853C0BCC5CF358258414040BB267E2E2453C0E0B2CE35E2554140DD0A7CD3812353C0D0FD79E0045541405222277EB22253C03F3CCF359253414004D97CD3692253C0204FD035325241400103000000010000000A000000A228D2289D2B53C0C0C5CF35425A4140A228D2289D2B53C0B07A248B5F5941404A947CD3513353C0C0C5CF35425A414062FB7CD3F53453C098F7CE35FA594140C0AB277E624653C03CD5CE352E534140EC717CD3454553C037D5CE352E554140A7F97BD37B4353C0E0B2CE35625641402EEA7CD36F3953C0B07A248B5F5941405222277EF22E53C0780AD035DA5B4140A228D2289D2B53C0C0C5CF35425A414001030000000100000013000000DA0A7CD3412153C0403CCF35D24E41405CFB7CD3F52153C0D02CD035664B4140C2AB277E822253C07C0AD035DA4D41409EDD267E9A2153C0C0107BE0A451414088C1D128191A53C01417268BAF654140BE607CD37F1353C018E8CF350E71414006D97CD3C91053C01804258B0F744140F4FF267E661053C0284FD035F274414079A57CD3F70F53C0888D258BFF7541408AC1D128F90E53C0BBC5CF35427741405122277ED20D53C088427AE05C7841404E947CD3F10C53C024B979E0EC784140DA0A7CD3410E53C038D5CE356E7541409ADD267EFA0F53C088427AE09C7341404506D228311353C0D42CD035E66D4140A028D2289D1453C038D5CE35AE6C4140F84AD228C91553C0483CCF35526B41407AA57CD3571953C02404258BCF644140DA0A7CD3412153C0403CCF35D24E414001030000000100000012000000D1C77CD3030953C0E893D0350A7F4140FB4AD228690953C0E893D0350A7F4140FA4AD228C90853C00C17268B6F8041402CEA7CD3CF0653C0E4B2CE35E2834140D2C77CD3630653C05CA3CF35B6854140309FD1282D0653C0680AD0355A86414048947CD3B10553C03F3CCF351287414078A57CD3370553C060A3CF35F6874140C0607CD3FF0453C0F780CF352A894140D4C77CD3A30453C0483CCF35928941404E947CD3D10353C0C72CD03526894140CE7CD128610253C0740AD035DA8741408EC1D128990253C0DFB2CE35628741402FEA7CD3CF0253C048877AE0348741400867277E0A0353C0DCB2CE35228741400867277E4A0353C070557BE0FC86414001D97CD3090853C088F7CE357A814140D1C77CD3030953C0E893D0350A7F41400103000000010000000F000000A8B67CD31DFA52C074BF248B77914140A8F97BD31B0153C0780AD0359A894140D80A7CD3610053C0C02CD035E68A4140309FD128EDFF52C028B979E06C8C4140AAF97BD35BFF52C008CC7AE0CC8F4140D4C77CD3E3FD52C0503CCF35128F4140F6FF267E26FC52C08C71D0353E904140964F7CD3B9F852C058D2258B17944140D27CD12821F352C0687479E0949741401E837CD34BF152C02FB6D0355699414002D97CD3A9F152C00881CF356A984140362D7CD30DF252C0E093D035CA9741405CFB7CD315F352C0E493D035CA96414032EA7CD34FF452C0740AD035DA944140A8B67CD31DFA52C074BF248B779141400103000000010000003C0000002F9FD128CDE252C087427AE0DC9D41402EEA7CD36FE352C0204FD035B29D414060FB7CD375E552C087427AE0DC9D4140D80A7CD3E1E752C0E493D0350A9C4140B244277E3EE952C0A45ECF359E9B4140FA4AD228A9EB52C0B0C5CF35C29941404006D228B1EC52C02FB6D035569941403CBB267E0EED52C0747479E01499414017837CD3EBED52C02BB979E0EC9741402EEA7CD36FEE52C0F880CF35AA9741406889277E16EF52C0E819CF35069841402EEA7CD3EFEE52C034B6D035D6984140D07CD12861EE52C070BF248BB7994140392D7CD3CDED52C0EC93D0354A9A414040BB267E2EED52C0CB2CD035669A4140F7FF267EE6EC52C0D8B2CE35E29A4140AEF97BD3BBEC52C0888D258B7F9B4140603E7CD373EC52C0E493D0350A9C41409ADD267E5AEC52C0F880CF356A9C41402EEA7CD34FEC52C0E493D0350A9D414040BB267E2EEC52C090427AE09C9D41406689277ED6EB52C087427AE0DC9D4140EAE3D128A5EB52C0D0B2CE35A29D41406689277E96EB52C00017268B2F9D4140DE0A7CD381EB52C0687479E0D49C414087C1D12839EB52C0D848258BE79C4140765AD12835E752C0747479E054A04140C2AB277EC2E252C040877AE0F4A241401B837CD30BE152C0948D258B3FA541407AA57CD317E152C0D02CD03526A941405522277EB2E052C05CA3CF35B6AA41401A837CD3EBDF52C0B7C5CF3502B14140D2C77CD3A3DF52C0483CCF35D2B54140C0AB277E02DF52C044877AE074BA41409C28D228DDDE52C0403CCF3552BD4140623E7CD3F3DE52C060A3CF35B6BE4140061C7CD347DF52C030D5CE352EC14140362D7CD34DDF52C0C42CD035A6C241403EBB267E0EDF52C07C0AD0351AC441402CEA7CD32FDE52C044877AE0F4C64140A8B67CD3FDDD52C0707479E054C84140FFD87CD309DE52C09C427AE05CCB4140623E7CD373DE52C0CF48258BA7D041402EEA7CD30FE052C0F419CF3506DA4140309FD1282DE052C0C0C5CF3582DC4140041C7CD347E152C0700AD035DAE041401E837CD3ABE152C0E093D0354AE341407AA57CD317E152C00C17268BEFE3414078A57CD3F7DF52C068557BE03CE24140F2717CD325DF52C048877AE034DF4140D4C77CD3A3DE52C018E8CF35CEDB41407AA57CD377DE52C0C4C5CF3502D941403EBB267E4EDE52C0D0B2CE3562D64140A6B67CD31DDD52C0BCC5CF35C2CF41400C67277EEADC52C02804258B8FCA4140A6B67CD31DDE52C094427AE09CC0414002D97CD369DF52C02004258B0FAB4140BE607CD3FFE052C007E8CF354EA14140BF607CD39FE152C098F7CE353A9F41402F9FD128CDE252C087427AE0DC9D414001030000000100000019000000F2717CD305E852C0B8C5CF3542EA41406489277E36E952C0DBB2CE3522EA41404A947CD331EA52C0AFC5CF3502EB4140C4AB277EA2EA52C058D2258B17ED41401B837CD3EBEA52C0F835248B87EF41401A837CD36BEB52C0E819CF3586F141401C837CD34BED52C0F880CF35EAF44140392D7CD3CDED52C0975ECF355EF64140FE4AD22829EE52C0E093D0350AF74140623E7CD393EE52C0BC7A248B9FF741406689277EB6EE52C08871D0353EF841405622277E32EE52C08071D035FEF84140C2AB277EA2ED52C058A3CF3536F941400C67277E0AED52C00CCC7AE00CF94140AE44277E7EEC52C0D7B2CE35A2F84140362D7CD30DEC52C0A75ECF351EF84140D4C77CD323EB52C05FA3CF3576F741406A89277EB6EA52C090F7CE35FAF641403EBB267E4EEA52C0975ECF355EF641405122277E32EA52C02CB979E02CF54140FC4AD22869E952C0740AD0351AF34140765AD12835E752C09C8D258B7FEE4140329FD128CDE752C0CC2CD03526EC41404206D228D1E752C038B6D035D6EA4140F2717CD305E852C0B8C5CF3542EA4140010300000001000000400000006789277EB6F252C078557BE03C294240AAF97BD39BF252C0E048258B27264240643E7CD353F252C054D2258B172442406A89277E76F052C0F419CF35C61D42406689277EB6ED52C0AC5ECF359E10424076A57CD317E452C0740AD0359AF24140643E7CD373E352C0E4FD79E044ED4140F4FF267E86E152C02FD5CE35AEE54140F2717CD305E252C0244FD03532E64140081C7CD347E352C014E8CF350EE7414062FB7CD3B5E352C0C0C5CF3582E74140DC0A7CD3E1E352C0C72CD03566E84140A6B67CD3DDE352C02004258B8FE941404A947CD3F1E352C0403CCF3592EA4140944F7CD359E552C0B0C5CF3502EC4140904F7CD3B9E552C050D2258B57EE4140F2717CD3E5E552C0B87A248BDFF241408AC1D128D9E652C0988D258B3FF6414087C1D12839EB52C067557BE0FCFF4140AC44277E9EEB52C067557BE0FCFF41405022277E72EC52C020B979E02CFF41402E9FD1286DED52C060BF248BB7FF41401C837CD30BEE52C0FC35248B47014240392D7CD3CDED52C08FF7CE357A034240F4FF267E46ED52C08F427AE01C024240AEF97BD3BBEC52C0F880CF35EA01424087C1D12839EB52C038D5CE35AE024240DE0A7CD381EB52C0284FD035B204424098DD267EFAEB52C0E048258B670642409ADD267E9AEC52C0A85ECF351E074240A8B67CD35DED52C028D5CE352E06424042BB267E4EEE52C0FC35248B87074240EAE3D128C5EE52C037B6D03596094240623E7CD313EF52C0CC2CD035E60B4240309FD1288DEF52C004CC7AE00C0E4240309FD1288DEF52C00481CF35EA0E4240F2717CD345EF52C04C3CCF35121242402EEA7CD3EFEF52C06CBF248BF715424076A57CD3D7F052C0BCC5CF35C2194240D0C77CD383F152C04F877AE0F41D42403BBB267E4EF352C070BF248BB7234240362D7CD32DF452C0F035248B47254240D80A7CD361F452C068557BE0FC25424004D97CD349F452C028D5CE356E26424062FB7CD315F452C0B07A248B9F2642405EFB7CD3F5F352C050D2258B97264240E8E3D12865F452C058D2258B172A42400A67277ECAF452C074BF248B77324240BC607CD3FFF452C00C81CF352A344240EE717CD3E5F552C0F8CB7AE04C3742409DDD267E1AF652C09C8D258B7F394240E8E3D12805F752C0740AD0359A3C4240B044277E7EF752C070BF248BF7404240BB607CD35FF852C0204FD03572454240643E7CD353F852C0E3B2CE3522464240F4701B675CF852C050B5CDC04D464240921694E659F852C07881E4BB4D4642408D9B60B37EF752C04C4CE6BB4946424080BB943399F652C08C5C558C464642408EC1D12899F652C0F019CF3546464240765AD12895F652C0E3B2CE35224642405EFB7CD3F5F352C0707479E014314240DC0A7CD301F352C0D0B2CE35E22B42406789277EB6F252C078557BE03C29424001030000000100000016000000DB0A7CD3E1FD52C0B07A248B5F4642404606D22891FD52C09B8D258B7F45424000D97CD3C9FC52C008CC7AE08C454240964F7CD359FC52C06F0AD0355A46424066775BB559FC52C0B4B1E46E5A46424032ECC7194FFB52C0B039B18856464240264EB6732CFA52C0533BF6275346424000D97CD329FA52C094F7CE353A464240A8B67CD31DFA52C068BF248BB74242404606D228F1F952C0F019CF358641424018837CD3ABF952C0985ECF355E40424018837CD3ABF952C07871D0357E3F42404106D22851FA52C0BF107BE0243F42402CEA7CD3EFFC52C0BF107BE0243F4240D0C77CD343FE52C064A3CF35F63F4240DE0A7CD381FE52C0D8FD79E0C4414240AC44277E9EFE52C04C3CCF359243424018837CD36B0053C0700AD0355A454240A45A5E16D90053C0784F055D6B464240864494E6D50053C0B45C7E556B464240461D2C0DE2FD52C09769F22B60464240DB0A7CD3E1FD52C0B07A248B5F46424001030000000100000003050000629E2E806F0A54C088777D5573454240B88294E6BB0554C0A0217E5517454240F49CFA4C20FE53C0E8BBE3BB21454240AA7EFA4C84F653C030E57C552B4542401E9061B3E8EE53C0E86DE4BB3545424054AAC7194DE753C0A0F64B224045424090C42D80B1DF53C0E890B1884A45424003D694E615D853C0332B17EF5445424088C093E679D053C07854B0885E454240F5D1FA4CDEC853C030DD17EF68454240BE072E80F3BE53C030DD17EF68454240F804FB4C08B553C030DD17EF684542403802C8191DAB53C030DD17EF68454240400894E631A153C030DD17EF68454240800561B3469753C030DD17EF68454240BA022E805B8D53C030DD17EF68454240FAFFFA4C708353C030DD17EF684542400206C719857953C030DD17EF68454240E4B494E6A17153C0889A4A22884542400EA5C719BF6953C0D0E6B088A64542403F95FA4CDC6153C0003317EFC4454240EA4CC719F95953C0B86D7F55E3454240C6FB94E6155253C090CBE3BB01464240C6F4C619334A53C0D8174A222046424022DCFA4C504253C09052B2883E464240CC93C7196D3A53C0E80FE5BB5D464240C4912D802B3653C0408CE3BB69464240664E2E80E93153C00868B08876464240A01C2D80A72D53C0EC437D5583464240C81194E6652953C0A81F4A2290464240EC06FB4C242553C088FB16EF9C464240DC0461B3E22053C05FD7E3BBA9464240CC91FA4CA01C53C028B3B088B6464240F08661B35E1853C0F01DB188C2464240A5382D80931553C038954922B8464240C0D8FA4CC81253C0DF8917EFAC464240A881C719FD0F53C03490E3BBA1464240982A94E6310D53C0D084B188964642400691FA4CD40A53C0973DB1888E464240EBBEFA4C760853C06C85E4BB85464240D4ECFA4C180653C030CD17EF7C4642400A5C60B3BA0353C0F88517EF74464240E219A4C8070253C0988B424C6F4642409CDD267EFA0153C0E3B2CE35224642409CDD267EFA0153C057D2258B974442409E28D2285D0253C0B0107BE024424240CE7CD128610253C0700AD0351A404240A8F97BD3DB0153C087F7CE357A3D4240BE607CD3BF0053C04C877AE0F43A42409ADD267E5AFF52C014E8CF35CE38424078A57CD3F7FD52C094427AE05C37424074A57CD317FF52C01017268B6F3642404406D22851FE52C03CB6D035563342407AA57CD3B7FC52C0E719CF3506304240C0AB277E62FB52C0E893D0358A2E42405CFB7CD3F5FB52C0C4107BE0A42F4240AEF97BD35BFC52C044B6D03596304240964F7CD399FC52C0740AD0359A314240A128D228BDFC52C0D848258BE7324240D27CD12881FC52C02704258BCF324240964F7CD319FC52C02804258B4F34424098DD267E9AFB52C0B47A248BDF36424002D97CD3C9FA52C050877AE0F4364240F0717CD3A5FA52C0E493D0358A334240A4B67CD3FDFA52C0F880CF35AA2D424018837CD36BFA52C00817268BAF2B42408CC1D12859F852C068557BE07C264240E9E3D128E5F752C0284FD03572244240329FD128ADF752C05CD2258BD7224240ACF97BD33BF452C07C557BE0FC1342405EFB7CD3F5F352C0D0FD79E004124240755AD12875F352C00036248B870F4240745AD12895F252C040877AE0B40C4240EE717CD345F252C0284FD035720A4240AEF97BD37BF352C024B979E0AC0942403A2D7CD38DF452C0747479E0940A4240CE7CD128A1F552C0E4FD79E0840C4240D80A7CD341F752C0D8FD79E044104240663E7CD393F752C08071D0357E114240623E7CD373F752C0A85ECF359E1242401C837CD32BF752C018B979E0AC134240E8E3D12805F752C028D5CE35AE14424042BB267E2EF752C077557BE0FC1542403DBB267E8EF752C028B979E06C174240643E7CD353F852C068557BE07C194240D4C77CD3C3F952C034D5CE356E1B4240A8B67CD31DFA52C09C427AE01C1C4240C4AB277E42FA52C0304FD035F21C424042BB267E4EFA52C0E4FD79E0C41E4240D4C77CD383FA52C0780AD0359A1F42401E837CD36BFB52C018B979E0AC204240964F7CD359FC52C040B6D035562142402CEA7CD3AFFC52C02B4FD035722242405022277ED2FB52C057D2258BD72442402E9FD1288DFD52C0E893D0354A274240C0607CD37FFE52C02C4FD03532284240DC0A7CD3C1FF52C048D2258B57284240382D7CD32DFF52C0E3B2CE356226424088C1D12879FE52C0C4C5CF3582254240A4B67CD3DDFD52C0CB2CD035662442405EFB7CD355FD52C03CB6D035961F4240AE44277EDEFC52C0DCB2CE35221D4240081C7CD3C7FC52C0B0107BE0241B42409E28D2289DFD52C08C427AE05C1A42409ADD267EFAFB52C01017268BAF1742405222277E12FB52C0E0B2CE35A2164240A8B67CD31DFA52C08871D035FE154240A8B67CD31DFA52C0985ECF351E154240F1717CD3A5FE52C0284FD03572174240964F7CD3F9FF52C070557BE0BC17424040BB267E4E0153C0C4C5CF3582184240EE717CD3650253C04CD2258B571A42405122277EF20353C08C8D258B3F1E4240725AD128750453C00081CF35EA1E4240B244277E9E0553C00017268B6F1F4240F8FF267E260653C0687479E014204240EAE3D128450753C070BF248B3722424002D97CD3890853C008E8CF350E2442404606D228910953C068557BE0FC2442404E947CD3F10C53C050D2258B97264240D27CD128610C53C0B0107BE02427424001D97CD3E90B53C00FE8CF350E284240FA4AD228E90B53C00481CF35EA284240944F7CD3B90C53C0F7CB7AE04C2942408AC1D128590D53C05CD2258B9728424006D97CD3E90D53C0443CCF351227424076A57CD3370E53C0E493D0358A25424001D97CD3090E53C057D2258BD72442407AA57CD3970C53C0E019CF3546244240F94AD228290B53C0C02CD035E6224240FB4AD228E90953C018B979E02C214240D1C77CD3030953C0780AD0359A1F4240ACF97BD3FB0753C02004258B8F1C42405222277E520753C0F019CF35061B4240E6E3D128C50553C02BB979E0AC194240C2AB277E220553C024B979E0AC164240C4AB277E620453C08871D035FE1542401C837CD3AB0353C0670AD0359A1542402DEA7CD30F0453C074557BE0BC144240964F7CD3790553C0E493D0354A1342406689277E360653C0700AD035DA12424002D97CD3890853C08071D0357E12424002D97CD3890853C0EC93D0358A114240904F7CD3190853C0EC93D0358A114240904F7CD3190853C08871D035BE104240A6B67CD31D0A53C0AC5ECF359E104240C0AB277EC20A53C08871D035BE104240D2C77CD3630B53C0DC48258B27114240F8FF267E660D53C0F880CF352A134240944F7CD3790E53C088427AE01C164240D6C77CD3E30E53C0F035248BC71642408AC1D128790F53C00081CF352A174240EE717CD3451153C068557BE07C194240DC0A7CD3411253C090427AE01C1B42402FEA7CD3AF1253C098F7CE353A1B42400867277EAA1253C068557BE07C194240DA0A7CD3611253C0A85ECF355E184240A228D228DD1153C090F7CE353A174240A8F97BD33B1153C05BD2258B57164240D4C77CD3A31053C08871D035FE15424004D97CD3E90F53C00C81CF35EA1442402EEA7CD3AF0D53C0E819CF35C60F4240DC0A7CD3810C53C004CC7AE00C0E4240DC0A7CD3810C53C09C8D258B3F0D42406789277E160E53C07C557BE0BC0C4240EC717CD3A50F53C018E8CF354E0D42409E28D2285D1653C01CB979E02C124240081C7CD3271853C09C8D258BFF13424076A57CD3371953C0F035248BC7164240D4C77CD3431A53C01F04258B4F164240BE607CD35F1B53C028B979E06C174240D80A7CD3811C53C08F427AE01C194240DA0A7CD3A11D53C08C427AE05C1A424018837CD3CB1C53C0B87A248B5F17424030EA7CD34F1C53C00CE8CF350E16424078A57CD3D71B53C0985ECF351E1542401C837CD38B1953C0EC19CF350613424076A57CD3371953C0D0FD79E004124240E6E3D128851853C0DC48258BA71042400A1C7CD3E71653C0F019CF35060F4240CE7CD128211553C0204FD035B20D42402DEA7CD3EF1353C09C8D258B3F0D42402DEA7CD3EF1353C00CCC7AE04C0C4240904F7CD3591A53C0A45ECF359E0A4240061C7CD3671B53C024B979E0AC094240061C7CD3671B53C070BF248BB70842404B947CD3311B53C023B979E0AC084240091C7CD3871A53C070BF248BB7084240F6FF267EE61B53C0F880CF352A064240382D7CD3ED1D53C050877AE0F4034240E4E3D128052053C0E4B2CE356202424030EA7CD38F2153C098F7CE35BA014240DE0A7CD3C12353C064A3CF357601424048947CD3F12453C040B6D035960142406589277EB62553C04C877AE034024240F2717CD3852753C0B07A248BDF064240A6B67CD31D2853C03BD5CE35EE0742404A947CD3312953C0FF80CF35EA0442400A67277EAA2A53C0FF80CF35EA04424076A57CD3F72B53C028D5CE352E074240A8B67CD3DD2C53C0BF2CD035260E4240AE44277E5E2E53C0D0B2CE35E213424062FB7CD3B52E53C0B0C5CF354217424060FB7CD3D52D53C090F7CE35FA1C4240A3B67CD37D2D53C008E8CF354E1E4240623E7CD3932C53C018E8CF350E2042406A89277E162C53C0E0FD79E044214240A6B67CD37D2B53C01CE8CF35CE2442403A2D7CD30D2C53C02304258B0F274240FA4AD228492D53C034D5CE356E28424062FB7CD3B52E53C0F7CB7AE04C2942404006D228512E53C0483CCF35D227424006D97CD3292D53C0D02CD035A62542402E9FD128ED2C53C0284FD035722442404A947CD3112D53C0B4C5CF35C22242404C947CD3712D53C060A3CF35B62142408AC1D128792E53C0687479E01420424018837CD38B2F53C0CC2CD035A61D4240F2717CD3253053C0C4107BE0641B4240F94AD228693053C08071D035BE18424060FB7CD3753053C0D8FD79E044104240D07CD128413053C088427AE0DC0E42409CDD267E5A2F53C0284FD035F20B42405222277EF22E53C0607479E05408424073A57CD3772E53C0344FD03532074240E6E3D128E52D53C0E493D0354A064240EE717CD3652D53C088F7CE353A054240944F7CD3392D53C00C17268BAF034240F2717CD3452D53C02C4FD03532024240382D7CD30D2D53C0D0B2CE35220142406A89277E162C53C0770AD035DA0042409BDD267E7A2C53C0D893D0350AFF414062FB7CD3B52E53C0204FD035F2F9414062FB7CD3B52E53C08071D035FEF84140A028D228DD2553C020B979E0ECF8414040BB267E2E2453C0A75ECF351EF84140725AD128B52353C0A75ECF351EF84140D6C77CD3A32153C0C0C5CF3542FA4140EE717CD3451E53C05CA3CF3576FC4140E6E3D128E51A53C0680AD0359AFD4140FC4AD228C91853C02804258B8FFC4140EE717CD3851853C00036248B47FB41409ADD267E9A1853C08C71D035FEF94140E6E3D128C51853C0E0B2CE35E2F84140FC4AD228C91853C0A75ECF351EF84140745AD128551853C0F8CB7AE04CF74140C2607CD3DF1753C028B979E0ACF741404C947CD3511753C08071D0357EF84140944F7CD3991653C08071D035FEF84140924F7CD3391553C01CE8CF358EF84140C6AB277E821253C0C0C5CF3582F64140CC7CD128E11053C0975ECF355EF64140964F7CD3B91153C08F8D258BFFF741404206D228111353C07771D0353EF94140C0AB277EA21353C0780AD0359AFA414030EA7CD32F1253C02804258B8FFC4140DC0A7CD3810C53C00317268B2FFF4140D2C77CD3630653C067557BE0FCFF4140ABF97BD3DB0453C098427AE05CFF414075A57CD3170353C00881CF35EAFD4140D07CD128E10153C08871D035FEFB41409CDD267EFA0153C0204FD035F2F94140EB717CD3650353C074BF248B37FB41408BC1D128190453C0DCFD79E004FA41409CDD267E9A0453C0403CCF3592F54140FC4AD228690253C024B979E0ECF64140DA0A7CD3810153C08871D0353EF74140603E7CD3130253C01417268B6FF441402CEA7CD3EF0253C08071D035BEF141404D947CD3110453C0607479E0D4EF4140964F7CD3790553C0B07A248B5FEF4140964F7CD3790553C09C8D258B7FEE41400E67277E0A0453C00CCC7AE08CEC4140F0717CD3450353C087427AE0DCE841409CDD267E9A0353C008E8CF358EE54140964F7CD3790553C090F7CE35BAE441405622277E320753C050877AE0B4E541405422277EF20753C050877AE0B4E541406689277E760753C02FB6D03556E4414076A57CD3B70653C098F7CE357AE341405FFB7CD3B50553C0E093D035CAE24140F1717CD3A50453C0700AD0355AE241409ADD267EBA0353C0F019CF3546E241400A67277E2A0453C0F019CF3546E24140DC0A7CD3A10353C098F7CE357AE14140F8FF267E060353C030D5CE35EEDF414074A57CD3B70253C024B979E06CDE41405622277E120353C08871D035BEDD41409ADD267EBA0353C074557BE0FCDC4140329FD1286D0353C0A85ECF355EDB4140E8E3D128C50253C098427AE0DCD94140CE7CD128610253C0284FD03572D941408AC1D128790353C0DC93D0358AD74140FA4AD228690553C034D5CE352ED84140A4B67CD37D0753C048877AE074D94140D1C77CD3030953C0284FD03572D94140FE4AD228E90753C064A3CF3536D64140F0717CD3650653C0B8107BE024D54140091C7CD3A70453C050D2258B57D541409EDD267EDA0253C040877AE0F4D54140061C7CD3E70253C0E893D0358AD541408EC1D128D90253C07C557BE0FCD441402C9FD128AD0253C0E4FD79E044D44140CE7CD128610253C0707479E054D341409CDD267EFA0153C0707479E054D341401A837CD3ABFF52C090F7CE357ADD4140AAF97BD35BFF52C0E493D035CAE14140AAF97BD35BFF52C0E819CF3586F14140C2607CD3DFFE52C00081CF35AAF24140C2607CD3BFFC52C0E493D0350AF54140C2AB277E42FC52C070BF248BF7F541405FFB7CD3D5FB52C0E0B2CE3562F64140061C7CD3E7FA52C0687479E0D4F44140D2C77CD3A3F952C027B979E0ECF14140745AD12815F852C0F835248B87F041404A947CD3B1F752C05F7479E054F04140DC0A7CD321F752C090F7CE35BAF04140A7B67CD3FDF652C0740AD0359AF141405222277E32F752C087F7CE357AF24140A7F97BD37BF852C028D5CE356EF34140603E7CD333F952C007CC7AE0CCF44140E4E3D128C5F952C0C0C5CF3582F64140A8B67CD31DFA52C0A75ECF351EF84140FC4AD228C9F852C010E8CF358EF74140329FD1286DF752C05BD2258B97F64140603E7CD313F652C028B979E02CF641400A67277ECAF452C08871D0353EF74140D07CD12861F552C0BC107BE024F84140E8E3D12805F652C0284FD035B2F841407AA57CD3B7F652C064BF248BF7F84140B044277E7EF752C08071D035FEF841406689277E16F752C040877AE0F4F94140352D7CD3CDF652C0BCC5CF3502FB4140C4AB277EA2F652C024B979E02CFC4140765AD12895F652C00C17268B6FFD4140FE4AD22869F452C0204FD035F2FA414074A57CD397F252C088427AE05CF74140309FD1288DEF52C0B07A248B5FEF4140309FD1288DEF52C028D5CE35AEED41408CC1D12879EE52C0D0FD79E004EB41405622277E32EE52C0DBB2CE3522EA41405EFB7CD335EE52C0EC19CF35C6E741404306D228B1EE52C027B979E0ECE54140C2AB277E42EF52C050877AE034E44140309FD1288DEF52C0F019CF3546E24140A6B67CD35DEF52C02804258B0FE141409CDD267E7AEE52C0D8FD79E0C4DE41405622277E32EE52C0304FD035F2DC4140C0AB277E22EE52C08071D0353EDA4140E6E3D12865EE52C0B87A248B5FD94140A228D228FDEF52C0284FD03572D94140BF607CD37FF152C050877AE034D94140C0AB277E82F152C0E093D0354AD84140ACF97BD3DBF052C040877AE0F4D541401C837CD36BEF52C008E8CF354ED2414060FB7CD355EF52C090F7CE35FAD04140B244277E3EF052C02804258B4FCE4140071C7CD387F052C09CF7CE35BACD41401B837CD3EBF052C00CCC7AE04CCD4140B044277E7EF152C0E0B2CE3522CD41404C947CD311F252C0304FD035B2CC4140C4AB277E22F252C00481CF35AACB41402E9FD1280DF252C0E819CF3586CA414019837CD32BF252C074BF248BB7C94140DA0A7CD3E1F252C0687479E014C94140ACF97BD3BBF352C02404258BCFC84140745AD128B5F552C0DFFD79E0C4C84140745AD128B5F552C074BF248BB7C94140A8F97BD3DBF452C07C0AD0355ACA4140E8E3D12865F452C0B8C5CF3582CA4140663E7CD373F452C0E819CF3506CB414002D97CD389F452C05CA3CF3576CB4140EE717CD3A5F452C09C427AE0DCCB41400A67277ECAF452C0B0C5CF3542CC4140A6B67CD35DF652C0C4107BE024CB4140623E7CD373F752C08071D0353ECC41404A947CD331F852C0FF16268BAFCE4140964F7CD3B9F852C0607479E094D14140A6B67CD33DF952C0A05ECF359ECF41402C9FD1284DF952C0D7B2CE3562CD4140BE607CD33FF952C0DCB2CE3562CB41401A837CD36BF952C0985ECF351ECA41405EFB7CD315FD52C0E3B2CE35E2C34140EB717CD365FD52C090427AE09CC341405EFB7CD395FE52C098F7CE353AC3414040BB267EAEFE52C0F019CF3586C24140C0607CD37FFE52C0E048258BA7C141404A947CD371FE52C0CC2CD035E6C04140C0AB277E42FE52C0E019CF3546C04140FD4AD22849FE52C0E0B2CE35A2BF41400A67277EAAFE52C034D5CE35AEBE41404306D22811FF52C090F7CE353ABE41402E9FD128AD0053C0403CCF3552BD41406689277E360053C0EC19CF3586BB41404206D228910053C0B47A248B5FBA4140352D7CD32D0153C08071D0357EB94140DA0A7CD3810153C08FF7CE357AB84140613E7CD3930153C0204FD035B2B641403FBB267ECE0153C02CB979E0ACB54140914F7CD3390253C0F019CF3586B541409EDD267EDA0253C03CB6D03556B64140CE7CD128610253C05CA3CF3536B7414075A57CD3970353C0B4C5CF3582B841401E837CD38B0453C00017268BAFB641409C28D228DD0453C04C3CCF35D2B341400A67277E2A0453C05CA3CF35F6B141400A67277E2A0453C024B979E02CB141409CDD267E1A0553C0D8FD79E004B141404A947CD3910753C074BF248BB7AF414047947CD3510853C0A05ECF35DEAE4140A6B67CD31D0953C0A75ECF351EAD4140BE607CD39F0953C01017268B6FAC41405EFB7CD3F50D53C0DC48258BA7AC41406889277E160F53C058A3CF3536AD4140EF717CD3C50F53C0A85ECF359EAF41408AC1D128391053C03FB6D035D6AF41401A837CD3AB1053C090427AE05CAF4140CC7CD128E11053C08071D035FEAD41405222277E321153C05CD2258B97AC414040BB267EEE1153C0C0107BE0E4AC4140DE0A7CD3E11353C02804258B0FAF4140DA0A7CD3C11453C0C02CD03566B2414002D97CD3491553C060A3CF35B6B34140A7B67CD3BD1653C018B979E0ECB44140D0C77CD3431753C0A85ECF35DEB34140061C7CD3471753C0680AD0351AB24140A8F97BD33B1753C024B979E02CB14140C0AB277EC21653C050D2258B57B04140352D7CD38D1653C0EC93D0358AAE4140ACF97BD3DB1653C078557BE0BCAC4140FA4AD228E91753C024B979E0ECAB41401C837CD34B1853C068BF248B37AD414076A57CD3371953C0C0107BE064AE414004D97CD3C91953C07871D035BEAE4140DA0A7CD3411A53C0D8B2CE35A2AE4140C0AB277EA21A53C0700AD035DAAE4140352D7CD3ED1A53C074BF248B37B04140332D7CD34D1853C074BF248B37B04140332D7CD34D1853C024B979E02CB14140A228D228DD1853C070BF248B37B24140D80A7CD3211953C0780AD0355AB4414076A57CD3371953C08FF7CE357AB84140BE607CD3BF1953C0707479E0D4BA4140F2717CD3C51A53C040877AE074BB41405422277E721B53C0908D258B7FBA4140352D7CD3ED1A53C034B6D03516B841404E947CD3511C53C060A3CF35B6B341403EBB267E0E1D53C0888D258B7FB441401E837CD3CB1D53C0BF107BE0A4B44140603E7CD3731E53C0E0B2CE3522B441404006D228F11E53C00881CF35EAB24140A6B67CD37D1E53C078557BE07CB24140C2607CD31F1E53C0B0107BE0E4B141405EFB7CD3D51D53C0E4B2CE3522B14140DA0A7CD3A11D53C074BF248B37B04140E8E3D128E51F53C048D2258B17B24140DA0A7CD3C12053C06B7479E054B3414030EA7CD38F2153C064A3CF3576B541409C28D228FD2053C0C0107BE0A4B541403EBB267EAE2053C018B979E0ECB54140A4B67CD37D2053C0D748258B67B64140BC607CD33F2053C05CA3CF3536B741405222277EF22253C070557BE0FCB841408BC1D128D92353C0740AD0355ABA4140BE607CD3DF2253C0D848258BA7BB4140BE607CD3DF2253C0204FD03572BC4140BB607CD31F2453C00C17268BEFBD41402EEA7CD3CF2453C020B979E0ACBF4140EE717CD3852453C0730AD0351AC14140BE607CD3DF2253C0204FD035B2C14140F84AD228A91F53C0A85ECF35DEC041405BFB7CD3951E53C0EC19CF35C6C14140DA0A7CD3A11D53C0D8FD79E044C541400C67277E4A1F53C05CA3CF35B6C44140BC607CD3BF2053C0543CCF35D2C44140725AD128B52353C0CC2CD03526C6414030EA7CD36F2553C094427AE05CC641400A1C7CD3C72653C01017268B6FC54140392D7CD36D2953C0C42CD035A6C241405422277E722853C07C557BE03CC241409ADD267EBA2753C0D8B2CE3562C14140745AD128352753C0E019CF3546C04140382D7CD3CD2653C0543CCF3512BF41404C947CD3712753C014E8CF354EBC4140332D7CD3AD2753C0D848258BA7BB4140EAE3D128C52653C0FF80CF35EAB941408AC1D128592653C01804258B4FB941403EBB267EEE2553C0A77A248BDFB841403EBB267EEE2553C034B6D03516B8414004D97CD3492653C08871D035BEB7414076A57CD3772653C048D2258B57B7414078A57CD3972653C0975ECF35DEB64140382D7CD3CD2653C03CB6D03556B6414000D97CD3292653C0D848258BE7B54140F84AD228A92553C098427AE05CB541400C67277E4A2553C0BF107BE0A4B441403CBB267E0E2553C060A3CF35B6B34140BFAB277E622653C0543CCF3592B24140AAB67CD33D2853C0304FD03532B34140944F7CD3992953C00081CF352AB54140392D7CD36D2953C034B6D03516B84140EE717CD3052A53C0C4107BE0E4B74140C6AB277E822A53C0607479E094B74140081C7CD3E72A53C040B6D03516B741406889277E362B53C03CB6D03556B64140623E7CD3132D53C040B6D03516B7414006D97CD3893053C090427AE09CB541409E28D228FD3153C0DCFD79E0C4B64140623E7CD3533353C0304FD035F2B841408EC1D128993453C070557BE0FCB94140C2AB277EE23753C048877AE0B4BA41403EBB267EAE3953C03BB6D03596BB4140A8F97BD3BB3C53C05CA3CF3576BE4140B044277E9E3F53C0B47A248B9FBF4140061C7CD3E74053C07871D035FEC04140643E7CD3534353C0D42CD03566C441400867277E4A4253C07C71D0357EC04140DC0A7CD3A14153C00881CF35EABE4140061C7CD3E74053C00036248B47BE4140EE717CD3A53F53C0C3107BE0A4BD41400C67277E0A3F53C02804258B0FBC4140AEF97BD37B3E53C034B6D03516B84140A028D2287D3C53C0FF80CF35EAB94140904F7CD3D93953C0543CCF35D2B84140964F7CD3393753C0EC19CF3546B64140D2C77CD3433553C060A3CF35B6B341400A67277E4A3453C090F7CE35BAB2414060FB7CD3753053C024B979E02CB1414018837CD36B2C53C0E4FD79E044AD4140E6E3D128252753C098F7CE353AAB414078A57CD3572153C0707479E014A841402CEA7CD3CF1F53C0B87A248BDFA74140D80A7CD3A11F53C0E819CF3586A64140765AD128351F53C02004258B4FA54140BE607CD33F1E53C0BCC5CF3582A341409CDD267E1A1E53C0D8B2CE35A2A24140BE607CD3BF1E53C020B979E06CA041404006D228F11E53C05CD2258B179F41400C67277E8A1F53C064A3CF35769D41409BDD267EFA2053C068557BE07C9D414040BB267E2E2453C0D048258BA79E414040BB267E2E2453C087427AE0DC9D41400C67277EAA2253C060BF248BB79C4140E6E3D128E52153C098427AE0DC9B414030EA7CD38F2153C01017268BAF9A41402EEA7CD3EF2153C048D2258B979941404E947CD3D12253C02FB6D035D6994140745AD128952453C044B6D035169B4140F8FF267EA62553C0D0FD79E0C49A41402E9FD1286D2653C05CD2258BD7994140BC607CD3FF2653C0C02CD035E69841405CFB7CD3752753C05BA3CF35769841405422277E722853C07C0AD0355A984140C0AB277E822953C04C877AE0F4974140A7B67CD37D2A53C0D848258B279741406889277E362B53C040B6D035D6954140ACF97BD35B2A53C0740AD0355A954140332D7CD3AD2753C00CCC7AE00C95414006D97CD3E92653C093427AE05C9441400C67277E4A2653C0908D258B7F9341406A89277E962553C00881CF352A934140745AD128952453C058D2258B17944140F0717CD3E52453C044B6D035569441405022277E322553C0E4FD79E0C4944140AE44277E7E2553C00CCC7AE00C954140AE44277E7E2553C040B6D035D6954140745AD128952453C0E493D035CA964140C0AB277E822353C00881CF352A934140BC607CD3DF2353C018B979E0EC8F4140CE7CD128412553C0988D258B7F8D4140A4B67CD33D2753C010E8CF354E8C4140FE4AD228E92653C074BF248B378A41401C837CD32B2953C030D5CE356E874140DC0A7CD3012C53C0DCFD79E0C4844140EE717CD3652D53C0C4C5CF35028341405BFB7CD3752E53C0543CCF3512804140309FD128ED3053C0985ECF359E7E41405422277EB23353C0A05ECF355E7E4140623E7CD3B33553C0E893D0350A7F414002D97CD3E93753C094427AE01C8141402E9FD128AD3953C068557BE07C8341402EEA7CD38F3C53C00436248BC7884140FA4AD228693D53C0780AD0359A894140C4AB277EC23F53C074BF248B378B4140F6FF267EC64253C0E0B2CE3562924140623E7CD3134553C058D2258B17944140944F7CD3594253C05FA3CF35B68C4140AAF97BD33B4253C0700AD0355A8B4140AAF97BD3FB4053C0700AD0355A8A41405EFB7CD3F53F53C04F877AE0F4874140AEF97BD37B3E53C00436248B87824140329FD1282D3C53C00C81CF356A7D41401A837CD38B3953C0D02CD035667B4140FA4AD228A93653C000CC7AE08C7A414040BB267E8E3353C024B979E0EC784140745AD128553153C00CCC7AE04C764140061C7CD3073153C0DC48258B67754140D5C77CD3C33053C0EB93D035CA74414060FB7CD3753053C068BF248B77744140C0607CD3FF2F53C030D5CE35AE744140ACF97BD35B2F53C068557BE0FC754140061C7CD3A72D53C0EF19CF3506774140F4FF267E862C53C0988D258BBF784140603E7CD3732B53C0F8CB7AE0CC7A41406689277E562A53C08071D0357E7C4140A6B67CD31D2953C03CD5CE35EE7D41402CEA7CD36F2853C050D2258B577E4140332D7CD3AD2753C07871D0353E7E4140623E7CD3132753C09C8D258B7F7D41404206D228912653C0D893D0354A7C4140ABF97BD33B2653C00881CF352A7B4140F8FF267E262653C00881CF35AA7A4140EE717CD3052553C0D048258BA77941400E67277E8A2353C0C82CD035E67741402E9FD1288D2253C018E8CF354E774140BE607CD3DF2253C0DC93D035CA794140CF7CD128412453C040B6D035567D4140D1C77CD3632453C0E4B2CE35227F41406689277E162353C00781CF35EA7F4140F5FF267E262253C028B979E0EC7F41401E837CD32B2153C0E448258BA77F4140765AD128352053C0F880CF35AA7E414062FB7CD3551F53C08071D0357E7C4140603E7CD3F31E53C0700AD0355A7E4140081C7CD3E71E53C060A3CF3536804140954F7CD3F91E53C048877AE0F48141404006D228F11E53C068557BE07C834140F6FF267E861E53C0B7C5CF3542854140E6E3D128C51D53C0DC48258BA78741400E67277E0A1D53C0BF107BE0648941407AA57CD3B71C53C0F780CF352A894140663E7CD3931C53C0780AD0359A8841409ADD267EFA1B53C0F035248B0787414078A57CD3D71B53C000CC7AE08C8641400C67277EEA1B53C018E8CF354E854140B044277E3E1C53C0FC35248B478341404E947CD3511C53C0E0B2CE35228241400C67277E2A1B53C098F7CE357A7F414040BB267ECE1A53C0F019CF35467E4140E6E3D128251B53C008CC7AE08C7D41404E947CD3D11C53C0780AD0351A7C41402E9FD1284D1D53C02CD5CE352E7C414078A57CD3B71D53C053A3CF35F67B4140F6FF267E061E53C00881CF35AA7A41402D9FD1280D1E53C05CD2258B97794140A4B67CD3DD1D53C0985ECF35DE7841403EBB267E8E1D53C0B7107BE0647841404206D228311D53C004CC7AE00C784140E4E3D128251C53C0BF2CD03526784140924F7CD3591953C0AC5ECF359E794140FC4AD228C91853C0680AD0355A79414002D97CD3291853C0B77A248B9F7B41402E9FD128CD1653C00081CF356A7C41403CBB267E6E1553C01CE8CF358E7C414030EA7CD3CF1453C0C0107BE0E47C4140D90A7CD3011553C0A05ECF35DE7E4140765AD128151653C0503CCF3592814140944F7CD3991653C068557BE07C834140B044277E9E1453C0F8CB7AE08C824140C0607CD39F1353C0C02CD03566804140FC4AD228C91253C018E8CF350E7E4140EE717CD3451153C08071D0357E7C4140EE717CD3451153C0EC93D0358A7B4140DA0A7CD3E11153C044B6D035D67A4140FC4AD228C91253C018E8CF35CE784140BE607CD37F1353C004CC7AE00C784140C4AB277E821453C0888D258BFF774140C2607CD33F1553C074BF248B77784140F84AD228C91553C0FC35248B47784140FC4AD228291653C00CCC7AE04C764140F0717CD3051653C0988D258BFF744140A6B67CD39D1553C0304FD03532744140AAF97BD37B1553C0E0B2CE3522734140FC4AD228291653C018E8CF350E71414062FB7CD3B51653C02404258B4F70414076A57CD3371953C030D5CE356E6E41406A89277E561953C0B87A248B1F6F4140A8B67CD39D1953C06F7479E0547041404E947CD3B11953C018E8CF350E71414088C1D128191A53C018E8CF350E7141404206D228511A53C03CB6D03516704140904F7CD3591A53C00481CF35EA6D4140091C7CD3871A53C038D5CE35AE6C41401D837CD3EB1A53C064A3CF35766B4140309FD1284D1B53C060BF248BB76A41404E947CD3511C53C00317268B2F6941406789277E761E53C07871D035BE64414002D97CD3E91E53C018B979E02C644140B044277E5E1F53C07871D035BE6341404A947CD3D11F53C0CB2CD03526634140BC607CD33F2053C0A75ECF351E624140BC607CD33F2053C034D5CE356E6141400C67277E0A2053C0D048258BA76041404606D228F11F53C0B8C5CF35C25F4140BC607CD33F2053C0204FD035B25E41404206D228D12053C0888D258BFF5D4140745AD128752153C00017268BAF5D4140BE607CD3DF2253C09C8D258BBF5D41409F28D2283D2453C00036248B875E41408AC1D128592553C00781CF352A604140EF717CD3A52553C0B87A248B1F624140745AD128952453C0204FD035F26341408CC1D128F92553C078557BE0FC654140DE0A7CD3E12653C030D5CE352E6841401E837CD36B2753C048877AE07468414048947CD3D12753C0503CCF35925D4140C2AB277E822853C0E319CF35C65A4140BC607CD31F2A53C0CC2CD035665C41404406D228912A53C0F880CF35EA5E414030EA7CD3AF2A53C0F419CF3546624140705AD128F52A53C094F7CE353A6541409ADD267EDA2B53C08871D0357E6641402E9FD1286D2D53C05CA3CF35F6654140D2C77CD3032F53C058D2258B97644140EAE3D128653053C00881CF35AA624140745AD128553153C0304FD035726041403EBB267E4E3053C00036248B87604140924F7CD3B92F53C048D2258BD76041404A947CD3312F53C0985ECF355E61414062FB7CD3B52E53C0A75ECF351E6241404206D228512D53C0888D258B7F5E41402E9FD128ED2C53C0B87A248BDF5C4140904F7CD3593953C0A05ECF359E5E4140329FD1286D3B53C0CC2CD035665C414000D97CD3A94453C050D2258BD7574140F3FF267E464553C0C82CD0352657414076A57CD3F74553C0DC48258BA756414049947CD3914653C040877AE0745741405222277E924653C0B07A248BDF5841408CC1D128794553C0C0C5CF35425A41409D28D228DD4653C09C8D258BBF5D4140E8E3D128454753C077557BE0BC604140C2AB277E424753C08871D0353E6141403A2D7CD36D4853C030B6D035966141405222277E724853C02C4FD035B25F4140AAF97BD3FB4753C068557BE07C5D41405322277EB24753C0B87A248BDF5C4140309FD128CD4753C00481CF35AA5A4140329FD1282D4853C07871D035BE584140C0AB277EC24853C050D2258B575741409F28D2287D4953C02CD5CE35AE5641400A1C7CD3E74953C0EF35248B07574140DC0A7CD3414A53C03CD5CE35EE574140F8FF267EA64A53C0C82CD035A65841404E947CD3314B53C0BCC5CF3582584140BE607CD33F4B53C018B979E0AC57414030EA7CD3AF4A53C0BF107BE064554140964F7CD3F94A53C034D5CE35EE544140EE717CD3E54C53C0E893D0354A5341409EDD267E3A5053C0687479E0144C4140DC0A7CD3015253C00017268B6F4A41400A1C7CD3C75253C0EC93D0350A4A41409EDD267E5A5453C08CF7CE353A48414005D97CD3895553C0543CCF35D24741406489277ED65653C0A45ECF35DE4941404C947CD3115753C0B0C5CF35024A4140081C7CD3675753C0908D258B7F4A41404C947CD3B15953C0D02CD035664B4140C4AB277EC25853C0948D258B3F4D414060FB7CD3F55553C01CE8CF35CE5041405622277E525553C03CD5CE352E53414006D97CD3C95553C07C0AD0359A54414076A57CD3375853C0E0FD79E0C4594140CC7CD128415953C0A87A248B1F5B4140CC7CD128415953C027B979E0EC5B41404E947CD3315853C078557BE0FC5B4140DC0A7CD3015853C053A3CF35B65C41404606D228715853C07B557BE0BC5D4140CC7CD128415953C0204FD035B25E41405022277ED25953C097F7CE35BA5E41409ADD267E7A5A53C0334FD035725E41403A2D7CD32D5B53C07C557BE0BC5E4140CC7CD128E15B53C0304FD035726041401C837CD36B5B53C0C0C5CF35C2594140D80A7CD3015B53C0B87A248B9F5741402EEA7CD32F5A53C0FF16268B6F584140E6E3D128655953C0EB19CF3586574140CC7CD128C15853C0F419CF35C6554140D80A7CD3615853C010E8CF350E544140944F7CD3795853C0C82CD035E6504140FE4AD228695953C098427AE05C4F4140A228D2287D5A53C068BF248BF74E4140D80A7CD3015B53C0908D258B3F4F4140EF717CD3455B53C0E019CF35C64F4140AC44277EDE5B53C02FD5CE35AE4F414098DD267E7A5C53C0F8CB7AE00C4F414003D97CD3C95C53C00C17268BEF4D41403EBB267E8E5C53C0D048258BE74C414087C1D128F95B53C0204FD035724B414018837CD34B5B53C0D8B2CE35224A414000D97CD3C95A53C04C3CCF3592494140D6C77CD3A35953C0780AD0351A494140FAFF267E865853C070BF248BF747414004D97CD3095853C0E093D0358A4641400A1C7CD3C75853C040877AE0344541400A1C7CD3C75853C06C7479E0544441402EEA7CD36F5853C0DC48258BE7434140BE607CD33F5853C088F7CE357A434140623E7CD3D35853C0CC2CD035E6424140AEF97BD3DB5953C0B0C5CF3542424140FA4AD228295D53C034D5CE35AE4041401E837CD34B6253C090F7CE35FA3B4140EC717CD3C56A53C0CC2CD03526304140C0607CD3BF6E53C038D5CE356E284140A4B67CD33D7253C0E493D0358A1F4140C2AB277E427453C05CA3CF35761C41400E67277E4A7553C09C8D258B7F1A41401C837CD30B7653C0D42CD03566164140AE44277E7E7753C064BF248BB71141406689277EF67753C0D42CD035A60F4140FC4AD228297953C0E793D0358A01414030EA7CD34F7A53C0B4107BE0A4FA40400C67277E4A7C53C0680AD0351AF74040C6AB277EC27B53C058A3CF3576F940400A67277EAA7B53C050D2258B97FA4040EAE3D128E57B53C000CC7AE08CFB4040EAE3D128E57B53C048D2258B57FC404060FB7CD3F57A53C0D8B2CE3522004140A7B67CD37D7B53C068BF248B370A4140A8F97BD3FB7A53C0C02CD035E60D4140603E7CD3337C53C0C72CD035E6124140663E7CD3337D53C060BF248B7718414099DD267E9A7D53C060BF248B77184140C0607CD39F7D53C0E4B2CE35E21441405622277EF27C53C07871D035BE0B41400C67277E4A7C53C0D048258BA70841406F5AD128B57C53C0B87A248BDF064140745AD128D57C53C0B0C5CF35C2044140D6C77CD3C37C53C0700AD0355A004140CE7CD128017D53C0DC48258BA7FE404075A57CD3377E53C01417268BEFF940405622277E928053C004CC7AE0CCF34040D4C77CD3238153C088F7CE35BAF240404C947CD3118253C058A3CF3536F24040081C7CD3278353C00081CF356AF2404040BB267EEE8853C0B8107BE024F54040081C7CD3278A53C0700AD0355AF540404A947CD3B18D53C028D5CE352EF54040EE717CD3858E53C040B6D035D6F54040F84AD228299053C00881CF356AF6404073A57CD3579553C08B71D0357EF44040CC7CD128819753C0700AD0355AF540404406D228319753C000CC7AE04CF64040F6FF267E269753C05CD2258B57F74040CC7CD128819753C05FBF248BB7F940409CDD267EFA9753C05FBF248BB7F94040C6AB277EA29853C048D2258B17F64040CC7CD128219A53C008CC7AE08CF44040C6AB277E229E53C088F7CE35BAF24040FAFF267EC6A353C078557BE03CEF4040755AD12835A353C09C427AE09CF04040081C7CD3E7A253C02004258B0FF14040081C7CD3E7A253C094427AE0DCF14040E45D6769AEA453C07816CE3EF9F04040928B61B3AEA453C0181FE3BBF9F040408C4060B3E0A853C00472E4BB11F8404068ABFA4C12AD53C0746517EF28FF404092E62D8043B153C0E0E77D553F0641407CC294E675B553C0AFC9B288560D4140F03E2D80A7B953C0B0CEE3BB6D144140D2A9C719D9BD53C038C216EF841B41407E1D61B30AC253C00CA44B229C2241406088FB4C3CC653C07C977E55B3294140DA0494E66DCA53C0E88AB188CA30414006B193E69FCE53C0E88FE2BBE1374140E81B2E80D1D253C0D47117EFF83E4140948FC71903D753C044654A2210464140FC32C81935DB53C0AF587D55274D414070AF60B366DF53C0843AB2883E544140521AFB4C98E353C0009FB188565B414084C6FA4CCAE753C00C3316EF6C624140F6F1C619D3E953C02090B088DA6541403A51FA4C1AEB53C0B8E84922906641408695C7190BED53C004A217EF246741408AD52D806FEF53C008A77D553B674140E8CEFA4C26F053C05C5F4A22446741408477FA4C2CF253C0C05E17EF5467414060D1C71951F553C008AB7D5573674140C2F8FA4C64F953C088AFB0889A6741403C9961B336FE53C0B82A4922C8674140E26FC719990354C0049A7C55FB6741407216FA4C5A0954C03C3919EF30684140A4A094E64B0F54C0C330B0886A68414020FBC7193D1554C018947E55A368414036DA60B3FE1A54C00B27B288DA684140547860B3602054C0D73617EF0C6941404EE060B3322554C020237C553B6941403140FA4C462954C0884516EF60694140866161B36A2C54C02F0FB2887E694140280A61B3702E54C0B361E4BB91694140500C2D80272F54C0D0C64B2298694140AA8393E6AD3154C07C7EE5BBB16941405AE12D802D3254C09028B088EE694140A0E6FA4C923254C0C022B288966A4140865661B3B43254C0E7504C22646B4140B29460B3BA3254C0C8247E55476C41408267C719793254C07CA9B18882794140584394E6853254C044DDE4BB557A4140CEF0C619BF3254C03053B2881A7B41409E7761B38A3554C0AC08E6BB3181414076DA94E6FD3854C067337E55B78841402C7794E6553B54C010637F55D78D4140C3302E808B3B54C0884D4B22388E4140A4BA60B3C03B54C070CE7C556B8E4140EE4C61B3083C54C02CC8B088768E4140C45461B3783C54C0309C7D55138E4140E2CF93E6C54154C0DC944A22D8874140261495E6214254C020D84A22A8874140148B61B3764254C0B06C17EFAC8741401A8161B3E44254C01C794A2244884140E381FB4C224354C030507F55D7884140DAEDC619594354C03CD317EF748941406252FB4C704354C034034B22108A41405CF2F94C804354C0644B4C22A48A4140718493E6794354C0D0F8E3BB298B41409437FA4C6C4354C058774922A08B4140B62094E6534354C0C4544A22288C414002DD60B39A4254C08C97E5BB998E4140CCB1C719754254C0D0B4E3BB418F41408EF9FA4C6C4254C0BB254B22F08F4140C637FA4C724254C02837E4BB9D9041408E6CC719894254C0343D4B2240914140C22694E6AD4254C0AC7916EFC49141407072C719DD4254C0F8F1AF8846924140FA0A94E6194354C0708E7C55BB924140AE7994E65D4354C0047FE5BB25934140F0412D80E74354C030CF4B227C9341409E3761B3B44454C0548B18EFBC93414036DAC719A94854C0009A17EF10944140008694E6F14B54C030BB4B22589441408D21FA4C005054C0FCBDE5BBB1944140702B94E6B15454C020AE4A22189541404C6361B3E25954C06C1519EF8895414048CAC719715F54C07FB77E5503964140508893E6396554C0309B4B2280964140D042C8191B6B54C070A218EF00974140600CC819F17054C034D94A2280974140526C2D80997654C064EC7C55FB9741402870C719F17B54C04C774B227098414054E994E6D58054C07CEA7E55DB984140810861B3248554C058B14A223899414002E4F94CBA8854C0789C4922889941409E62C819758B54C0E0527D55C3994140E807FB4C328D54C060E6E3BBE99941409AD861B3CE8D54C02851E4BBF59941407C662E80619254C0AC4DB2885A9A4140DA6BFA4C389754C06C4E4A229C994140665DC7197F9754C0E0527D55C3994140A0B42E80BB9754C02803E5BB099A4140B26294E6E39754C0B8BE7E555B9A4140CC6E60B32C9854C038464A22209B41400E6DC7195F9854C0D8957D55879B4140D86460B39A9854C00769B288E29B4140D6F294E6099954C00898E4BBF19B414008B6C7197D9954C0BFE77C55AB9B4140E9D694E66F9A54C0F8C14B22A49A4140A8F3FA4CDC9A54C06009B188FE9941402E35C7192B9B54C0486FB088469941407270C719859B54C0949EE2BB619741405176C719D99B54C00C807E55DB96414044332E80579C54C040AC16EF909641407FAF93E6A59E54C08835B1888A964140227994E60F9F54C02432E4BB419641405295C7198D9F54C04450B08892954140103660B3DA9F54C0C81F4A2208954140787DC71931A054C0E00A7F55BF944140E2F8C619ADA054C040A1E4BB91944140C2C2FA4CFAA254C0D0A117EF809441409C94C71975A354C0F831B1885E94414010F62D80BBA654C00CEFB0889A92414082D3FA4CD8A854C0B82FB288CA9041406D032E8073A954C018E07E55639041407B13FA4CF4A954C07C16E3BB4590414096FDF94CB4AA54C0980FE4BB61904140064CC7193DAB54C0281017EF509041400E42C719ABAB54C000DA17EFC08F414024C3FA4CE0AB54C068817E550B8F4140E2A2C71925AC54C0F0A6B288968D41405A3F94E699AC54C0A0B3AF88D28C4140D43BC7194BAD54C02F6E7E55FF8B41406AD4FA4CD0AE54C0840F7E55A78A41409686C7197FAF54C0E89317EFDC894140566FFA4C12B054C038B04A2260894140367EFB4C68B054C000467D554389414006D6FA4CE0B054C0B743B1888689414066F193E61FB154C0CF744A22008A41406AAAFA4C66B154C04035E5BB158B4140F6C060B372B354C06F954B22588A41407C86C7192DC654C0107217EF14804140D1E3FA4C58C754C048FBB1880E804140EA182E802FCC54C038737D55F37F4140D65660B306D154C070D94A22D87F41401812C819DDD554C0506F7D55BB7F4140FE4FFA4CB4DA54C098D54A22A07F4140944CC7198BDF54C06C6B7D55837F4140A4102E8061E454C0AF4217EF687F4140427EC71939E954C0F819B1884E7F4140D97A94E60FEE54C0480FB288327F4140388060B3E6F254C010A5E4BB157F41408EAC94E6BDF754C070ED4A22FC7E41401EA961B394FC54C048D6E2BBE17E414084AE2D806B0155C0805A17EFC47E4140947294E6410655C0D0C0E4BBA97E41402A6F61B3180B55C02427B2888E7E4140C8DCFA4CF00F55C0FC9E7D55737E4140A8A960B3C61455C03F054B22587E4140864494E6731455C090444C22588441406365FA4C1E1455C0382F7E55738A4140D80061B3BA1355C0F03FE5BB999141407ADCC619791355C0147F7D554F96414018CA2E803B1355C0C0A97D55AB9A4140A6F793E61D1355C0B09417EFA89B41404EC994E6FD1255C0D46B4C223C9C414002C4C719991255C09FB9B0886E9D4140213994E6D71155C0675E4B22F09E41401A0EFB4CB81055C004A7E4BBB9A041408EA060B3521055C0D0D1B1883EA14140B00DC819CF0F55C02FEBAF88AEA1414040EAC719D10E55C07893B28832A241400E04C819490E55C07B81B0882EA2414074B494E6E10D55C040D7E5BBF1A14140CAD0C719650D55C07C91B0881AA14140EA1AC719190D55C004A7E4BBB9A04140DDA094E6C90C55C0E45BE4BB79A04140D8A193E6590C55C0F07AB18856A04140D88661B36E0B55C0D4A47D554FA0414077EBC719FB0755C07C3FB188F6A04140135DFB4C560655C0C0C84B22F0A0414084BB2D80170655C0501B7E5503A14140287BC719A70555C0D4C94C227CA14140C833FB4C040555C08C3817EF58A2414072B3FA4CC40355C0A89C4B2264A441409C882D803F0355C0B891B1888EA54140E55861B3F20255C09CAB7D559BA64140BA6861B3D80255C007567F55B3AA4140249C61B3C20255C0C0724A226CAB4140A0AA94E67B0255C09784B188B6AC41403A38FB4C4E0255C0A4074A2254AD4140317E2E802F0155C0A8364A22F4AF414054ACC619010155C0406C16EF94B04140B6A42D80DF0055C070D7E4BB3DB14140829C61B3CE0055C0D017B088FAB14140CAC5FA4CD80055C068D04A22A0B24140DC60FA4C200155C0380EE5BB4DB44140562894E61F0155C0CC1B7E55C3B44140B83AC719110155C074E1E3BB41B5414020A4FA4CF00055C0A0247F55BFB54140D0C3FA4CBC0055C0F030B28856B64140E08960B346FF54C0B306B088EAB84140570BFB4CD0FE54C090C516EF84B941409822C8193DFE54C0F8314B220CBA414034F4FA4C8CFB54C0005F492294BB414060ECFA4C1CFB54C04C49E6BB09BC4140E07C60B39AFA54C0208EE4BBEDBC41407897FA4C50FA54C05476E4BB91BD4140322761B344F954C0BCFC17EF08C1414073CBC619E1F854C0402D7E5593C14140DEB8C71955F854C0AC0A7F551BC24140825D94E645F754C0C4FEE3BBB9C24140508893E639F554C0C0A449226CC341408AF860B3B0F454C0982AB288CAC3414088DD93E611F454C0CCD17D555BC441409D812D8013F354C050CB16EFACC5414082B093E68DF154C080404C2230C74140A28F61B34EF054C0F803E6BBF1C7414042D4C71903EF54C07804E3BB79C841409A0AC71999EE54C04CFE16EF84C8414064582E8055EC54C08B0D7F552FC841403E9360B312EC54C03884E4BB35C84140D056FA4CDAEB54C03C95AF8846C8414080FAC7193BEB54C0F81A18EFA4C84140D0BFFA4CD0EA54C07C9C7C55C7C84140A8BD93E665EA54C0A401E4BBCDC8414068E294E6FBE954C0ECD87D55B3C8414040392E809BE954C04B81E5BB89C841408EB8C61907E954C078B6E3BB8DC84140D20CC8194FE854C0DC96E3BBC1C841403ABC2E800FE754C064FC18EF64C941402A2794E66DE654C07F9D7D5553C94140EB78C719F7E554C0703416EF14C94140BE422D80B3E554C0F81A18EFA4C8414080DAFA4C66E554C05FE94B223CC841402E2E2E800BE554C088F216EFDCC74140A6FFC7199DE454C0144EE5BBA5C7414004E6C7192BE454C0B0BFE4BB95C74140350DC719F3DF54C0180617EFF4C841406ACF93E68DDF54C0E408B1884EC9414072FA60B318DF54C0E87A7E55DBC941409E252E80A9DD54C0A84716EF20CC4140954094E6FFDC54C080CA49226CCD41401EFDC71995DC54C0682AE6BB09CE4140389761B304DC54C0703CB288A6CE414068A5FA4C92D854C0F8254B220CD14140145A2E80B7D754C0245D4B2228D241408A7261B302D754C07C2D4B2270D3414068F2C71911D654C0ACDE7D55DBD44140D4CDC61981D554C0C09E4A2254D541407436FB4CD6D454C0884FE5BB89D54140C2BE94E643D454C0B37318EF7CD541403BA8FA4CCCD354C0F8B618EF4CD54140DA9DC71951D354C040E0B18856D541405AE02D80E3D254C0E07DE4BBA9D54140D05761B392D154C0874A17EF9CD84140D2AEFA4C38D054C01842B288CEDA4140EC1BC71901D054C0AC4F4B2244DB4140C47260B3A0CF54C0B09E4B22BCDB41400AADFA4C22CF54C0F0F317EF28DC414020A793E685CD54C0C85BE3BB21DD4140A47D2E80E1CC54C078147E55C7DD414002AA61B350CB54C08C144C2258E041403CDDFA4CECCA54C0DC4BB188C6E04140EEF394E669CA54C043E317EF24E141403ACA61B32EC854C0A891B08836E241400E8793E6D3C454C094E217EF0CE54140827BFA4C7AC454C0E0A4B08842E54140C38161B322C454C098AA492248E54140245FFB4C62C354C0DB36E3BBEDE441403248C719B9C054C02C88E5BB89E44140641294E6C9BF54C008F74A2220E44140D13C2E8065BF54C0E095E3BB51E441408AC494E6E3BE54C0CC2518EFDCE441405024C8193DBD54C0C04317EF04E84140A6D62D80A9BB54C054794C22E4EB4140223C61B350BB54C0A05617EF04ED4140E569C81935BB54C054807E55ABED414008F160B310BB54C0A8507E55F3EE4140B81061B3DCBA54C008CE7D558BEF4140B482C71921BA54C0B87218EF0CF14140FA15C719F9B954C027184B22D0F14140DCC261B3F6B954C0F805E4BB79F24140C11FC71985BA54C08393B1888EF4414074482D809FBA54C09BF8E2BB2DF54140103FFB4CB0BA54C040344C22D8F54140828CC719ADBA54C058BC4A228CF641408ADAC61999BA54C080C717EF44F74140649AC71977BA54C0888BE4BBF5F7414085D160B34ABA54C0AC6219EF88F84140E6A6FA4C14BA54C0D0154A2214F94140C47761B3B6B954C0A04017EF98F941406F85FA4C32B954C030AEB188FEF941404C3B94E635B854C0C4694B2250FA41402E7461B38AB754C028B717EF4CFA41400AAF2E80FBB654C0F8B8B0881AFA4140146F94E62BB654C070E84B2280F94140F9B8C71945B554C0E8C7AF887AF84140709BC7199BB454C0CBD6492288F74140C183C71945B454C0807918EF58F74140921094E6D9B354C058D77C5577F74140CC4C2E8077B354C0F8B5E3BBDDF74140722694E619B354C0B0597D55D3F84140F62161B3F2B254C0FF3A7E5593F9414072E094E6A3B254C0F4B9B188A6FA41405A6761B3E4B154C06C71B08806FC4140E67AFA4CB4B154C070E37D5593FC4140EA072E8097B154C0E0B3E2BB2DFD4140C804C8199DB154C0BC557E5503FF4140800861B386B154C0347519EF7CFF41409A272E8063B154C02BADB188DAFF4140BC8194E64BB154C058284A2208004240DE8961B3EAAC54C000937D55EB034240EC35FB4C62AB54C0E06C4C22D804424082DBFA4C4EA854C0140E7F55570742405843FA4CB2A754C0687DB2888A07424050FDFA4C3CA754C0201F4A2268074240A9FFC619F9A654C0285318EFF4064240752AC819E9A554C0E8E017EF84044240E0E3FA4CD0A554C03CC016EF2C044240CA0162B3CEA554C01CB24A22C8034240FE592D80E7A554C0788D4922380342403BEE2D804BA654C040C6E5BBA5014240E2A5C71965A654C09CF2E2BBAD004240E2F5C6196DA654C0AC8E17EFECFF41407E70C7195FA654C078834A2234FF41402A532E8003A654C0ABB67C5587FD4140BED793E6D3A554C09F56B188FEFC414080922E809BA554C0C89CB0887AFC4140E20EC8195BA554C0C0DCE3BB01FC41404EE261B308A554C0C8B0B0889EFB41402E1B94E6A9A454C018137E554BFB4140DF54FB4C3CA454C087A9E3BB1DFB41407079FA4CD0A354C06C567E551BFB414024742D806BA354C044C6E4BB3DFB414054A961B3D6A254C080AAE4BBA9FB414082E52D80E39F54C09CE7B088AEFE4140A8A9FA4C9A9F54C000BC4B22E8FE4140C2FCFA4C509F54C0F753E5BB35FF4140C277C719E39E54C074244A22D0FF414043612D806B9E54C0B81616EFA0004240794561B3429D54C06788E3BB21034240E1D9C619F99C54C0B8AA18EFF403424024412E80219C54C064F9E2BBF9064240EA6D94E6799B54C0CC74E4BB71084240CC5E60B3409954C0704B7E553F0C4240D8C560B31A9854C010D9B088A60D4240B622FA4C149754C0C8CA4922880E4240502B2D80799654C05B38E4BBED0E42408DC660B3329454C05C88E5BBF10F4240AA3AC719999254C0309A4C223C1142407FC593E6119254C0CFC2B288561142401EF02D80B39054C00C46B08846114240685E60B35A9054C0003E4B2284114240FEFC60B35C8E54C0A0F8B188DA1342408A21FB4CA48D54C028A64922601442401A69C7194D8D54C0D4E0B1887E144240825F2E800F8D54C0C4FE18EF7C1442409ADF60B3B88C54C08800B2884A144240F688C7191F8C54C070D77D5593134240A26B2E80C38B54C00863E4BB491342400E3DC819558B54C0EB69E3BB2D1342406E9E94E6758A54C0F73AB1881E134240300A94E6118A54C0949BE5BBFD12424054B494E6B58954C084AFAF88BA124240A04594E6718954C0C4BE17EF641242405E472D803F8954C020FE17EFFC114240B6CEC7191D8954C06015E5BB6911424068D260B3068954C0E81417EFCC1042405A97C719FB8854C07032B0882E1042409062FA4CE48854C064CD7E558F0F4240FACB2D80C38854C03FEAE4BB010F4240B003FA4C868854C010C5B088820E4240888661B33C8854C07B93E4BB190E424034DA94E6E18754C0A49CAF88BA0D42401A49FA4C788754C073CF17EF680D4240FE7861B37E8654C01886B088F60C42404E1BC719FF8554C06CEC7D55DB0C4240D67EFA4C8A8554C007814A22E00C42407ECBC719FD8454C09C5FB188460D424004E960B35E8454C0F87CAF88EE0D4240868AC719558354C02CE0E2BB6D0F42405181FA4CB88254C050E7AF88EE0F42406601C819158254C0B00E4B22D8104240F602FA4C948154C0204C17EFE8114240AA00C819237B54C0F4B74A22A42542401F0FFB4CDC7A54C0089BE4BB31264240D860C7191D7954C02897B2888A284240300694E6257454C0379A17EFF02D42401D1294E6D37354C010BC7E55272E42405A68FA4C847354C0209E17EF282E4240AC9CC619217054C0C0EA7D55532C42400A4DC719256E54C0D871B188E22B42405A8EC719D96D54C014CA7C55FB2B42407C1E61B3B66D54C0FC1317EF5C2C4240F0E7FA4CD26D54C0DC727C55072D4240DC92FA4C006E54C0DF6718EF982D4240046A94E6DF6E54C060C016EF942F4240DCD1FA4C8C6F54C0A82E17EFCC314240D6D3FA4CA86F54C0CC11B1885A32424048D1C7199D6F54C0F46218EF3C3342402265FA4C646F54C0203A17EF68344240DAD993E6B96D54C0E896B188CA394240ADCE61B3B46C54C0E382E4BB7D3E4240E7862E80BD6C54C0D3B318EFA43F4240189060B3A66D54C000D8E3BBC14242404A8961B3C26D54C07C497E555F434240045FC7192D6D54C0571317EFF84542403E6C61B32A6A54C08CAAE3BB054E4240F09CC719BB6954C0E81CB1889E4C4240DECB94E67D6954C063C118EF3C4C4240529D2E800F6954C01852E5BB094C42402254C719A36754C0F0EC7D55034C42401C0CFA4C806454C0F8C04A22A04B4240C082C7195D6154C0F49417EF3C4B4240B23AFA4C3A5E54C0FC68E4BBD94A4240DCE92D80175B54C0E83CB188764A4240069961B3F45754C0EF107E55134A4240005194E6D15454C0ECE44A22B04942402A00C819AF5154C0F3B817EF4C4942401BB8FA4C8C4E54C0DF8CE4BBE94842405FC32D80254A54C097407E55CB4842409ECE60B3BE4554C0FC0516EFAC484240DCD993E6574154C007A8B1888E48424050DCC719F13C54C0CCEA7E556F4842408EE7FA4C8A3854C00F3F4A2250484240D2F22D80233454C02CE1E5BB3148424008FE60B3BC2F54C080A67D55134842407E0095E6552B54C0385A17EFF44742405A1D61B3A22654C06C75E4BB9947424062312E80EF2154C08F1FE5BB3D4742406A45FB4C3C1D54C038DBE3BBE14642404662C719891854C078F6B088864642404E7694E6D51354C090A0B1882A464240548A61B3220F54C0C44AB288CE454240629E2E806F0A54C088777D5573454240,-18.7%,-204,888,158,730,North Carolina,true
39,0106000020E610000002000000010300000001000000BF020000EC0CAAA5AAFF5EC038FF27DA301C47408E5E09E107FF5EC0C8AA251DE51A47403F7B75BB02FE5EC0FF56E879F31A474046303941DDFC5EC0F0BDFAEA3D1A474065A52E1E20FB5EC06859FA8E69184740E1A5CC479EFA5EC0F00743C41D17474067C3DF3147FA5EC044FEC0993B17474070DE0E86DAF95EC0F0D880F60D17474041A6B3FBA4F95EC0E45D1C469515474007A6FB155FF85EC0D48D9752FD144740ACF97BD37BF75EC058A3CF357614474010D5F52071F55EC040D2637FCC1447408D5A6AB5CEF45EC0C03E38E1161447406FD4CD0263F45EC0289DBB16DA124740289FD1280DF45EC0700AD0355A104740C0607CD3FFF35EC097427AE09C0E4740AE44277E1EF35EC098427AE01C0D474073A57CD337F35EC04F3CCF35D20E4740C1E49BDA4AF35EC0C8C8BC6FAB104740A9388BCD3DF35EC0C83BA3F45F12474033EA7CD3CFF15EC008E8CF358E11474033EA7CD3CFF15EC0770AD0355A1247409F28D2285DF25EC0C0107BE024134740ED717CD3A5F35EC0344FD03572154740AAF97BD33BF45EC028D5CE35EE154740392D7CD3EDF45EC0F019CF350616474023826848FDF55EC05091B4A927164740A547759569F65EC0E8F95DC9AF1647409AD28D5217F75EC0CFC3941829174740529D850563F75EC07815432DDE174740DD8C536DCAF65EC0A88760DD371847401082FACE83F55EC0DCCCFA71541847409932507C89F45EC008D2DC1C44184740603E7CD313F35EC0E819CF35C6184740C881D8DED6F15EC00C56B605C71947406B1F5DC512F15EC0A45EB028201A4740F8CABAE74FF05EC0806465CE0F194740F2717CD325EF5EC018E8CF35CE16474010FC5F438AEE5EC088F2E465D01547406A375D562EED5EC0AF1317F4DC154740299FD1284DE75EC0985ECF35DE174740A7B67CD35DE65EC010E8CF358E1847409FE296F4AFE75EC0C800AEA32B19474079A57CD3B7E75EC067BF248B371A4740BE607CD3DFE65EC0C0C5CF35C21A474082626F8537E55EC0B85364FB701A47406A0716CC27E45EC030A5D416B81B47404EBEED5DB1E25EC01863909DF21C47407E55458357E25EC0AC5CFCD5F21D4740CAE399C53BE15EC0E83C3A4D1D1E47404006D228D1DF5EC000CC7AE0CC1D4740FA4AD22809DF5EC02B4FD035721D47400CA9D1FA47DE5EC030BE63B0D61B474048E176A5FBDC5EC0B8C2474D861A474021C91455FADB5EC0C017D69C62194740FEF03EB7A5DB5EC0B85A26BEF81747400536E37187DB5EC05843AEE39E1647405322277EF2DA5EC0C02CD035A61547403D7EE473FAD95EC0A8E047A74114474072FAF15FACD85EC070B7B620B6124740D1C91F8DDCD45EC0300FCD07C7114740B2C43B0729D35EC0671C3F080C124740A54E6CDDC4D15EC030A97FFC24114740E7DE917E69D05EC0487D42AB1011474042BB267EEECE5EC008E8CF358E1147401432795E25CE5EC0B4BE4C44DA12474000A2E69227CD5EC0B8E6C012121547409562D31F61CC5EC08F1EF4F00E164740912D65AC86CB5EC0CB8844D1EC164740FAEFCEBE57CB5EC03FE48198EF1647407754156D02CB5EC000CFDFB3D91647408B42FB4C28C75EC0D894B088DE174740F2F161B3E8C55EC0B3817E55631747403DB893E60DC55EC068D44B2230164740E4F993E6CDC25EC0A043B188D21347406767C719EBC15EC04091E2BB211347403E2F61B3F6BF5EC0F0B97E55A3124740E9ADFA4CDEBD5EC0C88F49226011474050C6C619E1BB5EC010357F55A70F47407F5BFA4C40BA5EC030407E55CF0D47405A7BFA4C12B95EC0EBABB188D60B47407D3E61B3F0B75EC0D77CB18836094740BF9CC71917B75EC068977D555B0647404C1161B366B65EC0C45F17EF780147408D6FC7198DB55EC0783D18EF0C004740954994E683B45EC0102B7E55D3FE4640093DFA4C9EB35EC088287F5533FD4640427994E63BB35EC0608316EF14FB4640ACB694E6B7B25EC048E3B1884AF5464082D694E689B15EC060DD17EFD0F04640C922FB4CA8B15EC0F83A7F5573EE4640301162B3F4B15EC03C3518EFDCEB4640F0DEC719E9B15EC0D7AFE5BBF1E84640C84561B374B05EC07077B18866E54640EA592D8033B05EC0C03B7E5523E44640C4AFC71943B05EC0AF4E7D55BBE246404230C81989B05EC0B86517EF44E046406EC7C71999B05EC07CB4E4BBD9DE4640AA1D2E8049B05EC08CBF4B22D8D94640075D2E80E1AF5EC09098B088FAD6464078E82D8049AF5EC0ACAC4B22D8D446400E5261B32EAE5EC0A475B0880ED3464077B92D80A9AC5EC0A873E4BB5DD14640B789FA4C14AB5EC0D0E44B2218D046400A65FA4C12A65EC0805DE5BBA5CE4640CB2F2E807DA35EC07F9BE4BBA5CF4640D22CC81989A25EC0BB30E4BB99CF464020402E8075A05EC060F77C5513CE464033172E802F9D5EC0BFAFE4BBD5CC464054792D80459B5EC0D470E4BB49CB46404A6DC719DD955EC0D41EE5BB25CB4640D8E4C719B5905EC0A03718EF7CC846401717FB4C788F5EC0A768B188F6C84640C162C7195F8E5EC05059E4BBF9C94640401B61B396895EC01740E3BB05CC46406C4794E6257E5EC0408F492238D24640C035C819957B5EC0D438E5BB7DD446405AFC2D8031775EC0180E7E55B3D94640DB44C81989745EC07CE8E4BBD5DB46403B7960B3BA725EC0BCEFB18856DC4640D1C393E6EB6D5EC0D326E4BBE1DA4640804561B37E645EC0D874B1885EDD464093E893E665515EC0D45116EFB8DA4640DA16FB4C5C4E5EC068B9E4BB35D946408B3DFA4C124D5EC07FCD4922ACD74640DE1C94E66D4C5EC048DF18EFCCD54640264E2D80ED4B5EC0C4B84B228CD3464084B8FA4C104B5EC0784EB088DED046409790C719EB495EC07F2A18EFA4CF4640B991C61981485EC090044C22E4CF46400C412E80CF425EC070A07D5593D346407214C8197D425EC0487C4A22A0D346407EDC2D8023415EC0270618EF88D34640255D2E806F405EC0D0024B2240D3464061E0C61913405EC007984A2234D34640B5A32D80F73D5EC034C07D555FD34640D7E2C619413D5EC0D07F7C553BD34640508F2E80553C5EC0E3614B22A4D246402B702E809B395EC0300DB28826D2464040B0FA4CE0365EC0878BB2884AD346401EE261B302365EC028314A2260D34640BF0BC719AD355EC0AC357D5587D346404FA961B3D6325EC0B8D64A22B4D6464010F293E65D325EC010DA17EFFCD6464004E793E6CD2D5EC0B0447D554FD84640388361B3CA2A5EC0D78D492208DA464075F393E68D2A5EC0FF7EAF88FADA46408D09FB4C1C2A5EC0407E17EFB8DB464009C6C71969285EC01099E4BB51DD4640BA0794E6BD275EC0944F18EF8CDD464035ACC719171E5EC0634AE4BBE5DA4640A66BFA4C581D5EC080D218EF00DB46401183C719CB1B5EC0AC864A2218DC46408067C7193D1B5EC0D701E3BB45DC46401D98FA4CF0175EC02F04E5BB69DB4640500162B334175EC024E517EF8CDB4640F170FA4CC0155EC0903C4B2264DC46402AACC7193D135EC058D54A2284DE4640CD7CC71991125EC08802E4BBC5DE4640F97CC71997115EC0C01AB288BEDE464047B5FA4CB40F5EC038EA4B2234DE46408FC161B3B60E5EC0383C4B2258DE464015CC2D80EF0C5EC078377D5577DF4640C5CFFA4C440B5EC0E4274B2228E1464085B5FB4C4E095EC04F67E3BBE9E346404C3A61B324085EC0EB0917EF00E546405DCAC71925055EC020F77C55BBE54640F9F494E6C9FB5DC05076B18842EB4640A5BD93E665EA5DC06B2A4C2298EF4640B85F61B3B6E75DC088CC7F55A3F246408229FB4CDEE55DC054664A22E8F54640F4DFC719D1E45DC02F9A7D55BBF6464090EFF94C20E35DC0604AE5BB01F746405AE393E6B1DE5DC09494E4BBB5F6464057A2C71975DB5DC03CA4E4BB95F746403E86FA4CD8D55DC0187E7D551BF946402DA6C719F9C55DC0BC9E7E5573F94640344994E6D9C25DC0387A4B2274FB46407BD060B326C05DC058D34A22F0FF46404F9A61B396BF5DC058D34A22F0FF464066F494E6A1BC5DC0D814B288F2FF46408697C71963B45DC0F849B088F6FF464096C92D8023AC5DC0203E4B22FCFF4640662BFB4CE4A35DC0A0F07E55FFFF46400C0794E6A59B5DC0D8B4B08802004740A47160B366935DC068497D550700474072D32D80278B5DC0685B7F550B004740BBFC94E6E7825DC0A01FB1880E004740DB9FC719A97A5DC020D2E4BB110047402A3AFB4C6A725DC0C066B18816004740C2A4C7192B6A5DC0688AB1881A004740D7D62D80EB615DC07B4EE3BB1D004740F77960B3AC595DC02472E3BB210047404D1494E66D515DC02084E5BB25004740167661B32E495DC05CB9E3BB29004740A66F61B3EE405DC0D06B17EF2C004740616161B33E385DC06C1E4B22300047406F0661B318385DC0A83518EF9CFF46406123C7198B375DC090CB17EFA8FB4640370E2E80AB355DC01050B08876F44640F5A2C719D9315DC080B9E4BBE9EE4640AE0761B342315DC0104FE4BBE9EC4640AD9393E699305DC05076B18842EB464076BB60B3042C5DC010D1E3BBD1E94640BA0861B3662B5DC078C6492208E94640A93E2D80132A5DC0D7E0B088DAE6464091CCC7195D265DC010B8B28896E346402E0FC719AD235DC040954A22D4E246405368C719BD225DC0BBBE7E5597E146405E282D80ED215DC038F57D5533E0464005BC93E619215DC0F85FB088AEDD4640DEDB93E6EB1F5DC0F8A2E5BB71D84640978E60B3AC1D5DC0D0417D553BD2464097602D802D1D5DC038017F559BCF4640326A61B31E1D5DC0303EE5BBE5CC46407F53C719A11D5DC000314C227CCA46406DCB94E6811E5DC058AE7D5583C84640AC3C94E665205DC0D871E4BB6DC54640C18994E6C1205DC040447D558FC44640CFD7FA4CF6215DC0B0E34B2240C04640FF5D94E641225DC0E0E4E3BB8DBD464011A994E681225DC08897B2884ABC464007E3FA4C8C255DC0785F7E55CBB6464039452D807F265DC04C16E4BB81B24640894261B3B6285DC05468B088CEAE4640617694E689295DC03F607D557BAC46408FA32D80CB295DC00F4A7E55C3A94640C930C819FD295DC0A87BE4BB71A44640CDBC61B39C2A5DC0280C7E555BA246409155FA4C742B5DC00B564A222CA04640F644C719992C5DC0842818EF4C984640C03561B3EA2D5DC018684A22609346403991FA4CB4345DC0CF8016EF94844640F15F61B334355DC048E77E5533834640105261B36A355DC0F022E4BBE581464065D0FA4C46355DC068D74B227080464098B594E6F5345DC06C874A226C7F4640146BC719A5345DC0389F4A22C87E464069E960B380345DC0C0B47E55677E46404C09C8199B345DC058684A22B87B4640513E61B34C355DC0A07CB288BE75464064C8FA4CD0355DC037574B225C734640F29661B34A375DC01BEC4922DC6E46400A0962B3B43A5DC000A37C55BB664640421294E69D3B5DC0309AB18826654640EF33FB4CCE3C5DC0D7D116EFA0634640474BC719AD405DC0C0827E55FF5F4640024FC719DF415DC040A24B22E85D46402E0194E68D425DC044CBB1880E5C46400B62FB4C50445DC0403717EF905546408D8261B3EE455DC0E7A27C55075146409FA294E6A3465DC0D46E16EF504E4640E5732E802F475DC0702CB18852494640D9642D80D3475DC078E34922EC4646409E06C719AD485DC040CE4B22C0444640BEE661B38E495DC058E2B0883643464007F594E6414A5DC0236A17EFB4424640A64D2E80F74A5DC030B416EF684246408439C719854B5DC0407318EFBC414640AAA594E6BD4B5DC04CF3E3BB1D4046405A6494E6094C5DC06B11B0886E3F46407008FA4CA04C5DC0881EB188AE3E46402043C7190B4D5DC018A4B088C23D4640DEFE60B3624C5DC0B0A04B22503A46407A7161B3DE4C5DC0580F7E5503384640D3F060B3924D5DC06F56B0887A3546409BA1FB4CC84D5DC0CC897D558732464098DF93E67F4D5DC0B4A918EF0C3146405B7660B3A64C5DC03C2D4C22702E4640F403C719794C5DC0C46BB088CE2C464092FA94E6894C5DC0AF30B0887A2B4640559B2D80D74C5DC028704B22CC2946407ACA61B3E84C5DC040F97C557B284640FC7D94E67B4C5DC0C8037F551B2646400A5861B3724B5DC088E9E4BB71244640852D94E6F9485DC0B89018EFD8214640A0AD61B356485DC0A0FD4922E8224640D1F360B3D2475DC0B052B18802244640340E94E639475DC0A08B4A22EC244640946F60B35A465DC07CC27C556B254640DD4794E683455DC05CD77D551B25464050C02D800B455DC0A09F4A22102446402117C719AB445DC073A57E55CF224640271FC71921445DC0B89018EFD8214640DCFEC719D1425DC0B07E4C223C214640715FFA4CB4415DC07021E5BBA5214640287C94E68B405DC04F14E4BB652246405C9E60B31A3F5DC0F36317EFCC224640E79F2D804D3E5DC07BC74A22582246401C0195E61B3E5DC0988AB188362146409D89FA4C243E5DC03C927E55C31F464005F32D80033E5DC00C5218EF581E46406A802D80873D5DC0907FB188A61C4640A77D93E62D3D5DC0A4BBE4BBF51B4640126A2E80C93B5DC07C667D55DB1A4640A6D361B3AE3A5DC0F8714A22A0194640317D2D8067395DC0248F4B22CC17464057F1FA4C16395DC00888E3BB9D164640D568FA4C5A395DC007DE7D55B315464086F3C619CD395DC01C7AB288F2144640428394E6093A5DC03727B2884214464090CDFA4C0C3A5DC0280B7F55CB1246406602C819233A5DC0F8954922481146401568C719653A5DC080BB7D55D30F4640EA9294E6E93A5DC01809E5BB890E4640A6F794E69B3B5DC0CB4EB188160E4640DCB0C7197D3C5DC078C516EF1C0E4640047F60B35A3D5DC020E516EFE80D464005F32D80033E5DC0D8CB7D55CB0C4640E896C719FF3D5DC0BBC74A22B00A46409277C7193F3C5DC09CC04A2258064640126A2E80C93B5DC030927D55A7034640296F94E6DF3B5DC0B8A5AF882E024640167394E6173C5DC038A917EF30014640AF46FA4C603C5DC0F3524A2238004640BA792E80A93C5DC044E37E55CFFE4540D751C719193D5DC050F64A2290F945404B59FB4CE83D5DC0E41C17EF68F54540E36294E6253E5DC08C45E5BB59F24540A59161B3E23E5DC010DDE2BB79EF4540475BC719993F5DC078C918EFC8ED4540E7F1FA4C02415DC0D4D27E5523EC4540A65F61B302425DC0F068B18812EA45401E88FB4C82415DC0587E17EF20E745401E88FB4C82415DC0D89EAF882EE64540A6C061B382415DC094F8E4BB29E6454080C560B34A415DC0408BE5BB7DE445406A72FB4C48415DC0447FE3BBF9D845406BDAC61947415DC0F4C6B08836D345400EAEC71943415DC06718B18802C6454081FB93E63F415DC0DF69B188CEB84540234061B33C415DC030D918EF98AB45400E55C71939415DC0B42A19EF649E454031612E8035415DC0B81C4B223091454029E760B332415DC0BF0E7D55FB834540C5BA61B32E415DC038D14922C876454031082E802B415DC0A0B17D5593694540DA4CFB4C28415DC018037E555F5C4540C56161B324415DC090547E552B4F4540B076C71921415DC087D5E3BBF5414540E1F3FA4C1E415DC00C27E4BBC1344540CC0861B31A415DC08478E4BB8D274540E814C81917415DC0D0E74B22581A4540E19AFA4C14415DC053C87F55230D45404477FA4C10415DC0CCFB18EFF0FF4440D19F60B3FE4C5DC0D8FB18EFF0FF44405660FB4CEE585DC0D8FB18EFF0FF4440EBF92D80DD645DC0D8FB18EFF0FF4440792294E6CB705DC0D8FB18EFF0FF4440848360B3BA7C5DC0D8FB18EFF0FF4440501494E6A9885DC0D8FB18EFF0FF44401CA5C71999945DC0D8FB18EFF0FF444062FD94E687A05DC0D8FB18EFF0FF4440705E61B376AC5DC0D8FB18EFF0FF444003F893E665B85DC0D8FB18EFF0FF4440CF88C71955C45DC0D8FB18EFF0FF444016E194E643D05DC0D8FB18EFF0FF4440E3D993E631DC5DC0D8FB18EFF0FF4440AF6AC71921E85DC0D8FB18EFF0FF4440836CC71911F45DC0D8FB18EFF0FF4440DF70FA4C0C005EC0D8FB18EFF0FF444010B7FA4CCA105EC0D8FB18EFF0FF444001952D8087215EC0D8FB18EFF0FF4440256A61B344325EC0D8FB18EFF0FF4440CE77FB4C02435EC0D8FB18EFF0FF4440C7C6FA4CC0535EC0D8FB18EFF0FF4440396CC7197D645EC0D8FB18EFF0FF4440AC8260B33A755EC0D8FB18EFF0FF44405590FA4CF8855EC0D8FB18EFF0FF4440FF9D94E6B5965EC0D8FB18EFF0FF444079B42D8073A75EC0D8FB18EFF0FF44401551FB4C30B85EC0D8FB18EFF0FF4440567093E6EDC85EC0D8FB18EFF0FF4440057E2D80ABD95EC0D8FB18EFF0FF4440AA8BC71969EA5EC0D8FB18EFF0FF4440143194E625FB5EC0D8FB18EFF0FF4440C53E2E80E30B5FC0D8FB18EFF0FF44406AB0E7B7BA0D5FC050EA18EFF0FF4440FB8415CFE20D5FC02032426BCA0045408860127D2A0F5FC0B8C7D7873D024540CE5E062EB2105FC00051BC7953044540D25C68C096115FC03401AD3DCF05454022ED6274C2125FC03041ADD9F205454084D0B43680155FC0E4363A5EB60B454062C95EE76D165FC08436DBE4890C45405AD33BF602175FC09809D4DC760E454088F1EFA0AA165FC08058A634E21045406F93C54E6F175FC0D73C9F2C351345403993B61E49175FC02081ADBC6B164540C5762D3D14185FC0F86BC9BC2B19454044ADE28042185FC07FFA3E12321C45400967277E4A195FC0D02CD035A61E4540F1717CD3651A5FC098427AE0DC1F4540D70A7CD3411A5FC0CFB2CE3522214540005BA068341A5FC02C129D56EB25454075A57CD3171B5FC028D5CE35AE284540C3AB277E621B5FC05CA3CF35F6284540745BC237B31B5FC0D442B5DA262A45402DEA7CD38F1B5FC08071D035BE2C4540EC66F0D1441B5FC0508B6AE6502E4540E2FEB4C84B1B5FC038C0BFBA4A3045406E473E30591B5FC038F72F0EC3324540DCEACCDF321B5FC0A47AB6EBBE35454094913B7E251C5FC0B042197037384540F4E2594F1B1B5FC0D788A0A41F3A4540EE863775021B5FC0D051C9D8C73B4540E2A9D356EC1A5FC0B81A143FD93E4540D07CD128011A5FC0978D258B7F424540081C7CD3C7195FC060A3CF3536444540B144277E3E195FC0E0FD79E084484540016091CC7B195FC0007D8D57F24A4540C48A80C1D0195FC0531DB429274C45409D2286D197195FC09BB4873CD04E4540CC5FB66A251A5FC0B88B03318E524540071C7CD3871A5FC0E893D035CA544540F5FF267E461B5FC050877AE0F455454078A57CD3371C5FC0D893D035CA564540725AD128151D5FC020B979E0EC574540BF607CD3DF1D5FC02CB979E0EC594540275B5570441E5FC060F45CC07A5D45405FD89FF9791F5FC03F6CB0DD6E5E4540944F7CD359205FC0E019CF35465E454060FB7CD3F5205FC03CB6D035D65F45402D9FD1280D225FC0D048258BE76645409E28D2287D225FC08CF7CE357A684540F74AD22829235FC020B979E0AC694540F2717CD345245FC0908D258BBF6A45403A2D7CD30D235FC060BF248B376C4540DCE98D41841F5FC0A0AE2CE004774540F62D9ECDAC1D5FC09FF4F8091C7F45405122277E121D5FC02C4FD035728145402B2753F8781C5FC0C7477002D7834540C90A8367FF1B5FC0505AED0B2F874540D47FED2BD21B5FC010AE9FBC97894540FD46251C2A1B5FC058F0D1E5448F45408F0EB239A21A5FC0544EDADF0F90454086485676C81A5FC0C0EE65033292454039AF4241BE185FC0DC2FF03AADA14540BC029DEB49195FC09F6A3CD168A64540E15CFB49AF195FC047C7E43AB1A745403E5880FBA9185FC0E8FA20A042AA4540885159A518185FC07C6E069E8CAB4540DECA761108175FC058E802BFCFAB45404B541C58E5155FC0284360BC11AD4540A7D50FCB15155FC037ADA2F3A5AC4540A11B50B8DC145FC0F856F65A59AB454066126FDCE3145FC047EB69E0F7A74540D1C1D9C441145FC0B39C10E960A645405BB8281D06145FC000A9C8868DA74540030C24EBBA135FC068B3F9E5F7A9454026046FD1F4135FC0C82D2A4C59AB4540E7BE4EDDC1135FC004FF95BB6DAD45403817B25F3C135FC0F8E200718CAE4540D5C77CD363125FC00017268B6FAF45402D9FD128AD115FC028B979E06CB245402A9FD1282D105FC00817268B6FB54540E9F58D66E70E5FC068710D4D48B6454047C8C2683A0E5FC0488A40E36CB64540B4D73B9CF30D5FC047E5CAD34BB545403BF61415FE0D5FC0403D0EAE79B345404D5ED39FF70D5FC028916CD169B14540890B6DB79F0D5FC003B0768BF5AF454058BE0CFED20C5FC05020F1A7DDAF45409522E6B0600B5FC008DC7BA440AF454077A57CD3B7095FC0D793D0354AAF4540EADD0C55F6085FC074F5676F0BB0454022C6590EDD0A5FC07862C35E9EB045401AC9FA6DF20B5FC00CA68B0817B24540E67EE7A7300C5FC0F8E2D95FE2B345402C82C2DD6F0C5FC0B0F292D9C2B54540BD7399E1590D5FC07032D2AE29B745406315F8E83F0D5FC098BB7AA8BCB84540ED717CD3A50C5FC00381CF35EAB9454011E2DC4F5B0D5FC0E479875AE1B94540BF3945A2EB0E5FC0BBD114093FB945407B72D34D5F0F5FC048A7A652E3B745401EBE7325CB105FC0140024599BB64540F8E47AD1BA115FC058E8D13BF2B54540E00A4A2C24125FC0DF15CF4D99B34540526B2D6ED1145FC020E9E49D67AE45403BDC866574155FC0D4E246B0C2AE4540300A7AE912135FC078D112967EB5454071FC3BCE390F5FC0E0347FE407C6454039C74C444D0E5FC0E8B3892E10CB4540352D7CD3CD0D5FC018E8CF354ED04540BAC79F296D0D5FC0A88CCB740CD44540E1905F35F20C5FC0E082215CD5D44540BFCC690F2E0B5FC0FFE701B724D645400ADCD080590A5FC0A89734FA1CD84540C2AB277EE2095FC0D048258B67D945403BBB267E8E095FC0B47A248B1FDB4540643E7CD313095FC0A85ECF355EDC45405A23BAAEF2085FC0589B2B69D6DD45409C49F9AE80085FC040F16E3C0ADE4540FB7C672313085FC0F080D45B40DD4540F870612176075FC098F69EE8FFDA4540802D8526FA065FC0E84F970962DA4540D1C77CD3A3045FC050877AE034DA45405EB656747E045FC0C80CE4B817DB4540B8A6177A79055FC0BFDBFF1E41DB4540DACA29397B065FC05C76654AFDDB454055891E9D5F075FC0688AAC8122DE4540A324A1E339085FC0C07ED006E2DF4540165C872B86095FC0281BF6F2B0DF4540430DF339450A5FC0286CBFBC4DDE4540725AD128550A5FC0A75ECF35DEDB45404B2D7019FA0A5FC07F4E920C4BD9454037A881A2360C5FC0186BA7769ED74540ED25C50EFD0C5FC0DFBA668F23D74540A30BE334450C5FC004EA388BD2DB45406333C1E2430B5FC01F25C4D698E145400867277EAA095FC08F427AE0DCF0454020B9568A43095FC068BEBD24BBF84540613E7CD3F3085FC0304FD035B2FD4540061C7CD3C7085FC0E019CF35C6FE4540613E7CD3F3075FC0D8FD79E084FF4540E4E3D128A5075FC06B7479E0D4004640ED76C4EE89085FC03FC55A1E19044640857E4CEF8B085FC080DD1A2CAA0546405522277E12085FC08071D035BE0C464067E84FE34A075FC0E03BC10365184640279FD1284D075FC0B37A248BDF1F46409E28D228DD065FC0D02CD035A62446401C837CD3EB065FC028B979E06C254640E0E3D12845075FC040B6D03596264640279FD1284D075FC04CD2258B57274640C3AB277E22075FC0700AD0351A28464087C1D12899065FC0B8C5CF35422946402B9FD1286D065FC0C4107BE0E4294640DBC05A9EAF055FC0A88AB74256314640535F184167055FC090101C6CB1344640914F7CD399045FC08471D035FE354640A45521092E045FC0ACF7747FF93646400C6987646D035FC0FBD4C0BC6B3746403F431433E5025FC0071E8E716F364640EC8F8E103D025FC07806DF3145354640E4E3D12825015FC054877AE07434464039DD2375C4015FC0BB70043C383846408CB7E17F84025FC0001AE5D3C23846402F10D7D92C035FC020EED4DD6E394640F493B1075E045FC0F48E6FA30C3846409C35C480DE045FC018D65ACD77374640D4A953FA56055FC0789FC594C03646401A837CD34B055FC030D5CE356E384640DEA8673736055FC03C0780AB2E3B4640D05EFD0566055FC04486C4A0C03F46408C51B45E0B045FC0903050BC044E46409574D9EA5D035FC02462AD95214F4640360CA024EC025FC08F5B494E8D4F464075615A1DFE015FC0A03CA34F194F4640D83ABB597C015FC0E7EE9541414E4640F9E13FC14B015FC04F6A0BB6AE4D4640A508D6EFC4005FC0ECC39F67C74C464000340BC69E005FC050B690AD124E4640F576B1E74D005FC0907AB7A2E24E46405B57C5E16D005FC094212723D94F4640114FE36235015FC0800492784550464006C10EEF7B015FC0C7015F97C24F46404A6E68EBBC015FC0A7AAF798AB4F46403A63D8C13E025FC01069B0BD175046405550AA4017035FC0442D8C8FF75046401B0D76DC93035FC008D1BC1E3750464034D8EE605C045FC0F4F21A86124F4640BA9D8AA287045FC06F7E4A0F6F4F4640EB56B03C51045FC01052E2A0E85046405D23156805045FC0687A049CFD514640E37322B2C9035FC014B0CB41675346400C6565B7B3035FC03C210832F0544640EDC925B604045FC0570AD334FE5546407B54D4AAC7045FC06791FB371E564640744953D2FD045FC0C89217AB6356464029C3E99EA1045FC01872C083E6564640FFC0A7C24A045FC0A81369F23F5846409E28D228BD035FC0304FD035F25C46403A2D7CD3CD035FC0DCFD79E0845F46400833A53C2D045FC098A7D700C161464035DD202AB2045FC09BA2C9238A6346404D8CBB8D42045FC0E708DD881B674640499BD7FC2B045FC00CD0ED41626946402D9BD3D46E035FC010731F795A6B4640964F7CD3F9025FC0AF7A248BDF6D464060FB7CD335025FC00817268B6F70464075A57CD317025FC08B427AE0DC72464004D97CD309025FC0473CCF35D27346403F06D22891015FC0304FD03572744640DA0A7CD321015FC0543CCF35527546403B5633422A015FC0B897572FB8764640D0B19D31A4015FC0C8CB44C5C37746403F06D22891015FC02404258BCF78464060FB7CD3F5005FC0AC5ECF35DE7B4640924F7CD3B9005FC040877AE0B47F464040BB267E4E005FC0483CCF3592854640D80A7CD301015FC06CBF248BF7864640031C7CD3E7005FC08FF7CE353A884640E2E3D12845005FC0503CCF35928A4640BD607CD3FFFE5EC034D5CE356E8D4640F1717CD385FE5EC08071D0357E904640F7FF267E26FE5EC024B979E0AC9346408AB88D271EFE5EC0F70078D9699546409E19FFFC06FE5EC05860A3B4D0974640C1B1BE1906FE5EC020079443479A46409C28D2287DFE5EC088F7CE35BA9B4640D5C2CF8CF9FD5EC0701645D510A0464002D97CD3C9FD5EC0747479E014A146403FDF47AF92FD5EC097BEE739C2A346406789277E76FD5EC0D32CD03566A64640653E7CD333FE5EC020B979E06CAA46405CFB7CD335FF5EC018E8CF350EAB46409E28D2281D005FC074BF248B37AB46409E28D2281D005FC048D2258B17AC4640FA4AD228C9FE5EC0948D258BBFAC4640DA0A7CD341FE5EC030B6D03556AE464079A57CD317FE5EC058A3CF3576B046403F06D228F1FD5EC0C02CD03526B24640964F7CD3B9FD5EC0E419CF3586B34640D4C77CD383FD5EC0A87A248B5FB446403A2D7CD34DFD5EC0A85ECF351EB54640D5C77CD303FD5EC0FF80CF35EAB44640F7FF267E26FD5EC0E0B2CE3562B44640A6B67CD37DFD5EC058A3CF3576B0464040BB267E6EFC5EC038B6D035D6B14640E2E3D128A5FB5EC0C4107BE0E4B34640071C7CD3C7FA5EC054A3CF3576B54640924F7CD319FD5EC0C42CD03566B74640F7FF267E26FE5EC07C0AD035DAB94640A028D2281DFE5EC0E893D0354ABF4640924F7CD359FD5EC01CE8CF350EC24640623E7CD313FD5EC0304FD03532C6464086C1D128B9FC5EC0403CCF3552C74640ED717CD385FC5EC0E493D0354AC34640ABF97BD31BFC5EC090F7CE35FABF4640DAD2DBE600FB5EC08CCC971C59BF4640089376916CFA5EC0C8A704F4DDBD4640B244277EFEF85EC098427AE0DCBC4640D58BA4E73AF95EC088F5375CBCBD46408DA00C160DF95EC0785D4A2D79BE464048A03446BEF85EC0004E374926BF464062957CC687F85EC0ECA513F702C046404583C387A9F85EC0D02D5961EFC046403DF82B25EAF85EC08849184A89C24640B9C5A46E70F95EC03FDD8A5527C34640DD0A7CD3A1F95EC02CB979E0ECC4464087C1D12859F95EC070BF248BB7C746406989277E36FB5EC0284FD035F2C6464019837CD3ABFC5EC00CCC7AE0CCC846403A2D7CD34DFD5EC09C8D258BBFC946402F60E9ACF1FC5EC05889FBFAA7CB4640BAFC020574FC5EC0A037221A88CF464029E266B147FC5EC0B816173502D346406E2F1C47EDFA5EC007EFFA25D2D446401A10846BFBFA5EC040FD4D5384D74640DFF78945C4FA5EC080C5AEB543D8464024AC256142FA5EC03C9C5EDB7BD846403CF7CB78B2F95EC0A051A332F3D74640CB2EAC092CF95EC0C70E001581D7464091C0C3A0CBF85EC010116E076AD746400B67277E4AF85EC0A87A248BDFD74640BC607CD3BFF75EC0747479E054D94640D0C77CD323F85EC07B0AD0351AD946402E9FD1286DF85EC0D4FD79E004D946405422277EB2F85EC038B6D035D6D846403ADE42BC6DF95EC0E4E112CE0ED9464099A57FD7D4F95EC0B0027EFFB9D946401AA3A2D51CFA5EC020FCAA87A8DA46401059E236B7FA5EC024C22E802CDA4640D343364EF2FA5EC090D8F5B23DD94640B41538C28AFB5EC0087294B9C2D8464029A816E1ABFB5EC058FC159541D746403FE4FDB0ACFB5EC01854AFFD92D546400DB0AF3806FC5EC03F74FFA78ED44640B244277E1EFC5EC058A3CF3576D54640AF44277EFEFB5EC070BF248B77D946403589667044FC5EC007172BD70CDD4640078AD21DA5FC5EC0A49961C933DE46409370D902B1FD5EC0507A881B37DF4640DF9F4BFE08FE5EC0470CC45760E046408243FEE5EFFD5EC03034623666E146405385DA2A39FE5EC078328BD99DE1464010E9B8F9CAFE5EC0C081374E51E14640F6E56694DBFE5EC0F0FFA54446E24640AC89A5DEF9FD5EC07042E3C10AE44640A8B67CD3DDFD5EC0E0B2CE35E2E54640C1AB277E62FD5EC0E048258B67E8464087C1D12839FD5EC0EC19CF35C6EF464019837CD36BFD5EC0680AD035DAF2464032EA7CD30FFE5EC0687479E094F54640E6E3D12865FF5EC00BE8CF350EF84640AF44277EDEFE5EC0780AD0355AF94640D3C77CD343FE5EC0284FD035F2F9464055FAB1F8B6FD5EC0604D448AC4FB4640D68F58AEDEFC5EC06419091E73FC4640F5FF267EC6FB5EC0C82CD03566FD46401B837CD36BFB5EC0FFCB7AE00CFF464075A57CD317FB5EC0E493D035CA0147409CD7B2F16AFB5EC02746317BC40447406D690A37F5FB5EC050735872790A474093A8032BD7FC5EC01894901F5C0F4740D6C77CD363FF5EC0FC80CF35AA194740D02F7F5573015FC094B8B7378C1D4740E9161C191C015FC06FDE6AAA221E4740534E5B862C005FC0BC0457886D1E47403C5E4C893DFF5EC0B8EC5463031D4740EC0CAAA5AAFF5EC038FF27DA301C47400103000000010000000B000000A1F57CA2F2DB5EC08C6EA909361C474011B348BA36DC5EC068D161B64B1B47401F30B271F8DC5EC0A46E09C8F01B47408FDBDAE8FADD5EC0F8A283E9CC1C4740F05BB25F94DE5EC070B6F148381E474086B91509E0DE5EC038911A66EA1F4740A6223D8EC4DE5EC0083E17C4C2204740445B150E28DE5EC0101FC6E89C2047400B0FBEB672DD5EC0A878391FB01F4740769DBDFB6FDC5EC0E049E0F0311E4740A1F57CA2F2DB5EC08C6EA909361C4740,-8.4%,-123,"1,341",738,603,Oregon,true
43,0106000020E6100000020000000103000000010000000C000000964F7CD319D753C088F7CE35BA804040663E7CD393D753C088F7CE35BA80404040BB267E8ED753C01417268B2F834040A228D2283DD753C0B8C5CF35828540408EC1D12899D653C0A85ECF355E874040A8B67CD39DD553C067BF248B77884040944F7CD379D553C0F035248B478840405622277E72D553C044B6D035168840400967277E8AD553C0CC2CD035E687404002D97CD3C9D553C060A3CF35B6874040A028D228DDD553C0DF93D035CA854040964F7CD319D753C088F7CE35BA80404001030000000100000098020000665DC7197F9754C0E0527D55C3994140DA6BFA4C389754C06C4E4A229C9941407C662E80619254C0AC4DB2885A9A41409AD861B3CE8D54C02851E4BBF5994140E807FB4C328D54C060E6E3BBE99941409E62C819758B54C0E0527D55C399414002E4F94CBA8854C0789C492288994140810861B3248554C058B14A223899414054E994E6D58054C07CEA7E55DB9841402870C719F17B54C04C774B2270984140526C2D80997654C064EC7C55FB974140600CC819F17054C034D94A2280974140D042C8191B6B54C070A218EF00974140508893E6396554C0309B4B228096414048CAC719715F54C07FB77E55039641404C6361B3E25954C06C1519EF88954140702B94E6B15454C020AE4A22189541408D21FA4C005054C0FCBDE5BBB1944140008694E6F14B54C030BB4B225894414036DAC719A94854C0009A17EF109441409E3761B3B44454C0548B18EFBC934140F0412D80E74354C030CF4B227C934140AE7994E65D4354C0047FE5BB25934140FA0A94E6194354C0708E7C55BB9241407072C719DD4254C0F8F1AF8846924140C22694E6AD4254C0AC7916EFC49141408E6CC719894254C0343D4B2240914140C637FA4C724254C02837E4BB9D9041408EF9FA4C6C4254C0BB254B22F08F4140CCB1C719754254C0D0B4E3BB418F414002DD60B39A4254C08C97E5BB998E4140B62094E6534354C0C4544A22288C41409437FA4C6C4354C058774922A08B4140718493E6794354C0D0F8E3BB298B41405CF2F94C804354C0644B4C22A48A41406252FB4C704354C034034B22108A4140DAEDC619594354C03CD317EF74894140E381FB4C224354C030507F55D78841401A8161B3E44254C01C794A2244884140148B61B3764254C0B06C17EFAC874140261495E6214254C020D84A22A8874140E2CF93E6C54154C0DC944A22D8874140C45461B3783C54C0309C7D55138E4140EE4C61B3083C54C02CC8B088768E4140A4BA60B3C03B54C070CE7C556B8E4140C3302E808B3B54C0884D4B22388E41402C7794E6553B54C010637F55D78D414076DA94E6FD3854C067337E55B78841409E7761B38A3554C0AC08E6BB31814140CEF0C619BF3254C03053B2881A7B4140584394E6853254C044DDE4BB557A41408267C719793254C07CA9B18882794140B29460B3BA3254C0C8247E55476C4140865661B3B43254C0E7504C22646B4140A0E6FA4C923254C0C022B288966A41405AE12D802D3254C09028B088EE694140AA8393E6AD3154C07C7EE5BBB1694140500C2D80272F54C0D0C64B2298694140280A61B3702E54C0B361E4BB91694140866161B36A2C54C02F0FB2887E6941403140FA4C462954C0884516EF606941404EE060B3322554C020237C553B694140547860B3602054C0D73617EF0C69414036DA60B3FE1A54C00B27B288DA68414020FBC7193D1554C018947E55A3684140A4A094E64B0F54C0C330B0886A6841407216FA4C5A0954C03C3919EF30684140E26FC719990354C0049A7C55FB6741403C9961B336FE53C0B82A4922C8674140C2F8FA4C64F953C088AFB0889A67414060D1C71951F553C008AB7D55736741408477FA4C2CF253C0C05E17EF54674140E8CEFA4C26F053C05C5F4A22446741408AD52D806FEF53C008A77D553B6741408695C7190BED53C004A217EF246741403A51FA4C1AEB53C0B8E8492290664140F6F1C619D3E953C02090B088DA65414084C6FA4CCAE753C00C3316EF6C624140521AFB4C98E353C0009FB188565B414070AF60B366DF53C0843AB2883E544140FC32C81935DB53C0AF587D55274D4140948FC71903D753C044654A2210464140E81B2E80D1D253C0D47117EFF83E414006B193E69FCE53C0E88FE2BBE1374140DA0494E66DCA53C0E88AB188CA3041406088FB4C3CC653C07C977E55B32941407E1D61B30AC253C00CA44B229C224140D2A9C719D9BD53C038C216EF841B4140F03E2D80A7B953C0B0CEE3BB6D1441407CC294E675B553C0AFC9B288560D414092E62D8043B153C0E0E77D553F06414068ABFA4C12AD53C0746517EF28FF40408C4060B3E0A853C00472E4BB11F84040928B61B3AEA453C0181FE3BBF9F04040E45D6769AEA453C07816CE3EF9F04040F4FF267E66A653C09C427AE01CF04040F4FF267E66A653C078557BE03CEF404000D97CD3C9A553C010E8CF350EEF4040372D7CD34DA553C014E8CF358EEE40404306D228F1A453C060BF248BB7ED40404406D228B1A453C0D893D0358AEC40409B28D2285DA753C0B0C5CF3542EC40401A837CD30BAA53C077557BE07CEA404098DD267EDAB053C0D048258BA7E34040E8E3D12885B753C028D5CE352EDA4040041C7CD307BC53C01017268B2FD24040D4C77CD303C253C000CC7AE04CC44040E4E3D12885C853C03CD5CE356EB54040AAB67CD3FDC953C0443CCF3512B04040D4C77CD383C953C040877AE034AF4040AAB67CD3FDC953C00CCC7AE0CCAD40402CEA7CD3AFCB53C0DCB2CE35E29E4040A8B67CD3BDCB53C0C0107BE0E49B4040C4AB277E22CC53C0C0107BE0E49B4040DA0A7CD3A1CC53C074557BE0BC9D40406889277EB6CC53C098427AE05CA24040C6AB277E02CD53C05CA3CF35B6A440402F9FD128ADCD53C070557BE07CA64040E4E3D12885CE53C048877AE034A740403CBB267E2ED153C0C4C5CF3542A74040FC4AD22869D153C098427AE09CA8404078A57CD3D7D053C00CE8CF358EAB4040362D7CD32DCF53C090F7CE357AB140409C28D228DDCC53C0FC35248B07B64040C4AB277E22CC53C0D42CD03526B74040C4AB277E22CC53C00C17268BEFB740404C947CD391CD53C0607479E0D4B64040A8B67CD3DDCE53C0888D258BBFB44040A9F97BD3BBD153C068BF248BF7AD40405222277E72D253C028B979E06CAB404077A57CD3F7D253C018B979E0ACA840400A67277E2AD353C070557BE0FCA54040FAFF267EA6D253C004CC7AE08CA34040FC4AD22869D153C068BF248B77A14040CFC77CD3E3CF53C0D7FD79E004A040405022277EB2CD53C0DC93D0350A9F4040F6FF267E86CD53C02C4FD035F29D404074A57CD397CD53C0BCC5CF35829C40405022277E72CD53C0E019CF35069B4040A028D228FDCC53C02C4FD035B2984040BC607CD39FCC53C0FFCB7AE00C984040A8B67CD3BDCB53C0F019CF358697404006D97CD389CC53C018B979E06C964040603E7CD373CD53C088F7CE357A954040D4C77CD343CE53C070BF248B37944040DC0A7CD3C1CE53C050877AE0349240404206D22851CF53C00481CF352A9340405222277ED2CF53C0770AD0355A954040603E7CD353D053C0FC35248BC795404061FB7CD335D153C0B0C5CF3542954040081C7CD347D153C0D893D0350A94404048947CD3D1D053C048D2258B97924040A8F97BD31BD053C0D048258B67914040061C7CD367D053C074BF248BB79040405422277EB2D053C074BF248B37904040EF717CD305D153C0D0B2CE35E28F40401C837CD36BD153C0D848258BA78F4040AE44277EDED153C040B6D035D6914040F6FF267E06D353C038B6D035169340408EC1D12879D453C0304FD035B293404002D97CD3C9D553C0284FD035F2934040AAF97BD31BD553C074557BE03C92404030EA7CD3AFD353C0680AD0359A9140402E9FD1288DD253C0B8107BE0A490404098DD267EBAD253C0FF80CF35EA8D40404006D228B1D353C05BA3CF35368C4040D2C77CD383D653C050D2258B178A4040F7FF267EC6D753C0244FD03532884040A028D2283DD853C038D5CE35EE8540403EBB267E4ED853C014E8CF35CE834040E6E3D128C5D853C068BF248B37824040F0717CD365DA53C058D2258B97814040A028D228DDDB53C0E048258B6781404002D97CD349DD53C094427AE0DC804040081C7CD387DE53C0B4C5CF35028040404A947CD371DF53C0D32CD035E67E4040904F7CD3B9DF53C08871D0353E804040643E7CD393E053C0F419CF35C6824040DC0A7CD3C1E053C07871D035BE834040041C7CD347E153C0F019CF35468540408CC1D12879E253C0B8107BE0A4844040A028D2287DE453C060BF248B77824040382D7CD36DE553C0E4FD79E0C481404078A57CD337E653C02004258B0F804040A7B67CD3DDE753C0F035248B477A404076A57CD3F7E753C02004258BCF784040E8E3D128A5E753C0503CCF3552774040C2607CD3DFE653C00336248B4775404004D97CD389E653C0E493D0354A7640401D837CD30BE653C017E8CF350E77404040BB267E6EE553C06C0AD0359A774040924F7CD3B9E453C0D048258BE777404060FB7CD335E553C09CF7CE35FA754040382D7CD3ADE553C0B0C5CF35027540404A947CD3D1E853C0C0C5CF35027240401A837CD34BE953C0FC35248BC77140406889277ED6E953C0E4B2CE3562714040BE607CD31FEA53C094F7CE357A7040406689277E56EA53C0503CCF35926F4040EC717CD3A5EA53C00081CF352A6F40409CDD267E5AEC53C054D2258B176E4040725AD12895ED53C0483CCF35926B40406889277E96EE53C0BC107BE0A4684040F6FF267EA6EF53C0680AD0355A664040A228D2281DF353C048877AE0F462404002D97CD309F553C0E0B2CE35A26140406389277E76F653C0680AD0351A6140402C9FD1282DF753C00CCC7AE0CC614040AAF97BD3BBF753C06C7479E0546340402A9FD1286DF853C08C427AE0DC6440400B67277E8AF953C010E8CF358E654040BE607CD3FFF953C050877AE07466404030EA7CD36FF953C070BF248B77684040A8B67CD3FDF753C018B979E0AC6B4040A9F97BD31BF953C00881CF356A6D40401C837CD38BF953C0E819CF35066D40404C947CD3D1F953C0D42CD035266C4040F8FF267EE6F953C0C0C5CF35426B4040061C7CD3C7F953C004CC7AE0CC6A404002D97CD309FC53C0403CCF35526D4040F6FF267E66FC53C078557BE0FC6C4040D2C77CD343FC53C054877AE0346B404006D97CD3A9FB53C060A3CF35F6674040FAFF267E86FB53C0304FD035F26540400A1C7CD3C7FB53C0FB35248B4764404004D97CD369FC53C0C0107BE024644040F8FF267E46FD53C0888D258BFF64404032EA7CD32FFE53C0680AD0355A6640403A2D7CD3EDFD53C0C0C5CF3582644040F8FF267E46FD53C04C3CCF35D2624040AEF97BD35BFC53C0747479E0946140408AC1D12819FA53C050877AE0B46040401C837CD38BF953C0948D258BBF5F4040081C7CD327F953C06C0AD0359A5E4040D07CD12841F853C0A85ECF359E5D40402EEA7CD30FF853C094F7CE35BA5D4040A8B67CD3FDF753C098F7CE357A5E4040352D7CD38DF753C098F7CE357A5E4040E8E3D128C5F753C00881CF35AA5A404006D97CD3C9F853C0707479E014584040F8FF267E86FC53C0975ECF359E5340403A2D7CD32DFD53C0985ECF351E534040362D7CD3CDFE53C0E893D0350A534040D80A7CD3610054C0670AD0359A5340404106D228110154C024B979E0AC534040E5E3D128A50154C0E893D0350A534040E5E3D128A50154C07871D0353E524040372D7CD32D0054C04C3CCF359250404060FB7CD3B5FF53C078557BE03C4F4040623E7CD3530054C0F835248B474E4040725AD128B50354C02804258B4F4D404018837CD3AB0654C0B07A248B9F4B40400A67277E0A0854C0BCC5CF35424B40400867277E8A0954C018B979E06C4A404032EA7CD36F0A54C08871D035FE4840405EFB7CD3550B54C0747479E0944840408AC1D128D90C54C0FC35248BC74A4040AE44277EDE0E54C060A3CF35764E4040765AD128151054C054D2258BD74F4040E5E3D128051154C0EC93D0358A4F4040D07CD128411054C0C4107BE0E44D4040F4FF267E460D54C0B87A248B5F49404000D97CD3E90C54C0E048258B274940408AC1D128D90C54C0D8B2CE35E248404062FB7CD3150D54C0B4C5CF35C2474040EC717CD3850D54C00481CF35AA464040D0C77CD3230E54C08C71D035FE45404048947CD3D10E54C03CD5CE356E45404018837CD36B1354C07C557BE0BC3F4040643E7CD3331454C0E893D0354A3F40402DEA7CD3AF1454C0E0FD79E0843E40405422277E321554C0BCC5CF35423E404017837CD30B1654C03CB6D035563F4040EC717CD3651654C00881CF35AA404040A028D2287D1654C0DCB2CE3522424040B044277EBE1654C0244FD035724340409B28D2289D1754C0E4FD79E0444440402A9FD1286D1754C00881CF352A424040DA0A7CD3A11754C048D2258BD73F4040603E7CD3331854C067BF248BF73D4040C2607CD31F1954C0244FD035323D40405622277E321A54C0707479E0943D4040382D7CD3CD1A54C0888D258B7F3E4040DE0A7CD3611B54C0C02CD035A63F4040CD7CD128611C54C00C17268BAF4040405EFB7CD3951D54C038D5CE352E4140405022277E721E54C0988D258B3F4140408EC1D128391F54C0607479E094414040964F7CD3992154C0B8107BE02445404060FB7CD3152254C0A87A248B1F46404000D97CD3892254C0B4C5CF35C2474040D2C77CD3032354C0B4C5CF35C2474040F8FF267E062354C0C0C5CF3542464040663E7CD3D32254C06F0AD035DA444040AAB67CD37D2254C04C3CCF3592434040964F7CD3192254C00F17268B6F42404060FB7CD3B52354C05CD2258B17424040DA0A7CD3412854C01704258B4F434040B044277E3E2A54C01704258B4F434040AAB67CD3DD2A54C048877AE0B4424040D2C77CD3632B54C070BF248B77414040AAF97BD35B2B54C07C557BE0BC3F4040623E7CD3332A54C0D7FD79E0C44040400E67277E8A2454C01417268BEF3E404006D97CD3C92354C02404258B0F3F40409E28D2289D2254C090427AE09C3F4040DC0A7CD3E12154C07C557BE0BC3F40400A1C7CD3072154C0F880CF356A3F40409EDD267E7A1F54C04B3CCF35D23D40409ADD267E9A1E54C0244FD035323D40409ADD267E9A1E54C08071D0353E3C40406A89277E562054C058A3CF35763C4040A9F97BD33B2254C0B0C5CF35423C40404406D228112454C0680AD0359A3B40408AC1D128992554C078557BE07C3A40404E947CD3B11F54C0344FD035B23940404C947CD3111E54C058D2258B973840405EFB7CD3551D54C00881CF352A36404002D97CD3A91D54C098F7CE35BA3340403EBB267E6E2054C0BCC5CF35C23140404B947CD3F12154C02C04258BCF2F4040289FD1280D2354C060A3CF35B62D4040D2C77CD3032354C03CD5CE356E2C404030EA7CD3CF2154C0F880CF35AA2C40408AC1D128192054C038D5CE35EE2D4040EE717CD3851E54C008E8CF358E2F404098DD267EBA1D54C0D8B2CE35E2304040C2AB277EC21C54C027D5CE356E324040D2C77CD3431C54C088427AE05C334040AAF97BD3FB1B54C050877AE074344040DA0A7CD3811B54C050877AE074344040D27CD128C11B54C0334FD035F23140409ADD267E3A1C54C09C427AE0DC2E4040041C7CD3E71C54C014E8CF35CE2C404098DD267EBA1D54C0D0B2CE35622D4040CB7CD128211E54C0D0B2CE35622D40408BC1D128191E54C064A3CF35B62C404060FB7CD3351E54C017E8CF358E2C4040FAFF267E661E54C0687479E0942C40409ADD267E9A1E54C03CD5CE356E2C404042BB267E6E1D54C018B979E02C2B4040CB7CD128211E54C01804258B4F294040FC4AD228692354C01017268BAF234040ACF97BD31B2454C088F7CE357A234040DA0A7CD3212554C09CF7CE35BA2340408AC1D128992554C01017268BAF2340403F06D228112854C088427AE09C214040DA0A7CD3C12854C0D42CD03526224040DC0A7CD3212954C0E0FD79E084254040944F7CD3192954C088427AE0DC284040DA0A7CD3412854C0D8B2CE35E2304040EE717CD3852A54C0E0B2CE35222F4040D17CD128E12A54C04C3CCF35D22F40402C9FD128AD2954C0FB35248B073940404406D228112A54C090F7CE353A3B4040CE7CD128C12B54C02C4FD035723B4040745AD128952B54C038D5CE356E3A40409EDD267E7A2B54C01017268B2F3A40401C837CD34B2B54C040B6D035563A4040D17CD128E12A54C078557BE07C3A40403EBB267ECE2A54C038B6D035163A40404206D228712A54C0344FD035B23940402EEA7CD30F2B54C054877AE0343840405422277E522B54C070557BE07C364040AAF97BD35B2B54C00036248BC72D40406889277E362B54C0E493D035CA2C40405EFB7CD3952A54C0888D258BBF2A40404206D228712A54C00081CF356A29404078A57CD3B72A54C040B6D03516274040FA4AD228692B54C09C8D258BBF264040EC717CD3452C54C0DCB2CE35A22740408CC1D128993054C034D5CE352E2E4040663E7CD3333254C0F835248B473540404E947CD3F13254C0D8FD79E0043A4040CE7CD128013354C070BF248BB73C4040A228D2281D3254C01417268BEF3E4040F4FF267E463254C0637479E0943F4040613E7CD3133354C0DCFD79E0C43F404088C1D128193454C00C17268BAF404040D6C77CD3A33454C0543CCF35524240405CFB7CD3F53454C0CFFD79E004444040C0607CD37F3554C0E4B2CE352245404078A57CD3B73654C018E8CF350E45404078A57CD3B73654C0E4FD79E0444440402CEA7CD3EF3554C0780AD0351A434040E7E3D128053554C0344FD035723F4040081C7CD3873454C02404258B0F3E4040081C7CD3873454C0244FD035323D40402A9FD1280D3554C0F019CF35463A40405CFB7CD3353454C00881CF35AA354040CE7CD128013354C068BF248BF7304040D2C77CD3633254C00036248BC72D4040AAF97BD31B3354C048877AE0B42A4040D80A7CD3213354C024B979E0EC284040F0717CD3253254C0B0107BE024284040F8FF267EA63154C0D0B2CE35222740402CEA7CD3AF2F54C0D42CD03526214040081C7CD3872E54C0DC93D0350A224040613E7CD3932D54C00481CF35AA21404032EA7CD3CF2C54C0483CCF35922040409CDD267E3A2C54C0503CCF35521F404089C1D128592B54C054D2258BD71C4040DA0A7CD3612B54C074557BE07C1B4040904F7CD3192D54C0D848258B671840402C9FD1282D2F54C060BF248B77134040081C7CD3873454C048D2258BD70D40404406D228F13354C0DBFD79E084124040A6B67CD3BD3154C00036248B871A4040FA4AD228E93154C0503CCF35521F40403EBB267E6E3254C00817268B2F1E40408AC1D128993254C058A3CF35B61C4040D80A7CD3A13254C0C0C5CF35021B4040FC4AD228C93254C040877AE034194040BC607CD33F3354C030B6D035D6174040643E7CD3B33454C070BF248B37154040DA0A7CD3013554C090427AE05C144040DA0A7CD3413554C0284FD03532114040DB0A7CD3E13554C048D2258BD70E40403A2D7CD3CD3854C0DCB2CE35E2084040BE607CD33F3954C0FC35248B870740407AA57CD3573954C09CF7CE35FA0540409CDD267EFA3854C038D5CE352E0440405EF91579FA3854C0E84B791C2E0440406AB9C719053954C00FE34B2228044040C2FA93E64D3A54C0B0BDB288560440408C1F61B3783B54C0903FE5BB150540406D902D80733C54C06BB016EF5C064040D0F160B3DC3C54C05C64E3BB210840402A3BC8194F3D54C048AF7E550F0940409C5E94E6E13F54C0E48FB188260B40406872FB4C484154C0C49C17EFAC0B4040309AFA4CFC4454C0E48FB188260B40403E7D94E6894554C008C6B088B60B40403A542E80634754C0B030E4BB990F4040BF5FC719BD4754C0D002B388161040405EF794E6694854C0B0D2E4BBC110404086742D80B34854C000DF17EF58114040A4162E80E14854C01C6B16EF4412404096DB94E6D54854C0A4E116EFF8124040E23861B3B84854C0F0DC7E557F13404086742D80B34854C0F8EA4A22E4134040E4F22D80D74954C07765E3BBF9174040FA1A61B3024A54C0E8BC16EFD0184040957294E6DF4954C0081BE4BB391A404038EC93E6454954C0CFD6B0886E1C4040043BC819234954C03B297E552F1D4040CC45C7193F4954C0C0B017EF84204040043BC819234954C09C854A22F4214040C2C293E6ED4854C060924B222823404008FD2D806F4854C0071D7F55E324404032FE93E64D4854C074B5B0886626404082C4C7196F4854C088E916EF1C2940405075C719F14854C05428B288562B4040A71794E6B94954C0936D7E55D72C404011EB94E6AF4A54C0B45018EF642D4040ECD894E6A14C54C0A86BE3BBE13740404871FA4C904C54C08840E4BBE13B40409A74C719D94C54C0E0FCE3BB053E4040268161B3BE4D54C0DB477F55F33E4040F80D95E69B4E54C0480719EF7C3F4040604CFB4CF04E54C0689018EFBC404040B0092E800F4F54C0F76AE4BB31424040ACF8C7194B4F54C0C336B18852434040AA5A2E80A34F54C04838E5BBCD43404046E860B30A5154C010E5E4BB114540404D51C819495154C0840FE4BBF94440404EAA2D809F5154C00C1118EF74454040B60361B3925254C0302FB28856474040BEC32D800B5354C074CE18EF244840406000FB4C925354C070747E55D7484040A82194E6255454C0A028E6BB554940401069C719115654C0C8FEE3BBF5494040CBE894E6615754C05883B0880E4B40400E5B2E80895854C05C8E18EF744C4040923BFA4C585954C034407E55CF4D4040D3BE94E6F75954C0406218EFE84F4040A81E94E6E55954C05C8C17EFC4514040A4BC2D808D5954C0040FE6BBBD534040923BFA4C585954C06CD44B2230564040E2012E80795954C088A2E4BB0D574040A6ABC719C95954C008224B221058404046ABFB4C285A54C08408B288E6584040FEDAC719755A54C03F0B4C2240594040634460B3A05A54C0A06AE4BBD95940400429C719615A54C05C4616EF2C5B4040424BFA4C385A54C06379B188BE5C4040E06394E6D15954C01789B1889E5D4040C23D61B3C25954C0B0A218EF585F40407A90FA4C245A54C05C4217EF5C6140406E8AFA4CCA5A54C074CC17EF286340405C7B94E6215B54C048904922206540401CC5C719355B54C0FCEF4A22046740405F2BFA4C665B54C0D418E4BB01694040CC22C719015C54C048C2E4BB8D6C404080ECFA4C485F54C0132D7E552B76404057FD60B3066054C0945EE5BB417740405F6E2D80076054C0C00B7D55BB79404036F9F94C805F54C08C2A18EF1C7E40406AD693E6B95F54C0289FE4BB4980404006C561B3546054C068C84B22E4824040B62261B3206154C0A4DD492210854040F2B8C619ED6154C08887AF88FA854040A75B61B3526354C00C13B1885E8640403682C7194B6454C018454B2264874040E4B5FA4C186654C03F53E5BB598A4040949A94E6B56854C038DC4922E08C404054BCFA4C586E54C0FC3A18EFC89040409E592D809F7054C098EDE3BBF5934040687D94E6F17054C0A0954B22C0954040C2A32E804F7154C02060E5BBD99A404080C094E6BB7154C0145C4A22E89B40405495C7192B7354C088607D550F9C40408E0761B3527454C01B66B188C29C404056E693E6537554C0EC807E555B9E4040A2AD2D804D7654C0949BB0883AA140408D0062B3687554C0847AE5BB3DA24040381761B3327554C04038B08892A3404068DA93E6A57554C0B8B3B1880AA5404078B52D80BD7654C0F8B7492278A6404086D594E6DD7554C02C7517EF44A7404086D594E6DD7554C0B7134B2224A8404038D12D80517654C068D44A228CA84040D8F393E6117754C08817E6BB09A94040F013C719C77754C0FF8CE5BB31A940406CEDC719177854C0E844E4BB9DA84040C68E93E6537854C0449E4B22FCA74040F00CC819DD7854C0782BB088C6A840404E1AC819957B54C04FAB17EF3CAE40402A9394E6057C54C0A410B28826B040403A5AFB4C1C7B54C0E791B188F6B040406005C719E57B54C020C87E5517B4404048DD93E6B97B54C0D86B18EF0CB54040B4EC60B3B67A54C0B02D7E5553B54040FCBDFA4C427B54C0E8507E554BB74040DCC3FA4C967B54C0B8CD4A22F4B74040E45F94E6217B54C0FC48B188B2BA4040BE45C819097C54C060AB4C22F0BC404022F8C7199B7E54C018CBE4BBE5BF404026482E80EB7F54C018F9E3BBF9C14040AEC960B39E8254C090F3B088AEC74040D6E6F94CF48354C0C4A07E558FC94040B4192E80378554C08C497E559BCA40406483FB4C428854C06C94E3BB21CC40401332FB4CA28954C04C3DE3BB2DCD4040CC3E61B3228B54C0F0564A22E8CE404086F461B3688C54C074BE4B223CD140400E48FA4C548D54C08CA17D55F3D44040CEE02D80DF8D54C007F87D55CFD7404006662D80E78E54C00C93E4BB59DA40406682C719B38F54C0A051E3BB11E04040FD7160B3729154C04490E3BB91E34040C49094E68B9454C0106AE5BB55E84040CE4A2D803F9754C028AD18EFFCEB404076F22D80B59954C0B02E4B22B0EE40409F9D60B3C69B54C017797D5547F04040ABDB61B3C29D54C0EF28E5BB81F240400103C719459F54C0082017EF5CF54040F4DAFA4C62A054C00472E4BB11F840402660FA4C6AA154C0E4C04922D0F940405ADD94E6AFA254C0E4C04922D0F94040129BFA4CB8A354C068267F5573FA4040F27E2E8083A454C0B82A17EFE0FB40408EE82D80FDA454C05894492238FF4040264AC819B5A554C0E04E4B223C024140A7EDFA4C5CA654C014514A22D0054140EFB593E6E5A654C0A8DE7C5537074140289394E667A854C0C89C4B22900841405A7093E6EDA854C060E5E4BB590A41401C4660B3A0A954C01035B088EA0D414086CA60B31EAA54C0D8647E55330F4140AC6461B3D6AA54C0D00FE5BBA9104140F8562D80A7AB54C0282EE4BBDD114140C4DD60B32AAD54C0E46517EFE8124140C47D61B336AE54C0F41F4B2250154140688E60B3A6AE54C088324A22DC1541402C02C71901AF54C084F818EFA41741404ACAFA4C38B054C0541BE4BB9122414052E3C719BBB054C028EEE2BB79254140F4ED94E661B454C0E0904A22DC2E4140BC4794E6F5B454C0409E7E55FF2F4140665794E6D5B554C0888317EF20344140B8AA60B326B654C0C7624922A0374140CDD394E6DDB654C0C849B188F63A4140D88D2D8091B954C0E440E3BBD13D41401AFA94E6EFBD54C0E440E3BBD13D4140E666C819F5C054C0505A17EFA83D414058E293E605C354C03360E3BB913F41407A8EFB4C0EC454C008F5E2BB79414140344C61B316C554C09020B1887E444140F88CFA4C70C654C0508417EFEC45414074FDFA4CCAC754C0D8AFE5BBF14841401CF3FA4C2CCA54C0D0A0B0882A4B4140409560B3A6CA54C090D9E4BBC14C414042112E80C5CA54C0B8937D557B4E4140F90CC71939CB54C080507D55AB4E4140066D94E6BDCC54C0BC33B288F24D41402ACAC719E3CE54C01853B288B24F4140CA7560B3BAD454C0E447B088FA5541401CDDFA4CC0D654C0DC33E3BBAD5A4140DB6261B322D654C040B47D55136041405C31FA4C0CD554C06FE0E3BB5962414010A8FA4CC6D454C034367E556363414006C461B3A8D454C0504AB1886A644140B720FB4C9CD454C0081118EF746541406042FB4C84D454C03091B188666641403A862E8043D454C068EFE3BB216741408ACF93E6B9D354C0C8A27D55F7684140ADDA94E6DDD254C04826E4BB316A4140786660B3E6D154C0909F7E553F6B41405698C71909D154C06B10B088866C414030B0C71965D054C0900B7D55536E4140CA9915F35ACF54C0C881C1FE5170414002FA12DB1FCE54C07FA03F3982714140D455233910CD54C0F4C7E15F09734140C4329388B4CB54C0B0FEC2A3287541403C8A6C8422CA54C07840D18EB4774140C762CA5D9BC854C088583498A378414072538B4003C854C0E0AB40832F7B4140601261B3C6C754C09BE37E55DB7C4140465494E669C754C0E89917EF5C7E41405F3D2E8051C754C0D485B288E67F4140D1E3FA4C58C754C048FBB1880E8041407C86C7192DC654C0107217EF14804140F6C060B372B354C06F954B22588A41406AAAFA4C66B154C04035E5BB158B414066F193E61FB154C0CF744A22008A414006D6FA4CE0B054C0B743B18886894140367EFB4C68B054C000467D5543894140566FFA4C12B054C038B04A22608941409686C7197FAF54C0E89317EFDC8941406AD4FA4CD0AE54C0840F7E55A78A4140D43BC7194BAD54C02F6E7E55FF8B41405A3F94E699AC54C0A0B3AF88D28C4140E2A2C71925AC54C0F0A6B288968D414024C3FA4CE0AB54C068817E550B8F41400E42C719ABAB54C000DA17EFC08F4140064CC7193DAB54C0281017EF5090414096FDF94CB4AA54C0980FE4BB619041407B13FA4CF4A954C07C16E3BB459041406D032E8073A954C018E07E556390414082D3FA4CD8A854C0B82FB288CA90414010F62D80BBA654C00CEFB0889A9241409C94C71975A354C0F831B1885E944140C2C2FA4CFAA254C0D0A117EF80944140E2F8C619ADA054C040A1E4BB91944140787DC71931A054C0E00A7F55BF944140103660B3DA9F54C0C81F4A22089541405295C7198D9F54C04450B08892954140227994E60F9F54C02432E4BB419641407FAF93E6A59E54C08835B1888A96414044332E80579C54C040AC16EF909641405176C719D99B54C00C807E55DB9641407270C719859B54C0949EE2BB619741402E35C7192B9B54C0486FB08846994140A8F3FA4CDC9A54C06009B188FE994140E9D694E66F9A54C0F8C14B22A49A414008B6C7197D9954C0BFE77C55AB9B4140D6F294E6099954C00898E4BBF19B4140D86460B39A9854C00769B288E29B41400E6DC7195F9854C0D8957D55879B4140CC6E60B32C9854C038464A22209B4140B26294E6E39754C0B8BE7E555B9A4140A0B42E80BB9754C02803E5BB099A4140665DC7197F9754C0E0527D55C3994140,8.4%,57,738,286,452,South Carolina,true
49,,-5.9%,-2,32,30,2,Virgin Islands,false
46,0106000020E6100000070000000103000000010000003900000050909D1F754A58C050DCF16D141D3A409A5618F5A54A58C0808A2B27541A3A40D852F3277A4B58C08085FC15AD1E3A40AC5E14560D4C58C0988452DC3A263A4050313D10A24D58C0584CF34FEF4A3A40A447A1CC894E58C07065F3D360563A409EDD267E5A4F58C0B0469F6B6C5D3A405122277EF24F58C0D8339E6B0C643A4002D97CD3A95058C0A059A06BCC773A40299FD1282D5158C0C0FBF3C0897D3A404606D228B15258C0F8AAF6C079873A40FC4AD228495358C0BF469F6BEC8C3A4019837CD30B5458C0FF019F6B549B3A40A7F97BD35B5458C0B8914A16CF9D3A404F22277E125558C0006C48160FA23A40BE607CD39F5558C0900EF5C069A73A40041C7CD3675658C0A8FBF3C089B23A40DE0A7CD3415758C050084A169FB83A40071C7CD3C75658C0788B9F6B84BA3A40623E7CD3335758C07F8B9F6B04BC3A40904F7CD3795758C04F084A169FBD3A40CC7CD128A15758C0D77E49166FBF3A404A947CD3B15758C0708B9F6B84C13A404406D228915758C0E7339E6B8CC23A403A2D7CD3ED5658C0F014A06B34C33A40071C7CD3C75658C0E06B48160FC43A4086C1D128D95658C0808B9F6B84C53A4002D97CD3295758C0401B4B167FC73A40DE0A7CD3415758C07F8B9F6B84C83A40D0C77CD3835758C0E0339E6B8CCA3A404606D228715958C02FBD9E6BBCD43A4062FB7CD3D55858C0B027A16B94DD3A400967277EAA5858C0201B4B167FE63A405EFB7CD3355958C0A0FBF3C089FE3A401C837CD3CB5958C0A00EF5C0E9073B401E837CD3EB5958C0201B4B16FF0C3B4086C1D128795958C040084A169F163B4000D97CD3695958C0DFAAF6C0791B3B401E837CD3EB5958C0006C48160F203B40081C7CD3675958C0B0469F6B6C253B402CEA7CD30F5958C0DF7E49166F313B40DA0A7CD3215858C0E714A06B34353B404C947CD3915858C018D09F6B1C303B40745AD128155858C02F1B4B167FEE3A404A947CD3F15558C02885F4C0B9C13A40F8FF267E464F58C040084A161F723A409EDD267E5A4F58C0E0339E6B0C6F3A402A9FD128CD4E58C09859A06BCC6B3A40E6E3D128654E58C0CFE8F2C029663A40D2006385944D58C0903FD9C71C573A404E947CD3F14C58C008E3A06B7C4C3A404606D228B14C58C0A8A44B16AF463A40F9DCDA06B14B58C06F57EAF12C3B3A406EA3C0E95A4B58C0404FDC617B343A402050BF69EC4A58C09090883DF52D3A407CFA088F854A58C00FB93BA0A9213A4050909D1F754A58C050DCF16D141D3A4001030000000100000022000000D9DD6178644B58C080C13FC320A73B40AEA20E44995058C06F545C4D057F3B40EC545F147F5458C0F04DE3FD895B3B4002A043D92E5658C090191E982F463B4002767E4F815658C09060A223343C3B40B882391C6B5758C0B8EAB23A67393B406989277ED65858C018029F6B54393B404606D228715958C01098F5C0993A3B404E947CD3F15858C060AA9D6BDC3E3B408C162238B25758C0D755A48A2E593B40A8AD2739AE5558C0E89B6240BC683B4025F27AE9935458C0E045DD97CB743B4049387A50FE5358C030A84F635C7A3B40F8DB4D6C155358C07042E27703823B40FAE89EEC1B5258C05059016A5C8A3B400954A142545158C0987A3FB715913B406A89277E765058C070F54816BF973B402CEA7CD3AF4F58C0B0FBF3C0899F3B40A6B67CD39D4F58C01FEF9D6BF4A13B408AC1D128F94F58C0C0914A16CFA43B40D2C77CD3435058C0002E4C16DFA83B40C2AB277EC24E58C0E014A06BB4A63B400A1C7CD3074E58C04072F3C0D9A43B404206D228914D58C0A0FBF3C009A23B400867277E2A4D58C0A0FBF3C009A23B400B67277EAA4958C0900EF5C069BD3B402E9FD128ED4758C0301B4B16FFC43B409E28D2283D4558C050AA9D6BDCCD3B40643E7CD3D34458C0708B9F6B84D03B405322277E524458C0AF659D6B44D73B40A6B67CD35D4358C038D09F6B1CD83B404006D228D14258C000029F6BD4D53B40D1C77CD3834358C080789E6B24D33B40D9DD6178644B58C080C13FC320A73B400103000000010000001B0000005FFB7CD3D54158C018D09F6B1CDF3B40643E7CD3334258C050084A161FDA3B40D27CD128C14258C08059A06BCCDE3B40061C7CD3E74158C0D8339E6B8CE63B40735AD128953F58C0A0659D6BC4F23B4049947CD3B13D58C0B0FBF3C009FA3B40EB717CD3653D58C0D8E8F2C0A9FB3B40B044277EFE3C58C0788B9F6B84FE3B40D2C77CD3033D58C0C827A16B14003C40AF44277E3E3E58C06021F6C049013C40AF44277E3E3E58C0AFFBF3C089023C40BE607CD37F3A58C0FF2D4C165F193C40A9B67CD39D3958C00898F5C0191A3C40E8E3D128253958C020EF9D6BF41B3C403CBB267ECE3858C0708B9F6B841E3C405EFB7CD3553858C0B8914A164F213C40F8FF267E863758C0E814A06BB4223C4061FB7CD3B53658C00FEF9D6B74213C409DDD267E1A3658C0A0FBF3C0091F3C40342D7CD3ED3558C01F2E4C16DF1C3C40BE607CD31F3658C018029F6B541A3C4074A57CD3373658C01798F5C099143C40061C7CD3673658C01085F4C039123C401A837CD30B3C58C0D8E8F2C0A9FB3B4019837CD3AB3E58C0708B9F6B84ED3B402EEA7CD3EF4058C0B027A16B14E43B405FFB7CD3D54158C018D09F6B1CDF3B4001030000000100000032000000061C7CD3071A58C0786CA16B2C583C404A947CD3911A58C0B0659D6B44553C40362D7CD3AD1A58C0D8E8F2C029543C40643E7CD3531F58C0006C48160F4C3C40352D7CD36D2158C0A0789E6B244A3C402C9FD1286D2358C0FFE2A06B7C453C40663E7CD3F32658C048BD9E6BBC3A3C4077A57CD3F72C58C0201B4B167F2F3C404A947CD3912E58C01F2E4C165F293C40B044277EFE3158C0102E4C165F203C40DC0A7CD3C13358C0BF7E49166F1A3C40FA4AD228893458C038D09F6B9C163C40D4C77CD3033558C01085F4C039123C40AAB67CD37D3558C01085F4C039123C40091C7CD3473558C03085F4C0B9163C40CC7CD128C13458C0708B9F6B841B3C401C837CD30B3458C0E8E8F2C0A91F3C403CBB267E4E3358C0AF659D6B44223C403CBB267E4E3358C060AA9D6BDC233C40F4FF267EC63358C0A0659D6BC4263C40A6B67CD3FD3358C0C0339E6B8C2B3C405622277EB23358C0C7FBF3C009303C40DA0A7CD3A13258C0F0E2A06BFC313C40663E7CD3533158C0D8339E6B8C323C40D1C77CD3432F58C020EF9D6BF4343C4086C1D128392E58C0301B4B167F353C406689277E762D58C038084A169F363C40CFC77CD3032B58C000029F6BD43B3C40A028D2287D2A58C050AA9D6B5C3D3C40BE607CD3DF2958C010029F6BD4413C4018837CD32B2758C0C7FBF3C009473C403CBB267E8E2658C00F98F5C099493C404406D228112658C0C8469F6BEC4A3C40964F7CD3192358C01085F4C0B94F3C401A837CD3CB2158C0888B9F6B84543C40765AD128F52058C03085F4C039563C404406D228911F58C078AA9D6BDC563C40EE717CD3251D58C0778B9F6B04563C40A8B67CD35D1C58C0689EA06B64573C4078A57CD3971B58C0F797F5C0195C3C402A9FD1288D1B58C0E8E8F2C0295E3C40A028D2289D1B58C0CF27A16B94633C40C0607CD35F1B58C097A44B16AF643C403A2D7CD3CD1A58C087789E6B24653C40D2C77CD3631A58C0C7659D6BC4653C405BFB7CD3151A58C0F8AAF6C079653C4074A57CD3D71958C00898F5C019633C400C67277ECA1958C068AA9D6B5C5C3C4074A57CD3D71958C0D014A06B345A3C40061C7CD3071A58C0786CA16B2C583C4001030000000100000011000000051C7CD3671658C0706CA16BAC683C40FC4AD228A91758C0686CA16B2C683C40FC4AD228A91758C00098F5C0196A3C40F6FF267E061458C0609EA06B64753C40A6B67CD39D1158C0BF339E6B8C7A3C40D80A7CD3E10E58C0A8914A164F7D3C40D80A7CD3E10E58C0D027A16B947B3C40D0C77CD3630F58C0FF2D4C165F7B3C40061C7CD3A70F58C0B0469F6BEC7A3C40A028D228DD0F58C0C0914A164F7A3C400967277ECA0F58C0D8E8F2C0A9793C404006D228511058C01898F5C099783C400C67277EAA1158C0708B9F6B04753C401A837CD32B1258C0FF97F5C099723C40964F7CD3B91358C0D027A16B14713C40A8F97BD35B1558C03085F4C0396B3C40051C7CD3671658C0706CA16BAC683C40010300000001000000210000009D28D2281DB457C04072F3C0595A3D40EED771B75CAE57C02087A2A349553D4012E610E010B957C0382F718690393D40189706B89FBC57C0AFAEE953A4313D40A8C7FB73DCC457C0784890F6311D3D40AB21A413EEC657C090F82E4FAE163D40CBF93F7375C757C0B89D4E3DC8163D40181B3F5C8BC657C000E6C3BB751C3D40A4AD48B433C557C0B7738565D6223D40E593E11A2DC257C0EF8EBF54B6293D40BA0D5CDEEFBD57C0703ED26137353D406CED4EBB5BBC57C0AF89305F0D393D4076F4B37C70BB57C0302AFCE9A43C3D402A9FD128EDBA57C030084A161F403D40623E7CD3B3BA57C061AA9D6B5C413D40DA0A7CD301B857C068AA9D6BDC483D40944F7CD379B757C08121F6C0C94C3D401E837CD32BB757C037D09F6B1C4E3D40BE607CD3BFB557C0F0E2A06B7C4F3D40C1607CD39FB557C09FA44B16AF4F3D40B044277EFEB457C0AF914A164F513D405EFB7CD395B457C0B8659D6BC4543D40D07CD128C1B457C0509EA06BE4573D40AAF97BD3DBB557C01898F5C099583D40AAF97BD3DBB557C04072F3C0595A3D40FB4AD22889B557C0E814A06B345A3D40705AD12875B557C057084A169F5A3D40705AD12875B557C04072F3C0595B3D40DA0A7CD361B557C00898F5C0195C3D40B044277E3EB557C0DF14A06B345C3D40A8F97BD3FBB457C00898F5C0195C3D40372D7CD3EDB457C038D09F6B9C5A3D409D28D2281DB457C04072F3C0595A3D40010300000001000000990800004D8B60B3B2AE59C05C0FB18806404240448194E6B1A259C0409EE4BB05404240839D94E67D9459C0409EE4BB054042409019C819A38459C0DC3E16EF04404240B8A861B3AE7359C0DC3E16EF04404240202EFB4C2E6259C0DC3E16EF04404240C9832D80AD5059C0DC3E16EF044042407F4B2D80B93F59C0DC3E16EF0440424084C760B3DE2F59C0C05C7D5503404240CAE360B3AA2159C0C05C7D550340424035A12E80A91559C0B07AE4BB01404240CCC4FA4C680C59C0B07AE4BB01404240BB46C719730659C0B07AE4BB01404240100A2E80570459C0B07AE4BB01404240B61E95E6DB0059C0B07AE4BB01404240EE3FC719270059C0A0157D55FB3F42406C0761B3260059C010274B22A8394240988494E6230059C0E88A17EF1C2B42408399FA4C200059C0987D17EF901C4240344F94E61D0059C0508E7E55030E4240A69C60B31A0059C034F24A2278FF414049E12D80170059C07014B088EAF04140F496C719150059C0AC667E555FE241406CE493E6110059C0843B17EFD4D34140102961B30E0059C0D85D7C5547C54140FB3DC7190B0059C09F507C55BBB6414024BBFA4C080059C05CD2AF882EA841409708C719050059C07CB3B188A2994140724495E6010059C050177E55178B4140AC9A60B3FEFF58C0180A7E558B7C414087D62E80FBFF58C0E08BB188FE6D41400195C719F9FF58C0A87EB188725F4140AAD994E6F5FF58C06F71B188E65041402C09FA4CF4FF58C088A24922F84A41402C09FA4CF4FF58C080EA17EFA849414080C561B3EEFE58C014D1E3BBD1494140614B61B30EFC58C0E05FB2887E4A414086D193E611FB58C05BCF4A22044A41407D9EFA4C7CFA58C01C287F5573494140C6252E8011F958C0D0317D5503494140C40A61B372F858C0C4A97E554F484140003DFB4CA4ED58C014AFE5BB25374140A04B2E8063EC58C0A03118EFFC3341406432FA4C92EB58C020B616EF84324140A937FB4C62EA58C030A44A22E831414010B861B382E658C00C3F19EF48314140C15A2E8057E558C030A44A22E831414017412E80E5E458C010D47D55833241405C1261B328E458C030324B22EC334140693B2E8097E358C0AC02B08886344140C6A560B306E358C0D8D07E55CB344140B8BF94E6EFDF58C0B4367E5513344140AB3B94E67DDD58C0406316EFD4314140C5F794E629DC58C07C717D55F330414006E22D80A7DA58C030624B22B03041403E5CFB4CB0D958C0C8E916EF743141407913C7192DD958C0745AE3BB693341403B88C719CBD858C09C9019EFC83941405C7060B326D858C00859E3BB393B4140D7C3C71931D758C0309B7D552B3B4140223A95E601D658C09C7E17EFC4394140BC422D80B3D558C090B5E4BBFD38414040EEFA4C84D558C0301118EF183841408B7FFA4C40D558C050C67C552B3741406E2B94E6B1D458C0FCB0E3BB4536414034CBC61927D458C04C7F17EFDC354140B13095E681D358C037A5E3BB9D354140C5DC93E645D258C054C4B0887A354140750C94E6FDD058C02007E3BBAD344140DCD6C7195DD058C020AEB188C232414089602E80F7CF58C0906417EF6C304140F9EB2D805FCF58C084654A22682E41407D6060B366CD58C014E017EF7C2B41407C2061B34ACC58C004FBB1883E29414070EE2D808DCC58C05816E4BB35284140646CFB4CC8CC58C028B3B088B626414055B594E69DCC58C058A64922C81F4140A8B760B35ACC58C0047EE3BBB91D4140C962FB4C42CB58C0C04A19EF3C1C41404BCF2D80D3C958C04B9C4A22C41B4140889D93E6D9C658C0B4CFAF88FA1B41402C9BFB4C88C558C0BCD84B22B01B4140BEABC7191BC358C09C4F4C22701A4140754C94E6D3C158C0D0ECB088261A414022DFF94C74C058C03066B088861A41404D8FFA4C72BF58C0D44D7D553B1B4140A24261B36ABE58C0CC8BB288A21B41404E35C819FBBC58C06C3DE5BB191B4140B288FA4C2CB858C088324A22DC154140126E94E6E1B658C0001C4B2218154140D6442E80DBAE58C02C494C223012414052252E8015AE58C0A44318EF7C1141405AB52D80CDA958C04C104B2270144140CC3FC7195DA858C0505F4B22E814414042AFFA4C96A758C06012B288DA14414049E9C61981A558C038134A221C14414054D5FA4CC8A458C030DEB0886A1341406A2995E6C1A358C0C0067F555B1041405E2A94E651A358C060E3E3BBA90F414012A994E681A258C044F27D55B70E4140BC5D61B35EA058C054E9E4BB910A4140BEE02D80679F58C0C8097D559F094140CCD1F94C349C58C0B81B7F55A3094140BCB961B3A89A58C0DB4C18EF1C0A414030A5C7194D9A58C07BF4B1884A0B41406CE060B35E9958C0C44B4A22680D41406888FA4C989858C0D4537D55BB0F4140A2A9C719979758C0EC1EB2889A1141406859FA4CF89558C04C5318EF5C124140ECD8C719698D58C06C7019EF88104140AEB5C719718B58C0003119EFF010414086DD60B3708858C0507F4B22C01241403E1CC719D18658C0F43F4B22281341402AF32D80CD8558C018777D55B3114140284C2E80D78558C0A4A24A22500E414060EA93E6198658C0F0CBB088820A414060912E80C38558C0E8974A22CC0741407600FB4CA88558C0F4894B2290034140BE402E803B8358C0D807B088860141402A4F2E80178058C0585917EF74004140F49394E6D17D58C0D45F7E5523FF404050E4FA4C2E7D58C0685DB28866FF4040C45C94E6B57C58C0F4DD4B2264FE40403A3794E6957C58C074B4492210FD404045DD94E6FB7C58C0346F7D558FFB4040425861B38E7C58C0306AB28832FA40407A4661B38C7C58C04816B188F6F8404045DD94E6FB7C58C0B452E4BB51F640406C1D94E61D7D58C020594B2200F54040E057FA4C3A7D58C0786C18EF34F440401A8C94E6617D58C0B4B9B1884EF24040515FC719C17C58C0F87D7E550BF140409F96FB4C4E7B58C0A4AD7E55C3EF40403C0F2E80937858C09CAFB2884AEE404056A6FA4CC67558C0F8A17E551BEF40407CF62D803F7358C0E4CB18EFA4F14040E98E94E6C16D58C028BDB288E2FA4040685361B3846B58C0A8D67E55E3FD4040A2F6F94C006958C0C8344C224CFF4040E4CE61B3946658C0848E7D554FFD4040B88F61B3026658C0803DB18826FB404096DCFA4C106658C0B475B18866F640404EBB61B37C6558C04CDF7D5503F44040F4D2FA4C8A6458C0245FE4BB11F340400A1A61B36C6058C028AEE4BB89F34040285A94E6F95E58C077F949221CF340400CDAFA4C085E58C07C4FE4BB31F240407888C719855D58C038474C228CF04040764B2E805D5D58C0084218EFE4ED40404C52C819F55C58C060F216EFECEA40402AAF61B3EE5B58C0EC61E5BBD9E940405C8861B3CA5758C0488DE5BB4DEA4040AE442E80115758C07BEE16EFB4EA4040841FFA4C925658C0688F16EF50EB4040DCDAC719495658C0D0494A22C4EB40408C1C94E69D5558C0D87EE3BB75EC40405ECC2D80475558C07CA3E4BB05ED40401466FB4C165558C0D8F1B1888EED404048E993E6B95458C0D0C74A22DCEE40405A9794E6955458C0E0F37D553FEF40408C3E94E6915358C0B8A1E3BB61F04040119060B3CC5258C01704B1880EF0404072F9C719175158C090D47D557FED404018DC2E80BB5058C0D4E4B0884EEE4040429694E6974F58C080AEE4BB95F14040E844C819634F58C02870E5BB89F24040E58260B31A4F58C0132F4C2224F340409ADF94E6C14E58C0A8EF4B228CF340402B492D80F34D58C040024B2218F44040D8D293E68D4D58C0C4FE18EF7CF44040D42A2E80BF4C58C01CBA492284F340403CD294E6094C58C00825E5BB49F240408374FA4C8A4B58C0B00E4B22D8F04040EC1361B35E4B58C0E0F37D553FEF40406AE460B3AC4B58C0F0A717EF2CED4040C00B61B3E24C58C00C49E4BBF1E94040B653FB4C284D58C08C277D55C7E74040A45FFB4CD64C58C07038B088AEE44040E5B460B3FA4B58C06C527F554BE140407A52C719B94A58C0D09617EF68DE4040427EC719394958C0F8EC16EFD0DC4040250E2E80334758C0CC0918EFF0DC4040B2DAC619014658C0CC3717EF04DF4040F8FA94E66F4558C078907E554BE24040121161B34A4558C03C79492208E640407AAEC719034558C0A0EFE4BB69E740408C63C719C94358C0D02B4B229CE8404041D1C619814358C0DCD5B08886E940408C0AC719BF4358C018A6B088CEEA4040D98B61B3424458C0481DE4BB71EB4040A07294E6B94458C0E44A4B2250EC404070A761B3D04458C09CAFB2884AEE4040CA95FA4C8C4258C00C3CB18842ED40401A1D2E80214158C0084218EFE4ED4040A9F92D80234058C0F8CEB2880AF0404072C42D80233F58C028AEE4BB89F3404076F860B3FC3E58C02C9DB188A2F640401AE62D800B3F58C0880AB1884EF840400BA02E80953E58C0583119EF48F94040AC58C7193F3E58C0608DE4BB99F940408A292E80E13D58C028FCE4BBDDF940405E022E80B13B58C0782BE5BB89FA4040D057FA4C243B58C0782BE5BB89FA40409E4E2D80873A58C0DCC14A225CFA4040659EFB4CA83958C0272717EFB4F940405A9FFA4C383958C0E7FC7C551FF94040CEEC61B3E83858C0D079E4BB81F8404044F293E69F3858C024CDE4BB3DF74040F07BFA4C3A3858C0C8657E55A3F34040888D93E6ED3758C0A8DC7E5563F24040A66DC719873758C0E0B0B08852F14040E27D2E80C13658C03052B088FAEF4040AC7DC719733658C0B0497D559BEF404066CFFA4CFC3558C0801CE4BB59EF404034C62D805F3558C080F916EF44EF4040A9C02D80173358C0CC12E6BBC9EF4040BEB3C719913258C058F04B22A4EF40407C6F61B3E83158C04F0DB28816EF4040EE0A61B33C3058C0B438E4BBF9EC4040358294E6E52F58C0207D4A22A8EC40402F10C719592F58C08025B2887EEC40405FC92D80A52E58C090674C2270EC4040727E2D806B2D58C0E8E74A22B4EC4040F0DAFA4CC42C58C0F0D2492204ED40408ED0C719492C58C0C83A4B2264ED404082A694E6012C58C014AE7E55CFED404006F060B3C62B58C0A8914B224CEE4040AE9E94E6912B58C03051E5BBD5EE4040D6D52D80652B58C027F2E4BB71EF4040766994E6912A58C06391E3BB69F34040CBA894E6292A58C0F03317EF80F44040502894E6E32958C0241817EFECF4404068B1C7198F2958C024C2B2883EF540407C2894E6E92858C07C4A16EF44F54040CCA7C719092858C0A065E3BBE9F440404E482D80732658C084227E55D3F3404022622D80EB2558C0B03C4A22ECF240400A3AFA4CC02558C04F08E4BB29F240403E6694E6712658C0C000E4BBC5EF404086B2FA4C902658C018E97E5523EF404078412E808F2658C010B4E5BB71EE4040A29B94E6772658C06C8A7E55CBED4040263E61B3462658C0E0657D553BED4040CE9394E6072658C05CE717EFC4EC40403CFAC6193F2558C020187E555BEB4040B42194E69D2258C060D7E4BB01EA4040267861B39C2258C060D7E4BB01EA40400C2395E6352158C0985917EFCCE840405691C719DD2058C010B8E4BB41E8404006A8C619A72058C0E8374B2250E7404084A393E67F2058C0CC4E4A2220E640402291FB4C422058C03CED4A221CE54040CDEE93E6C51F58C07038B088AEE44040A8F094E66F1B58C07F76E5BB15E54040E0CBC719451A58C07038B088AEE4404028302E80C51858C0C4F54A22A4E14040A5702D80F31658C0687B17EFE0DC4040BB6A61B30A1558C0A038B288D6D940405660C719471358C0C03CE5BBF1DB4040AEF8C719E91258C017957E559BDE404098662E80EF1258C00C0C17EF84E04040BEAE2D80871258C074DD7C55ABE14040DF08C819DB1058C0D886E5BB0DE2404082F2C619210E58C0183EB1888AE1404047802D80F90C58C0E4EE4B22C0E140403832C719C50B58C0203C7D5503E34040A0FCFA4C240B58C088BB7E55B3E44040CABF61B3020A58C01CC24B221CE94040426C2E80630958C060D7E4BB01EA40400E4094E6B10858C0BCC8AF8846EA404052C0C619610758C077467D557BEB4040F4E9C619BF0658C0B0144C22C0EB4040F84FFA4C780358C0B0144C22C0EB40409E3A61B3920258C0604218EFF0EB40405D81C719690058C090D47D557FED4040EA5661B338FF57C087CDE3BBE1EE4040D6EE93E63DFE57C0138A7E55BFEF40401B822E80C9FD57C00FEA7F55AFEF4040928760B380FD57C064BD7E55A3F04040B41FFA4CD4FC57C03B1DE5BBD9F1404036B0FA4C06FC57C04857E4BBA1F240406E332E805DFB57C0B4B9B1884EF2404047F22D80AFFA57C0405918EF28F14040D52E61B310F757C0D4A6B1884EED40409C38FA4C54F657C0445CE4BBFDEC4040E69CFB4C88F457C090D47D557FED4040284161B324F457C02C73B1885EEE404080D060B3C4F357C0887FE4BBF5EE4040B21F61B342F357C0E0F37D553FEF40403BF660B3EAF257C02C73B1885EEE4040B65B94E691F257C05096E3BBC5ED4040AAEBC61921F257C090D47D557FED4040526CC7196DF157C06097E4BB51EE40409CF5C619B3F157C0B0FE4A22ECF14040B20B2E8041F157C07FC1B188BEF24040AC6361B32AEF57C0E40918EFA4F24040F4BFC71935EE57C04CCCB088DAF24040E46961B38AED57C07FC1B188BEF24040BA67FA4C20ED57C06FD77D5593F3404056202E807DEC57C0FF63AF886EF44040BEBE93E6C5EB57C0AF9F18EF18F54040B4E2FA4C1EEB57C0082017EF5CF54040A68B2E809BE957C0C8D17C55B7F640405C1CFB4C68E957C0A016B18802F74040C258FA4C58E857C0FC7B7D555BF6404056DDFA4CDCE757C0B452E4BB51F640401203FB4C02E757C0FFA67D55C3F840401DE62D8047E657C028FCE4BBDDF94040275694E66FE557C0307EB28856F9404048A893E699E457C0B00B17EF2CF840406E7D61B3C8E357C0FCEE4B2274F74040A69E93E613E357C01BE64A2278F6404024C72D8093E257C0C4FE18EF7CF440404A5F2E802FE357C0005D7D55A7F24040D357FA4C60E257C0244C17EFE8F14040C0E760B35AE057C0D8B1B188DEF14040C6612E805DE057C080D1B188AAF14040E077FA4C38E057C028F916EF38F14040E43861B3F4DF57C0AC3417EF98F040403DB7FA4CD0DF57C0F8CEB2880AF040405EB1FA4C7CDF57C017797D5547F0404066FF94E61BDF57C0D8C1B188CAF0404056CC60B3D2DE57C0C4D67C5513F14040CC812E8035DE57C034137E55FFF0404078DFC619B9DD57C0CC2D18EFB4F040403AFBC6194DDD57C0B4D9B18826F040401E732D80E5DC57C0E0F37D553FEF4040569D60B332DC57C02CE0E2BB6DEF4040EFEF93E6D9D657C09C18E4BB21EF40401F75C7194DD657C0E0F37D553FEF404022F994E6E1D557C080A3B28896EF4040ACE960B39CD557C034237E55EBEF404082A060B378D557C0C8C4B08876F0404080D693E66DD557C0474417EF78F14040A7C62E803BD557C0CC864922A0F240400C1EFB4CCAD457C02C81B0889AF24040335D94E613D457C0D8B1B188DEF14040B1EF94E661D357C0B804B2888EF24040F2FD60B3CCD257C0ECF416EFF4F24040162C94E651D257C0A73D4B2278F3404047F761B3EED157C0C4FE18EF7CF44040C62761B330D157C03C8818EFC8F34040D036C719D9D057C05CD4E3BB2DF540407158C719C1D057C0E0FAB0886EF7404066BBC7195DD057C0307EB28856F94040566460B326CF57C0C8F17D55F7FA4040FA112E8019CE57C030D7E3BB41FB4040A48FFA4CE0C957C09C7C7E55DBF840407C842D8027C957C00472E4BB11F8404038522E80CFC857C0883D7E554FF74040109661B38EC857C0500A7E556BF640401434FB4C36C857C0100B16EFACF540401420C81935C657C0CC8916EFDCF4404054C5C71915C557C000FB7D5597F34040D41F2E8009C357C08892B1881EF040400E41FB4C08C257C0E8EA17EFF0EE4040C07060B30CC157C0800D17EF68EE4040D4582D80D3BE57C09CAFB2884AEE4040564B94E65DBE57C0B428E4BB0DEE404006622E80DBBD57C0676F16EF78ED4040E6D093E671BD57C0DC167D55C3EC4040CDA860B346BD57C0D404B18826EC40403E3361B31EBD57C0B8B7E4BB35EA404022ABC719B7BC57C010CBB1886AE9404045B62D8027BC57C0707B7E5503E940407EFA2C8087BB57C010B8E4BB41E840408E1294E631BB57C0A400B0887AE74040B96B94E641BA57C07038B088AEE4404060E1C719DBB757C084A4E3BBC1E040403CA694E6A9B357C08BFD7C5583DF40400456C7190BB257C0101716EFACDE40406AE361B342B157C0539B4A2290DE4040502494E659B057C068B916EFE0DD4040B4C294E655AF57C0F81017EFE0DA40403FB2FA4C38AE57C04C7F7F55EFD94040F9E060B3ACAD57C0EC5F4922C8D84040507961B34EAD57C0BCC1E3BB85D84040C441FA4CDEAC57C030C616EFACD840407269FA4C20AC57C0707FE4BB41D940404A7094E6B7AB57C064AE16EF50D94040592EFA4CCCAA57C060167D5503D94040B21EFA4CECA957C0BCC1E3BB85D84040604FFB4C30A957C0EC214A22C8D7404084742D80B3A857C0DC4FB188B2D64040E63695E607A757C0F0F116EF2CD74040C431C819A9A557C0EC29E5BBF1D64040AB2CC719DFA557C0740A4A2278D640400C7E93E613A657C0A07CB288BED54040EA06FB4C24A557C07B3C16EFECD44040B86DC8191BA257C03C827D5533D34040B86DC8191BA257C0F0024A2214D440407EF22D80F1A057C01C9B7E551BD34040BD69FA4C529F57C0607218EF00D340403FD82E80FB9E57C00C14B088DED2404062EB94E6E19D57C0CBDC4A2270D240405A5FFB4C429D57C02093B0881AD04040D44861B3CA9C57C06CF9AF886ECD4040BED92D809D9B57C0281C4A22A0CB404060DFFA4C0E9A57C010E24A22D8CA4040BEB22D80739857C03073E5BB41CB4040BEB22D80739857C01827E4BB75CA404032B160B3409957C0146FB28826C940403ADC2D80CB9857C0103918EFE8C740409EA560B39E9757C0E036B1887EC74040D2F3FA4C449657C038B5B188A2C84040F879C819FB9457C08CA8B0886EC740403665C719519457C0282118EF8CC84040BEC8FA4CDC9357C0E0B4B18896CA40403B25C819359357C06C94E3BB21CC4040C9642D801F9257C0308E17EF2CCC4040442894E6098F57C0E053E5BB81C9404093A7C719298E57C0C094E3BB2DCA404034322D80538D57C044184A2268CB4040AE14C8195D8C57C0BC89E4BB05CC4040A6BAFA4C328A57C0F4F0E4BBE5C940409C1394E6F38857C0D00D4B2258C9404084D893E69F8757C00C7818EF74C94040ECAAC719758657C01827E4BB75CA4040B86B60B39A8457C0946018EF24C8404030BFC719A58357C060A34A2258C74040B6DC60B3068357C04012B088EEC64040B6DC60B3068357C014BAE4BBD5C64040A7A1C719FB8257C020D27E5583BE404018D5C719E58257C0B4664C223CAF40408808C819CF8257C0C80C18EFF49F4040C8B593E6B98257C0D0B2E3BBAD90404070E094E6A38257C05F47B18866814040060495E6A78257C07BD9B28862724040EAF72D80AB8257C0CCAC17EF5C634040801B2E80AF8257C08CDF4A2258544040D6D660B3B28257C040127E5553454040698994E6B58257C004B67D554F364040C8B593E6B98257C018D7B2884A274040DEA02D80BD8257C050AA17EF44184040A9BB2E80C18257C01FBFE3BB41094040803EFB4CC48257C040C42FDE89FF3F40B2622E80B78257C0DF04964400FF3F40542B2E80958257C07F1F954408FE3F40DD012E803D8257C000089544B8FC3F40A648FB4C5C8157C0BFB7FBAA7EFA3F4084C061B3F48057C0EF882EDEC1F93F4024A4C719298057C048D2C777A3F73F40EEAC61B3DC7F57C037AE2FDE69F63F40B76EFB4C8E7E57C059192FDE19EE3F408B022E80557E57C067E0954430ED3F4042792E800F7E57C06F882FDE69EC3F40BD7E60B3C67D57C0302F6311C5EB3F404CAA94E6AB7B57C08F2D974420E83F406EB5FA4C1C7B57C09859C6778BE63F40630E94E6DD7957C0907730DE19E23F40742EFB4CFE7857C03F96974430DE3F40923961B36E7857C030F1C977CBDA3F4054C82D801F7857C0D078FDAA66D83F40AED3FA4CDE7757C097489744E8D53F4035372E80697757C070012EDEA1D23F4009082E80C37557C0A70D631155CA3F40323FC719977557C0C0ABFAAA06C83F401ED8FA4C287557C0E0A2FBAA26BE3F401A7894E6EB7457C06859C67723BB3F405E6294E6B17457C0A8652BDE29B93F40B2BD60B3787457C03F8561115DB83F4036602D80477457C0E0BC611185B73F40DDD82D801D7457C0B7D760118DB63F4080532E800F7457C02FC6FDAA46B53F40F2F9FA4C167457C0B04AFCAACEB33F4068CAFA4C647457C077056211BDAF3F400E8294E67D7457C0179332DE61AD3F40D08C93E6997457C0CFB130DE39A63F4088DFC719AF7457C0D8B3C97713A43F40BC4094E6C97457C0DF0DC977B3A23F40F2E7FA4C0E7557C0FF95F9AAD6A03F401033FB4C4E7557C09F1A64112D9E3F40515C94E6577557C0703CC7776B9C3F401033FB4C4E7557C0C84EC9777B9A3F40C049FA4C187557C0C065631105983F409AB0FA4CEC7457C0C93865117D963F40463A61B3867457C0DFD05F1125943F40F8D42D80E57357C087F22EDE31913F40929D61B32E7257C03F656411AD8A3F40B3A8C7199F7157C0F78BFEAA16893F403667FB4C507157C06086CA7763883F40E4B12D80F37057C077569744C8873F4088B7FA4C646F57C02877944428863F409FE72D80056F57C0701130DE99853F409A6DFB4CB66E57C0D747CA77E3843F40428DFB4C826E57C02151FAAAD6833F4020B7C7197B6E57C040ED64117D823F40533B61B3AA6E57C0C0342FDE29813F405678FA4CD26E57C0F023C9776B803F4010C22D80E56E57C048855F1125803F408AD9C619ED6E57C0B8CDC5770B803F40E108C719996F57C0D7052FDE897E3F4022072E80CB6F57C01F15FCAA867D3F4072AA94E6D76F57C00F0FCB774B7C3F400C02C819B56F57C018CE9244407A3F406EF12D80916F57C05015FFAA16793F40E3222E805F6F57C0104FCB77FB773F40CAE02E80216F57C097C6C87743773F4064F2C719D56E57C0C87ECB77B3763F40BEC660B3126E57C06079974400763F4032BBC719B96D57C028DDF9AA76753F403C732D80736D57C000086211B5743F40D6B094E63D6D57C020DB63112D733F401A4494E6156D57C05F6560110D713F40E6BFFA4CE66C57C0976EC977EB6C3F40BAAC2D80B76C57C07747C977BB6A3F4051EA94E6816C57C07FF72CDE09693F40BC1C94E6DF6B57C03755CA7713663F401229FB4CE26A57C0786BC87763623F40DCD793E6FF6957C03F07944458603F405A2C61B3E26957C0DFE3F8AAA65F3F40228E60B3EC6957C0085232DEC95E3F40D7F460B3BA6A57C017C69444385B3F4044E1C719EB6A57C078F3C877335A3F40966AC719316B57C0E73DC877F3573F401F90C719516B57C02F5D5F1175563F40920061B3626B57C0A0322DDEA9543F40026A94E6416B57C0D869FAAAEE513F4062B0FA4C0C6B57C017E3C6776B503F40D04D61B3C46A57C000606411354F3F40B2982E80216957C02F159644704A3F40EAB960B36C6857C07F2D9644D8473F4098D960B3386857C0E79B2DDED1463F407A4061B30C6857C0D095FCAA96453F4086EE61B3E86757C0C0252DDE29443F407690FB4CC86757C01093CA7713423F407AC42E80A16757C08FF0FBAA4E403F40BAFE2D806F6757C0003331DEF93E3F40C29CC719176757C0B032FEAA163D3F4080CA2E80FB6657C0307AC877C33B3F40687F2E80BB6657C010079444F0343F4018B9FA4C9A6657C04F6730DE99333F403FF093E66D6657C0602E9744B0323F40B0B0C7193B6657C0E9286311FD313F4012472D800D6657C0C01531DE81313F4069CEC719EB6557C06741964448313F4028D060B3B86557C0BF6B954430313F40EC81FA4C7E6557C07FC5CA772B313F40DCDA93E63F6457C0B04F30DE49323F40E84194E6196357C04F232FDE49313F4039B0C619C16257C0308030DE192D3F401EF3FA4CF06257C03FA9FDAAAE213F4003D42D80136357C01F372CDE291F3F40AA2AC719AD6357C080FEC877B31B3F40C002FB4CD06357C040BF5F11DD183F40B87D60B31A6257C05FC56311550F3F40E42F61B3346157C0B0FC30DE990C3F40F66194E6F16057C0F00CC577C30A3F404E0C61B3306157C001A3FEAA2E083F409EF5C619B36157C04707CA77FB063F400F212E806F6357C06812C97723053F40AE06FB4C086457C080EBFBAAD6043F4072CB61B3F66457C01F2EFBAA26023F403A6B94E66B6457C07FABF9AA56FC3E4026B3C719696357C088689744D0F63E401EF3FA4CF06257C0A8F0C777F3F43E4026C5C719716257C01F5DC977A3F13E4004DC2D80896257C0A86DFCAA7EF03E401EF3FA4CF06257C047CE6211CDED3E4024E1FA4CE86357C0FF6C6311D5EA3E4010B82D80796457C0000A9544A8E83E40B03B94E6B96457C0C034CA7703E63E40F6F160B3A66457C047D264112DE33E409B24C719536457C0E8B1954450DE3E40DCDA93E63F6457C0370830DE71DB3E404E8160B3466457C097B3C87763D83E40967DC7195D6457C008FEC77723D63E40B03B94E6B96457C04002FAAAD6D13E4074F960B30A6757C058272FDE09C33E4095FDC719916757C028932EDED1B63E40D07761B32E6857C067AFC9772BB33E40BC3694E65D6A57C081582DDE21AD3E40EE2595E6E76A57C08842C97723A93E40F4BA94E6D56B57C0685FC877739C3E40C43F61B3F46B57C0F01EF9AABE993E406A0AC819376D57C0C818C87783983E403E0AC819316E57C0083D63114D953E406940C719C16E57C000B4FAAACE903E40483D61B3C66E57C04FA7C677C38B3E40A162FA4C986E57C090EF9844788A3E40B65594E6116E57C0305F964450893E409E2D61B3E66D57C070E1C8771B883E408278FA4CD86D57C05027C77723833E409E2D61B3E66D57C07F656111DD823E4054FC60B31E6D57C018ADFBAA367B3E40FE8E2D80076D57C0C00764112D793E401C312E80356D57C0186360116D743E408DAC2D80B16D57C0A90C9644F8703E40EAA660B3406F57C0106F62113D6A3E40FE5C2D80277057C008A4FAAA86643E406428C7195F7057C0F02B6411955F3E400C7EFA4C207057C007FA954450543E40A252FA4CAC6F57C098B3954460503E404E8B60B3B26E57C050EE9444404D3E4050672D80C56D57C0207C2FDE89493E40515EC719776D57C007A69544C8433E40051BC719A76D57C077E72EDE39413E40B27A61B3426E57C0BF7B30DE313C3E40C2CFC619616E57C0088BCA774B393E40BA922D80396E57C08F0DC777BB363E40BE7760B39A6D57C008316511FD323E40515EC719776D57C0F03AFEAA46313E40338693E6536D57C07719C9778B2C3E40F7372D80196D57C0B8B29544E0283E40E8FC93E60D6D57C0308B6211CD243E40515EC719776D57C03798C777EB1E3E402492FA4C4A6E57C04086FEAADE193E40CFBA60B3646E57C040782EDE81173E409E2D61B3E66D57C02F7DFCAA6E143E40034C2E80AB7157C00FD8621195053E40F2B0FA4CF87257C0C1F9954480FD3D40AED81B55197357C0F88CC1B650FC3D4094286AB2647457C0086BEEFF9BFC3D401499680C6A7557C010B47F9BCEFB3D40FA4AD228A97657C0076C48168FFC3D4001D97CD3E97657C0202E4C16DFF73D40EE717CD3857757C0DF14A06B34F33D4068FBB158297B57C097775F6099DD3D40214FB4060A7C57C0284F81A34FCE3D40ACE8768CB17B57C0F8F6AFACB4C63D40392D7CD30D7857C090A44B162FB93D40FC4AD228097757C09759A06B4CB13D402C9FD1280D7857C0C7914A16CFAC3D4004D97CD3C97857C08FA44B16AFAC3D401C837CD3AB7A57C0CF339E6B8CAE3D400A1C7CD3678257C020D09F6B1CAF3D4084C1D128D98357C0CF339E6B8CAE3D40FAFF267E868657C0706CA16BACAB3D4004D97CD3698857C0786CA16BACA83D405622277ED28D57C0D027A16B149E3D40715AD128759557C07F8B9F6B04943D40C2607CD3DFA957C0B0A44B16AF733D40745AD12835AC57C03985F4C0B96D3D40D6C77CD383AF57C0A80EF5C0E95F3D404106D228D1B057C0F1019F6BD45D3D404006D22851B257C08F59A06BCC5E3D40964F7CD399B257C05F21F6C049613D402A9FD1280DB257C0E814A06BB4643D409E28D228DDAC57C0F7AAF6C079763D405EFB7CD335AB57C0D0339E6B8C793D40663E7CD3B3A957C0D87E49166F7A3D4078A57CD3F7A857C079F548163F7B3D405322277E52A857C00F029F6B547C3D405EFB7CD3D5A757C010EF9D6B747D3D402C9FD128EDA557C03F1B4B167F843D402E9FD1282DA557C0D014A06B34863D40A8B67CD39DA457C0B8659D6BC4863D40FAFF267E66A157C090789E6B24863D40F94AD22849A057C0BFE8F2C0A9863D40934F7CD3799F57C059BD9E6BBC883D4040BB267E0E9F57C04072F3C0598D3D40904F7CD3199F57C0C7469F6BEC903D402B9FD128AD9F57C0E0339E6B0C8F3D40EC717CD3A5A057C0BF339E6B8C8C3D40F2717CD3E5A157C02085F4C0398E3D4002D97CD3E9A257C0778B9F6B84913D403EBB267EEEA357C00098F5C019933D40ACFBB6A9BFA657C0D0DAB0787A8D3D4051B449B07EAC57C0A033D636F9893D40A4B8480C28AF57C037EFA0494A873D407D430CC755B057C04719F4A336863D40B2AB40F5DBB157C09FD47403A6873D408E2F563E65B257C0A0405D3A6C8A3D40545603C23EB257C0A00A9FD8038C3D400205793185B157C02195447FB38A3D40B6DAE5B6B8B057C02057533B3E8B3D408049001DF7AF57C0B033152EA08F3D405239E0FF16AF57C050F7D1C248943D406B1D1D36D5AD57C04887B23E859C3D40A5B4B9C2FFAC57C0C0C57F1283A63D403A15E7DD55AC57C0DFE5EB5843B23D404786FA9582AC57C068BA9CE2D6B73D40D6B84CEDEFAC57C0D89CB90B3DBC3D408CC346AA06AD57C000500D3B59C03D408C39B58473AD57C0281BCE4BB1C23D4019541B2F0CAE57C0D7661C04CCC63D40DD8AD1C1FAAE57C0F03135F040C83D40C6CC2FF7A7AF57C0A7CC78A23EC83D4006412B56ABB057C01F5A673AC3C63D40266AB38E83B157C0AFC0B599DEC53D40BC66C7E0DDB257C0184E53788EC53D40E3B861AEA1B357C07024547330C83D40EA264837E5B457C050C35316A5C43D40AEFEC381E3B457C0FF6EE506F2BF3D4004FB5D7550B657C050A50C2EB3B73D400A91D4213BB757C01061FD0CE0AE3D400E3218A211B857C0D82ECBA474AA3D40561B1F9D02BA57C0904C34E05DA83D40E35348ABDABA57C0404F8D88C3A73D40AB57139C9EBB57C0FF5A4388AFAA3D403E5FBD610DBC57C0D8CBFC128DB03D40FAC5F805BBBC57C01FB54071B6B13D40EE6487C3D5BD57C0E081A7C855B43D405122277EF2BF57C08F59A06B4CB73D405666C9FDFDC057C0070D8C9665B83D407D116030B6C157C0288B29A270BC3D408D0205F02CC257C021E303299BBF3D40AEAA2F8F58C357C0F862FE7EEFBF3D40904F7CD319C457C0401B4B167FB63D408D35F69438C357C00001FBA1FFB43D4068FB31225BC257C0BF914ED14FB43D40D64EF540D8C157C03FE65B248FB23D40BAA113E92EC157C0E80682350BB23D4086518A9592C057C0886975F386B13D4082967EBAE8BF57C0B05D1CFAC6AF3D406428B05E17BF57C00054AFD7CBAC3D40830CAD798EC057C09088E001E3A83D407C3D279C01C157C05F5A7A6CFFA43D404811CB59A4C057C0401096743EA03D40A38AEA5902BF57C0E07E59B12A9B3D400CE76CF74EBF57C0286F88BE29983D4086C1D12859C057C03F084A161F943D40EE717CD305C157C090789E6BA4913D40051C7CD387C157C09859A06BCC8A3D407C0D5066F8BE57C0E0B23BAC89833D408023F75D19BA57C098E8F82B0E7F3D40F475C6488DBA57C080A5C1EEED7C3D4097FDD2B91ABB57C0A1458D28BE793D40382D7CD3EDBB57C0609EA06BE47A3D406989277ED6BC57C05F21F6C049793D40D4C77CD3C3BD57C02085F4C039783D40D4C77CD3C3BD57C0F7AAF6C079763D402FEA7CD3AFBC57C0F014A06BB4733D40A128D2289DBC57C01FEF9D6B746F3D408AC1D12859BC57C0B8FBF3C0096C3D40715AD128B5BA57C0A0914A16CF6B3D40715AD128B5BA57C03985F4C0B96D3D40904F7CD3F9BA57C040084A169F6E3D40DE0A7CD301BB57C0F797F5C0196F3D40B044277EFEBA57C078F54816BF6F3D409CDD267EDABA57C078F54816BF6F3D40EE717CD3C5BA57C0172E4C16DF6F3D40CFC77CD3C3BA57C0BFE8F2C0A9703D40715AD128B5BA57C02885F4C039713D403CBB267EEEB857C00FD09F6B9C663D40AAB67CD33DB857C000029F6BD4643D40FE4AD22869B757C07921F6C049643D402E9FD1288DB457C030BD9E6BBC5F3D401E837CD3CBB457C0C07E49166F5F3D40C6AB277E02B557C08059A06B4C5F3D40623E7CD333B557C0A70EF5C0E95E3D40DA0A7CD361B557C0F1019F6BD45D3D40A228D2285DB657C05FF548163F603D40643E7CD3B3B757C02F1B4B167F613D40C6AB277EE2B857C05FF548163F603D40E6E3D12865B957C02885F4C0395B3D402CEA7CD3AFB957C0C0E8F2C0A9553D402B9FD1286DBA57C07F21F6C0C9503D400A1C7CD367BB57C048BD9E6BBC4E3D4001D97CD369BC57C028D09F6B9C513D40924F7CD3D9BC57C028D09F6B9C513D40D07CD12821BD57C0B0469F6B6C4E3D40944F7CD3B9BD57C050BD9E6B3C4C3D40FA4AD22809BF57C068AA9D6BDC483D4084C1D12839BF57C0706CA16BAC483D40DA0A7CD3C1BF57C0808B9F6B04493D405122277EF2BF57C068AA9D6BDC483D40A8B67CD3FDBF57C0B8A44B162F483D4004D97CD3E9BF57C0C827A16B14463D405122277EF2BF57C0FF2D4C165F453D401E837CD32BC457C0B0659D6B44343D40061C7CD3A7C557C06021F6C049303D400A67277E6AC757C038BD9E6BBC2C3D40623E7CD3F3C757C0CF339E6B8C313D40061C7CD3C7C857C0C0469F6BEC323D402B9FD128CDC957C0AF469F6B6C333D4005D97CD3E9CA57C0F0E2A06B7C353D402E9FD1286DCA57C070AA9D6B5C333D40924F7CD399C957C038BD9E6BBC2C3D402EEA7CD32FCA57C0888B9F6B04273D40B044277E1ECA57C0818B9F6B84213D40924F7CD399C957C0C7914A16CF163D40623E7CD393C957C0F8AAF6C079123D40362D7CD3ADC957C0D8AAF6C0F90E3D401E837CD32BCA57C0F714A06BB40B3D404306D228D1CE57C04872F3C0D9FE3C40CFC77CD3A3D057C018029F6B54FB3C406589277E16D457C0DFE8F2C0A9ED3C40FA4AD22889D757C01FD09F6B1CE33C40081C7CD347D857C0A0469F6B6CE13C4061FB7CD3B5D957C04FAA9D6BDCE03C40643E7CD3D3DA57C0BF914A164FDF3C403A2D7CD32DDF57C0689EA06B64D43C40EE717CD385E657C0C0339E6B8CC33C40F2717CD345E957C030EF9D6BF4BE3C406689277E16EC57C0401B4B167FBC3C4086C1D128F9EE57C08859A06BCCBB3C401B837CD3EBF157C0689EA06B64BC3C402EEA7CD34FF457C07F8B9F6B84BB3C402E9FD128EDFC57C09F914A164FB03C400A1C7CD387FC57C0816CA16B2CAD3C40A8B67CD39DFC57C0DF6B48168FAA3C40A028D228DDFC57C08FA44B162FA83C40633E7CD3F3FC57C0A0469F6BECA33C40A8B67CD31DFD57C07F0EF5C0E9A23C40362D7CD32DFD57C030EF9D6BF4A13C402E9FD128EDFC57C0AF469F6B6CA03C40C0607CD39FFC57C0D827A16B14A03C401D837CD32BFC57C0B0A44B162FA03C40DC0A7CD3C1FB57C0DFE8F2C0A9A03C405222277E92FB57C09059A06B4CA13C40081C7CD3C7F257C0006C48160FB33C404106D22851F057C04F9EA06B64B63C40061C7CD307EE57C0D7E8F2C029B73C40623E7CD393F557C0401B4B167FA53C40D07CD128C1F957C0606CA16B2C9E3C40643E7CD3530058C0D014A06BB4983C40AAB67CD33D0458C06021F6C0C98D3C400867277EEA0758C0C8469F6B6C893C401D837CD30B0C58C0B8469F6B6C803C40DC0A7CD3010E58C0A8914A164F7D3C40613E7CD3730C58C000E3A06BFC833C401A837CD34B0A58C0C0FBF3C089893C409ADD267E1A0158C0686CA16B2C9A3C40B044277EBEFF57C0B8A44B162F9B3C40F84AD22809FF57C020EF9D6BF49C3C403EBB267ECEFE57C09F469F6BECA03C407AA57CD337FF57C0D027A16B14A53C401A837CD36B0058C0BF469F6B6CA73C404606D228B10158C0C0E8F2C0A9A63C40E5E3D128250458C048084A169FA13C409F28D228FD0458C0AF469F6B6CA03C401E837CD34B0658C0076C48168F9F3C404F22277E120A58C06021F6C049993C40A228D2281D0D58C0A0A44B162F963C40AE44277E7E0E58C0A7914A164F963C40944F7CD3390E58C057BD9E6B3C9A3C409ADD267E1A0D58C0B8914A164F9C3C401C837CD32B0A58C0EFAAF6C0799D3C40FD4AD228290958C0AF469F6B6CA03C40C4AB277EC20858C0AF469F6B6CA03C40C4AB277EC20858C0B0A44B162FA23C40964F7CD3D90958C028D09F6B9CA23C40E8E3D128C50A58C0C07E4916EFA13C40ACF97BD39B0B58C0C07E4916EFA03C40904F7CD3790C58C0AF469F6B6CA03C4004D97CD3C90D58C050084A161FA13C40AAF97BD31B0E58C0B8FBF3C009A33C4004D97CD3C90D58C06FAA9D6BDCA53C40362D7CD34D0C58C0C1914A164FAE3C40FE4AD228090C58C050AA9D6BDCB03C40A8F97BD37B0C58C08721F6C0C9B13C4004D97CD3C90D58C0A00EF5C0E9B13C40EC717CD3C50E58C077AA9D6B5CB13C40F6FF267EA60F58C0808B9F6B04B03C404606D228111158C0F0019F6BD4AC3C400C67277EAA1058C09F914A164FB03C40BFAB277E021258C0808B9F6B04AE3C4078A57CD3B71358C0676CA16BACA63C4004D97CD3091558C0A0659D6BC4A33C40D07CD128211658C0A0789E6BA4A23C40D5C77CD3631658C0786CA16B2CA33C4004D97CD3691658C0579EA06BE4A43C40FA4AD228C91658C0BF469F6B6CA73C40FAFF267EA61858C0A90EF5C0E9AD3C4088C1D128F91858C09F914A164FB03C405622277E521858C0B8659D6B44B33C400C67277E2A1858C05F8B9F6B04B73C40051C7CD3871858C03F9EA06BE4BA3C405022277E721958C0C8914A164FBE3C406489277ED61958C050084A161FBD3C4030EA7CD36F1A58C078AA9D6BDCBB3C40362D7CD3AD1A58C0C0914A16CFBA3C4078A57CD3D71B58C01FEF9D6B74C13C404A947CD3111C58C0C0339E6B8CC33C4074A57CD3771C58C0C0339E6B8CC33C4006D97CD3691C58C0A0914A16CFBF3C4040BB267E0E1C58C0EF019F6B54BB3C40715AD128951B58C0AF469F6B6CB73C40071C7CD3271B58C0900EF5C069B53C404E947CD3B11A58C0E07E4916EFB53C40D27CD128211A58C0C8FBF3C089B73C40F8FF267EA61958C07721F6C049B83C405022277E721958C07821F6C049B63C40B244277E9E1958C068AA9D6BDCB33C40D6C77CD3031A58C0172E4C165FB23C4040BB267E6E1A58C077AA9D6B5CB13C40362D7CD3AD1A58C09F914A164FB03C40EF717CD3A51A58C018029F6B54AE3C4000D97CD3691A58C000E3A06B7CAC3C40C6AB277E421A58C0D827A16B94AA3C409EDD267E7A1A58C0202E4C165FA83C40289FD128AD1A58C06021F6C0C9A43C404C947CD3D11958C0E014A06BB4A23C40FC4AD228A91758C0AF469F6B6CA03C40B044277E5E1B58C0B8469F6B6C983C40964F7CD3991D58C0A059A06B4C953C404406D228911F58C0E014A06B34943C405EFB7CD3951E58C030EF9D6B74973C40342D7CD36D1D58C0679EA06BE4973C4074A57CD3771C58C0BF469F6BEC983C404A947CD3111C58C05F9EA06BE49D3C40A6B67CD39D1C58C01F85F4C0B9A23C40E6E3D128051F58C0FF019F6BD49C3C404406D228911F58C0F7AAF6C0F9A23C40735AD128D51F58C0F06B48160FA53C409EDD267E7A2058C02085F4C0B9A43C40D4C77CD3432158C030EF9D6BF4A33C405422277EF22158C02085F4C0B9A43C405222277E522258C0609EA06B64A53C404406D228312358C050F548163FA53C40C2607CD37F2358C07F6CA16BACA53C4040BB267ECE2358C0281B4B167FA73C40ADF97BD3DB2358C0A8789E6B24A93C406689277ED62358C0B8914A16CFAA3C402CEA7CD3EF2358C0F0019F6BD4AC3C4062FB7CD3352458C079AA9D6B5CB03C40362D7CD34D2458C09F914A164FB23C40A8B67CD37D2458C01F2E4C16DFB33C40F6FF267E062558C07821F6C049B63C4005D97CD3C92558C0900EF5C069B83C40E8E3D128A52658C0B0659D6B44B93C40E4E3D128852758C04172F3C0D9B83C4078A57CD3572858C0D7E8F2C029B73C40A7F97BD39B2858C0C8FBF3C089B83C40061C7CD3E72858C0509EA06B64B93C40061C7CD3A72958C0C0914A16CFBA3C406889277E962958C0D77E49166FB43C405022277E522958C0689EA06BE4AF3C400A1C7CD3C72858C0D07E4916EFAB3C406689277EF62658C0C8659D6B44A33C406889277EB62658C0C8469F6B6CA13C403CBB267E8E2658C04072F3C0D99E3C4084C1D128992658C0F814A06B349C3C404E947CD3F12658C0006C48160F963C40663E7CD3F32658C0E014A06B34943C40D2C77CD3632658C0201B4B167F913C40D90A7CD3E12558C010029F6BD4913C40B044277E3E2558C0E014A06B34943C40A8B67CD37D2458C0A059A06B4C933C40C0607CD39F2258C08059A06BCC8E3C403A2D7CD34D2158C00098F5C0998C3C40C0607CD3DF2058C09059A06B4C8B3C401A837CD36B2058C0E87E49166F893C40745AD128152058C010EF9D6B74873C404406D228911F58C01085F4C0B9823C4004D97CD3E92258C050AA9D6BDC7C3C40C2607CD37F2358C0BF7E49166F7C3C401A837CD30B2358C0A0789E6B24783C40E9E3D128052258C0A8A44B162F783C40F84AD228E92058C060AA9D6B5C7A3C4087C1D128392058C0BF7E49166F7C3C40362D7CD34D1E58C05872F3C0597E3C40DE0A7CD3E11B58C02085F4C0397B3C40FC4AD228091A58C0DF7E49166F753C4074A57CD3D71958C0EF019F6B546F3C40623E7CD3731E58C01098F5C099663C4030EA7CD3AF1F58C0371B4B167F653C40A8B67CD3DD2158C0EF14A06BB4603C409E28D228DD2258C038D09F6B9C5F3C406889277ED62958C08021F6C0C9513C407AA57CD3F72A58C038EF9D6BF4543C40D6C77CD3032C58C0C0914A16CF533C403F06D228B12C58C017E3A06BFC553C401B837CD30B2D58C0F06B48160F5A3C40382D7CD32D2D58C030EF9D6B74633C40D2C77CD3632D58C078AA9D6B5C663C40ACF97BD3FB2D58C0A759A06BCC673C40C6AB277E222F58C0686CA16B2C683C4084C1D128792F58C020D09F6B1C693C406889277E962F58C07721F6C0496B3C40D6C77CD3A32F58C0A8A44B16AF6D3C40F0717CD3C52F58C0EF019F6B546F3C40705AD128153058C09059A06B4C703C40F84AD228C93058C05FF54816BF713C405EFB7CD3153158C0806CA16BAC723C4078A57CD3373258C0F8E2A06BFC783C40EE717CD3C53258C0B0914A16CF7A3C403CBB267E4E3358C0D8E8F2C0A9793C4089C1D128D93358C0B0659D6BC4773C402C9FD1280D3458C050F548163F753C40D80A7CD3E13358C0806CA16BAC733C403CBB267E4E3358C0C027A16B94743C40DE0A7CD3C13158C0F8AAF6C0F96F3C40D0C77CD3433158C038D09F6B1C6D3C405EFB7CD3153158C080789E6B24693C40ACF97BD39B3158C0708B9F6B84663C403CBB267ECE3258C0301B4B167F683C40D07CD128213458C038EF9D6BF46B3C40D4C77CD3033558C068F54816BF6D3C401A837CD30B3658C0509EA06B646A3C4040BB267ECE3458C0C0914A164F633C400A67277EEA3258C0BF659D6B445B3C40B044277EFE3158C038EF9D6BF4543C40F2717CD3653258C018EF9D6B74503C40D6C77CD3033358C0808B9F6B044C3C40061C7CD3473358C038EF9D6B74473C404B947CD3113258C05872F3C0D93D3C406889277EB63258C0C8FBF3C0893A3C40D4C77CD3033558C0301B4B167F353C406889277E163658C0F8AAF6C079313C405EFB7CD3553858C0FF6B48168F263C406489277E563958C0D8339E6B0C243C40061C7CD3673B58C038D09F6B1C223C40AAF97BD37B3C58C0102E4C165F203C40A9B67CD3BD3B58C0F814A06BB4293C401D837CD32B3B58C0102E4C16DF2D3C40C3AB277E423A58C0F0E2A06BFC313C403EBB267E2E3B58C0C8914A16CF363C4032EA7CD3CF3A58C0B0469F6B6C3B3C4000D97CD3293A58C0A0A44B16AF3F3C40C3AB277E423A58C008E3A06B7C433C40CC7CD128013B58C0A00EF5C069433C40D6C77CD3E33B58C0006C48168F3F3C40EB717CD3653D58C058BD9E6B3C373C402A9FD1288D3C58C06F8B9F6B84343C40CD7CD128613C58C0F0E2A06BFC303C4079A57CD3B73C58C01898F5C0992C3C40EB717CD3653D58C050AA9D6B5C273C40EE717CD3453E58C07821F6C049223C40BE607CD3FF3E58C0D7E8F2C029213C400A67277E4A4158C060AA9D6BDC233C400967277E0A4158C0C8469F6B6C243C40623E7CD3D34058C02FD09F6B1C253C40C0607CD39F4058C0F86B48160F263C400867277E6A4058C050AA9D6B5C273C4062FB7CD3D54058C010E3A06BFC293C40934F7CD3794058C09059A06BCC313C40E8E3D128E54058C0301B4B167F353C400A67277E4A4158C0301B4B167F353C404006D228514258C0C7FBF3C009303C404306D228914458C0AFFBF3C0092B3C403A2D7CD30D4758C0F0019F6B54273C402A9FD128CD4858C0A0659D6BC4253C40BE607CD35F4858C0609EA06B64283C40AE44277EDE4858C0609EA06B642A3C40E8E3D128C54958C008029F6B542B3C401E837CD38B4A58C05072F3C0D92A3C406689277E164B58C0F814A06BB4283C4084C1D128594B58C0409EA06BE4253C405EFB7CD3154B58C0B0469F6B6C233C404D947CD3114A58C0AF659D6B44223C405EFB7CD3B54C58C07021F6C0C9183C401E837CD3EB4D58C0A7789E6B24133C40A8B67CD35D4D58C080789E6BA4103C405022277EF24B58C0301B4B16FF0F3C40061C7CD3C74A58C030BD9E6B3C0E3C40BE607CD3DF4958C0C8469F6B6C0B3C40AAF97BD33B4958C048BD9E6BBC073C40AAB67CD33D4958C0E76B48160F053C40D1C77CD3834958C02FD09F6B9C023C400867277E8A4958C07F0EF5C069013C402A9FD128CD4858C010E3A06B7C023C402FEA7CD34F4858C05F21F6C049043C40D07CD128E14758C070F548163F073C404206D228914758C0A0A44B16AF0A3C405422277E724758C0A0469F6BEC0D3C400C67277ECA4658C0E8E8F2C029123C402C9FD128AD4358C050BD9E6BBC163C40D6C77CD3A34258C020D09F6B1C1B3C40BE607CD3DF4258C0B7659D6B441C3C408AC1D128F94258C020D09F6B1C1D3C40061C7CD3E74258C0589EA06B641D3C400C67277EAA4258C04872F3C0D91D3C40643E7CD3334258C010D09F6B9C1E3C400A67277E8A4158C04F084A169F1C3C4088C1D128594158C097A44B16AF193C40E9E3D128C54158C0B8659D6BC40F3C403EBB267EAE4158C0F014A06B340C3C4087C1D128994158C028D09F6B9C0A3C40C4AB277EC24158C04F9EA06B64093C402C9FD1286D4258C0DF7E4916EF063C409EDD267EDA4258C0609EA06BE4043C4004D97CD3E94358C067F548163FFD3B4098DD267E3A4458C0F097F5C019FD3B404406D228514458C0E0AAF6C079FD3B405322277E524458C0DFE8F2C029FE3B40D4C77CD3634458C0F0E2A06BFCFE3B40A6B67CD3BD4658C0072E4C16DFEF3B40061C7CD3C74B58C0606CA16B2CD63B40663E7CD3334D58C070AA9D6B5CD23B40CE7CD128E14E58C080789E6B24D33B40CE7CD128E14E58C0C0339E6B0CD53B404206D228914D58C0C0339E6B0CD53B4002D97CD3494E58C050AA9D6B5CD93B4088C1D128194F58C090789E6B24DD3B40E8E3D128055058C0579EA06BE4DF3B40944F7CD3195158C030084A161FE13B40A128D2289D5258C0BF469F6B6CE03B40745AD128355558C0E87E49166FDC3B40071C7CD3C75658C0D8339E6B0CDC3B405EFB7CD3555658C0C0469F6B6CDD3B402C9FD1282D5658C0609EA06B64DE3B40944F7CD3195658C0C0469F6B6CDF3B40041C7CD3E75558C030084A161FE13B402EEA7CD38F5758C0C8339E6B8CDF3B40FC4AD228295B58C0D0339E6B0CE03B4031EA7CD3EF5C58C0A8FBF3C089DF3B40FE4AD228495D58C0686CA16BACDE3B40613E7CD3735D58C0F0019F6B54DC3B402EEA7CD3CF5D58C0D8339E6B0CDC3B401B837CD34B5E58C0C8469F6B6CDC3B401C837CD3CB5E58C008029F6B54DD3B40FFD87CD3295F58C06021F6C0C9DD3B40BE607CD33F5F58C01F2E4C165FDE3B403A2D7CD34D5F58C0E7AAF6C079DF3B40DC0A7CD3815F58C0E06B48168FE03B4004D97CD3096058C030084A161FE13B400967277E4A6058C010E3A06BFCE03B4087C1D128596158C0A8FBF3C089DF3B4032EA7CD34F6058C03072F3C059D93B4017837CD32B5F58C000029F6BD4D53B404A947CD3B15D58C0BF469F6BECD43B40CD7CD128A15B58C0A0789E6BA4D63B40EAE3D128055B58C0606CA16B2CD53B409CDD267E3A5A58C0D827A16B14D53B40ACF97BD37B5958C070F548163FD63B40DC0A7CD3015958C0E8339E6B8CD83B40382D7CD3AD5858C0301B4B167FD43B4076A57CD3375958C040BD9E6B3CCD3B40DC0A7CD3015958C0E06B48168FCA3B401E837CD3CB5758C050AA9D6B5CC13B4006D97CD3C95658C0489EA06BE4BD3B40944F7CD3195158C09F659D6B44B53B409C28D2289D5058C0CF7E4916EFB13B404C947CD3D15058C0589EA06BE4AD3B404206D228715158C017029F6BD4A93B4048947CD3315258C0900EF5C069A63B40D6C77CD3835258C05072F3C059A43B40964F7CD3B95258C0708B9F6B84A13B40D1C77CD3E35258C03072F3C0D99B3B40C0607CD31F5358C070F54816BF993B40603E7CD3135558C0E814A06BB48C3B401C837CD32B5658C0F7AAF6C079813B40C4AB277E625658C0202E4C165F7C3B406689277E965658C05F21F6C0C9793B40A8B67CD37D5758C030EF9D6BF4753B40DD0A7CD3215A58C0F0E2A06B7C5B3B404206D228515A58C0C0659D6BC4553B400A1C7CD3075B58C0A00EF5C0E9533B40FFD87CD3295F58C0F8019F6BD44D3B4002D97CD3896058C0A759A06B4C483B404C947CD3716158C0A759A06B4C473B40FC4AD228A96258C008029F6B544A3B406889277E566058C070F54816BF4E3B402CEA7CD38F5F58C018029F6B54513B400867277EEA5F58C048084A161F523B40725AD128156058C0C8469F6BEC523B40765AD128356058C0C8914A16CF533B403EBB267E6E6058C0C8914A16CF543B40081C7CD3275F58C0B0FBF3C089543B409E28D2287D5E58C067AA9D6BDC543B40051C7CD3075E58C0C0659D6BC4553B40ED717CD3855D58C0E0AAF6C0F9573B40C0607CD37F5D58C0888B9F6B84583B400D67277ECA5D58C0C0659D6BC4583B40BE607CD33F5E58C0BF339E6B0C5A3B4083C1D128595E58C0B0A44B162F593B403CBB267ECE5E58C04072F3C0D9583B404A947CD3515F58C0C0659D6BC4593B402CEA7CD38F5F58C0A0A44B16AF5C3B4030EA7CD36F5F58C0C0E8F2C0A9613B40FFD87CD3295F58C038EF9D6B74663B40E6E3D128656058C0FFE2A06B7C643B40AE44277EDE6158C0C8659D6B445F3B40FC4AD228A96258C0006C48168F5D3B403CBB267E2E6258C0BF339E6B0C5A3B40BD607CD3DF6258C038D09F6B1C593B40F2717CD3656358C0608B9F6B04583B40091C7CD3676458C0C8914A16CF543B403CBB267ECE6458C00FE3A06B7C583B4018837CD36B6558C0301B4B167F573B4078A57CD3976658C018029F6B54513B40D80A7CD3616658C01098F5C0994F3B404606D228716658C010EF9D6BF44D3B401A837CD3CB6658C03085F4C0B94C3B40ACF97BD37B6758C047BD9E6B3C4C3B4060FB7CD3556858C070AA9D6BDC4C3B40765AD128956858C0E0AAF6C0794E3B40AEF97BD39B6858C0786CA16BAC503B404606D228D16858C0006C48160F533B40342D7CD3ED6D58C0B7469F6B6C6D3B4017837CD38B6F58C058084A161F733B40342D7CD38D7158C0C07E4916EF773B402EEA7CD34F7158C0C0914A16CF713B40DB0A7CD3216F58C07F8B9F6B046A3B40745AD128756E58C0F014A06BB4643B40AE44277E5E6F58C0F014A06BB4643B400A67277E0A6D58C0E87E49166F5C3B40EC717CD3456C58C0C0E8F2C029573B40725AD128956D58C0C8914A16CF543B40944F7CD3796D58C007E3A06BFC523B40DE0A7CD3616D58C0A0659D6B44523B40944F7CD3396D58C018029F6B54513B4086C1D128F96B58C040BD9E6B3C533B40EE717CD3056B58C0A0659D6B44523B409EDD267EBA6A58C0D027A16B944F3B4030EA7CD36F6B58C047BD9E6B3C4C3B40CE06903CD86C58C0A069808E33493B40B87ECFE2616E58C0F0FC3BB2A4493B40C0607CD3FF6F58C010D09F6B1C4C3B40342D7CD38D7158C047BD9E6B3C4C3B402A9FD128AD7058C020EF9D6B74473B4032F0ACD5C56D58C0E01368AD71443B4000419CF46F6B58C037246D2C26463B40D23A542D2B6A58C0A85F24DA2C463B402C3E5C0A196958C0F03DAB254D443B4098DA23184A6858C0486F5A19A23E3B40C8F89080496658C0078FA897323E3B405BA8777CD16358C0374C562E1C3C3B405218A1265A6158C0E84BFEDB703B3B4014222DE9166058C020CF1BF94C3E3B40BEDC2C937E5E58C00F037425A3413B4092662BE32A5C58C0707ED6FFB0453B40E8E3D128455B58C0401B4B167F433B406889277E565B58C01F1B4B16FF3F3B40071C7CD3C75B58C078F548163F3D3B400767277E8A5C58C0B8A44B162F3C3B40041C7CD3675C58C0409EA06B64393B40DC0A7CD3615C58C0D7E8F2C0A9343B40A9F97BD37B5C58C090A44B162F303B40A7B67CD3BD5C58C0D014A06B342E3B405DFB7CD3555D58C060F54816BF2C3B40F2717CD3255D58C09059A06B4C293B4062FB7CD3B55C58C078F548163F253B400767277E8A5C58C0E8AAF6C0F9213B40C0607CD3FF5C58C0A80EF5C0E91E3B402EEA7CD3CF5D58C0B0659D6BC41C3B40342D7CD3CD5E58C0A0FBF3C0891B3B402B9FD128CD5F58C09F789E6B241B3B40C2AB277EE25F58C07821F6C0C9193B40AD44277E3E5F58C01FD09F6B9C163B404C947CD3D15E58C0778B9F6B04133B402CEA7CD38F5F58C0EF019F6B54103B40061C7CD3C75E58C0A00EF5C0E9093B40D6C77CD3C35E58C050084A169F053B40F0717CD3A55F58C040BD9E6B3C033B406989277E366358C04072F3C059023B40FAFF267EE66358C068F548163F013B40E6E3D128056458C0609EA06B64FE3A406689277ED66358C0509EA06B64F33A40904F7CD3796358C050AA9D6BDCEE3A4004D97CD3E96258C0806CA16B2CEB3A403CBB267E2E6258C0A0789E6B24E83A40F8FF267EA65F58C0F0AAF6C0F9E33A40342D7CD3CD5E58C0806CA16BACE03A402CEA7CD38F5F58C048BD9E6BBCDB3A4004D97CD3696258C0C0659D6B44E53A4085C1D128196358C0202E4C165FE63A40FD4AD228896358C0589EA06BE4E33A4075A57CD3D76358C0D027A16B14DF3A40C0607CD3FF6358C020EF9D6BF4D93A4078A57CD3F76358C0301B4B167FD63A40D07CD128816358C03FBD9E6B3CD33A4018837CD3CB6258C018E3A06B7CD23A40ED717CD3E56158C0C07E49166FD23A40C0607CD3DF6058C060F548163FD13A40725AD128156058C0201B4B167FCE3A40392D7CD38D5F58C0B8A44B16AFCA3A40DB0A7CD3415F58C0C8469F6B6CC63A404306D228D15E58C02085F4C039BB3A4006D97CD3495D58C0BF914A16CFAA3A40BE607CD39F5C58C0D87E4916EF993A404B947CD3315B58C0E87E4916EF883A400967277ECA5A58C0688B9F6B84803A40FAFF267E065B58C0A059A06B4C823A405422277E725B58C0A0FBF3C089843A40CD7CD128A15B58C0CF7E4916EF853A40745AD128F55B58C0A0FBF3C089823A4018837CD38B5C58C058BD9E6BBC803A40BE607CD33F5E58C0D77E4916EF7E3A404606D228115C58C038BD9E6B3C7C3A40D4C77CD3235C58C0DFAAF6C0F9793A4079A57CD3775C58C020D09F6B1C763A401B837CD3AB5C58C0E87E4916EF6E3A40663E7CD3D35C58C05F8B9F6B846C3A4003D97CD3A95C58C0DF6B48168F6B3A4087C1D128D95B58C0489EA06B646B3A404406D228B15A58C08021F6C0496A3A409F28D2285D5A58C0E86B48168F673A400967277E4A5A58C090789E6B24643A401E837CD3EB5958C07F0EF5C0E9603A40944F7CD3795958C0F0019F6B54603A406489277E165858C04072F3C0D95F3A404A947CD3B15758C0B8914A164F5F3A401A837CD3AB5758C0F014A06B345D3A40AE44277E3E5858C0006C48160F583A40DA0A7CD3215858C0A0469F6B6C563A4032EA7CD3AF5758C01F85F4C039563A40BF607CD33F5758C0C727A16B14573A400A67277EEA5658C0A0914A164F583A40071C7CD3C75658C0DF14A06B34593A40F0717CD3855658C0B827A16B945A3A400767277E0A5658C0D87E49166F593A40EF717CD3C55558C030EF9D6B74573A40EC717CD3255658C0A0469F6B6C563A40A028D228BD5658C00FEF9D6BF4533A40ACF97BD31B5758C0E76B48168F4E3A40ACF97BD31B5758C0CFE8F2C029493A405EFB7CD3955658C0A8A44B16AF463A40C0607CD3FF5558C0D8E8F2C029473A4002D97CD3895558C0E0AAF6C0F9473A40ADF97BD31B5558C050084A161F483A4088C1D128995458C0A8A44B16AF463A405EFB7CD3355458C0C0914A16CF433A402E9FD1286D5458C008029F6BD4413A4078A57CD3D75458C00098F5C019403A404F22277E125558C028EF9D6BF43D3A4074A57CD3F75458C0F0E2A06BFC3A3A400E67277EAA5458C0F014A06BB4383A40C4AB277EC25358C0E8AAF6C079333A4078A57CD3175458C037D09F6B1C2E3A402D9FD1282D5458C0C07E49166F263A40C0607CD3DF5358C0E06B48168F1F3A406A89277E165358C0C027A16B941C3A40AEF97BD3BB5258C0F06B48160F1C3A40061C7CD3475258C0B8469F6BEC1A3A40382D7CD3AD5158C0A0659D6BC4193A40DA0A7CD3E15058C050F548163F193A40DC0A7CD3214F58C030D09F6B1C193A40623E7CD3534E58C0E0339E6B8C183A404206D228914D58C03072F3C059173A40FA4AD228C94D58C0C8FBF3C089133A4076A57CD3374E58C0606CA16B2C113A40DC0A7CD3E14E58C0B027A16B94103A40FFD87CD3C94F58C00098F5C019123A40BE607CD3DF4F58C030D09F6B9C0D3A40CC7CD128A15058C037EF9D6B74073A4002D97CD3A95058C018EF9D6BF4033A40ABF97BD35B5058C01F85F4C0B9FF3940CD7CD128215058C0F014A06B34FE3940FFD87CD3C94F58C050084A161FFD3940AE44277E1E4F58C037EF9D6BF4FB39402C9FD128ED4E58C09059A06B4CFC3940705AD128D54E58C0D07E49166FFD39409CDD267E7A4E58C02085F4C0B9FE3940F74AD228E94C58C09059A06B4C013A40633E7CD3534C58C030EF9D6BF4023A40AAF97BD3DB4B58C0F014A06BB4053A40A228D2289D4B58C050BD9E6BBC093A40A6B67CD37D4B58C05072F3C0590E3A4088C1D128394B58C080789E6B24123A401E837CD38B4A58C0A8A44B16AF133A407AA57CD3B74958C0F014A06B34133A4004D97CD3294958C02085F4C0390C3A40DA0A7CD3014958C0900EF5C0E9043A402A9FD128CD4858C0EFAAF6C079F93940AE1013C2E94858C0A04BEB7040F73940AE1DFABE1D4D58C0B081856BECF539403A2A1FFE315058C010BCCAAFA6F63940BC2A64020C5158C0B081856BECF53940806674933A5158C0BF71B99EC1F13940597B04D6685258C0C097C412BCED39404402231BE75358C040A975F70DEC39408B758247055558C080CB91DFECEE3940B4BEEC8A785658C0A8FB6A831DEB39406F12CA28BA5658C0E08CDF5DACE93940B2D6B9978B5658C0C8B5937CFDE439401E920E2D175658C0D8BD77F727DF39406872457D205658C0D8747E312BDA3940BE72F6616C5758C03093A6F009D83940E01ED2A2105858C0C7CDEB34C4D83940EEE22DF2535858C00FFB408A6BDA394093507C0D855858C0B8A15A724CDC3940D2EC4CF7F35858C0809509BA9BDD39402E8EE9ED755958C0B011FEE2A5DD39407F6DCE05915958C0C0DD301675DC3940E41BC7CB975958C0A0B5C2D8E8DA39402869C011DE5958C0B701B901F5D93940060BA20C3A5B58C0D72CD0E9D7DA3940108B97F5E25B58C0578819CB88DE3940F9B73B663E5C58C0205C0FF48AE23940C7B7A746B05C58C04009283F6FE439408F536BFC0A5E58C05045FEE297E439408AE693D81F5F58C0607944C44EE5394072932D32246058C050AEB0C7E1E63940623E231B4C6158C0E08CDF5DACE939407E0FFEDB2B6458C0A8D50B576AF439407CE81B61096658C010FD0E5764F73940649A4FD4B46658C0804E8A08DFFA3940F0F6C74B3C6758C0DF2068E6F8FE39409677495AD96758C090F706BA51023A405266118A0D6958C070189242C2053A40CE2342603B6A58C0B07D755AD9073A406E057CCD7E6B58C0B0BA7120DE083A40CB4559AB157158C0B8A122A2260A3A400CF55C88F07158C0A0D93750100B3A400AD47B8D117258C0F06F3F8A010F3A40E806F721547358C03F18EAD150103A404A008D1E347858C03F18EAD150103A40EFADD53F447C58C09876B7018B0E3A408C609D6FF37F58C04F99C51276103A40CC7F59EBD58058C03F5DEF6E4D103A40E69BD89CD38258C0E841C4127E0C3A4082EC7870308458C04F987A94CC0A3A4070DD7830CF8458C0479558D5EF0B3A40AEC972F6548558C0688E139127123A40005A6B3C998658C0983A06BA2F133A40D8D760659D8958C03F5DEF6E4D103A40124EA10CD88B58C058198908B3103A40DC0CD5FF3F8E58C070FAE7344E133A40D636913B3A9358C0C8909BB6861C3A40D8D615E7D39358C0A7422205001F3A407CEDB57A509558C0C8DADFFA2C273A40C600AF80B69558C040522105EC283A40A47EB9D7689758C0874A0A5700293A40F36DDB39259858C040062BDCDF293A40F36DDB39259858C030269042742C3A409FCC3E43A39758C01F34529BAA313A40D6D8B29D6B9958C0605878F77D333A40046B0833729B58C0FFAB3116BD373A404E453E03389D58C040CC0F91D7393A408A4319843B9E58C09040C8AF28353A40CA94457D8C9F58C0FFFFDC5D083B3A4057A02DB260A158C000A934B3AD3D3A409DC8E8ED60A358C09F0A49FE913F3A4082638C5E39A558C040A6B06424433A40843420FEFEA858C07022F945E73D3A408641679FD5A958C0405E56D5893E3A40BAD3D1628AAA58C040CAB1642A403A40567C5DC8DBAB58C0189617CBBA443A40008E78705FAC58C05718924242453A4009BE447DF1AC58C070144A6189453A40E0AF648212AD58C0F846FFE2D1463A40F0E097F540AC58C000E47E944C4A3A40486153F1E3AC58C0A0463216934C3A40EADF308FA4AD58C000C11CCBA84D3A403A3EB9577AAE58C0006BD186EC4D3A40CA9597B55AAF58C030B41E05A24D3A408A86188419AF58C0508ACBAFEE513A4074384CF7C4AF58C03026AC2A07553A40A657F344F9B158C0102AA053075A3A403AE6DB39EFB258C0FF8358D5495E3A40D8A201F948B358C0E8AD5772445F3A407C948DDEDBB358C090F144C4585F3A4032AD18044FB458C010BB4761575E3A4072295A2BCDB458C05884D1E9CF5D3A402200235B82B558C0E8AD5772445F3A40AB7D7CCDE8B558C03048FB45A75D3A4057FF4F1474B658C0D0096E20345D3A404AF04FD412B758C04008DDC0C55D3A4063CE4E94B1B758C0E8AD5772445F3A407D49F76127B958C020C4765A2B5E3A400BF6B57A83BB58C0F03227DC69643A409BF4560E81BC58C0D0E2C375D7603A409A05E69010BD58C09FB6B99ED9643A40DF67B63A9FBD58C0676A4A6147663A40BFAF08332ABF58C077EB25A26C663A4076102D7242C058C050F5BFD8D2643A40CA5B8247ACC058C0207D139181643A40023101390DC158C0DF7C9A7CFB643A40A9ECD4BF78C158C080DF4DFE41673A409B7164C2C8C158C0E0D48DA5FF673A4095AAFD9B0CC358C04FD25D0F2F683A40E63B481A3FC458C0681FF36E9D673A40B9F8ECCA78C558C040C92E165B683A40A54953B1CFC658C02FAB3A504C6C3A4099982A55F8C658C0008252382B6F3A405B53F3C48FC658C0F05909576C723A4006EB04D6FFC558C0BF3EBE3BB4753A40A097ED4AB8C558C048DDCE4C9D783A400ED48901DBC558C060317A94E87B3A4059C3AB6397C658C0D0E43D8A17833A40B341C3EE5DC758C0607BBED88E863A40ED6E184405C958C0A0B142270A883A406440CE458DCA58C07090EAD15A8A3A401ECA6342F6CA58C050D1DAC05F903A40B1CCD6A2FACA58C02F58223DDA903A405121770944C958C040A48C416A903A409947C5AE4DC958C0505395E4A99A3A40341AF3BB82C958C0AF7A8DA1BB9E3A40951BD04C24CA58C007396AC4E39A3A400C24312B87CA58C0B0E33922D49D3A403137D8FD8BCA58C080274215EBA03A40951BD04C24CA58C0E89427DB52A73A4098847CCD3CC958C0E7CD47475DA53A40410931FFBCC858C0B8E3A83BA5A63A408CF2C785D7C858C0688E789995A93A4084891B05BFC958C0103948F785AC3A407854F0B82EC858C040186E9502AF3A4051C7DAA84BC858C06076A1A8DFB13A40951BD04C24CA58C0B86294E3A7B83A4052E4BFEA54C958C008AD4B187CB93A40C13D873F49C858C0B8EE6EF553BD3A40C9894E7E58C658C0A004D0E99BBE3A40035B9FFAEBC558C05081F848BDBF3A40BFBAE21704C658C080C9CA6752C13A408A326C3FA3C658C07FF7716621C33A40E7502E124EC858C010DB61301CC43A407F038A429DC958C0C0CBAF7D91C03A4082206F84A6CA58C098903BE276BA3A4077F479227DCB58C0200B101288B33A40191082D3E4CB58C0200B101288B33A40D0E9332EDBCB58C0F894050EF5B83A408549774BF3CB58C020A2D2AA40BD3A4006D869EC77CC58C0D04CA20831C03A4055A12E96ACCD58C04FAF9F478CC13A406B5FD83F3BCD58C057EA13E3A6C73A406416FE9B08CD58C0E02952AA3FCC3A401EFCD27B42CD58C0C01CF426C5D03A40A95931831BCE58C0F8D85A4D7FD63A40FEC859CC57CE58C02044ECE3D6D43A40BCEBE5CA80CE58C058AF7D7A2ED33A4085A026110FCF58C0D706024C4ED83A406999A2C34DCF58C0305CA1072FDE3A4085A026110FCF58C070530DB032E13A40A95931831BCE58C01F445BFDA7DD3A40073E29D2B3CD58C02067898E3BE33A40752E44A68FCD58C068A4E23F95E83A40B0FF942223CD58C0F0E320072EED3A40191082D3E4CB58C0608C0B4FDFF03A401A7641B920CD58C0DF57B50E53F13A40436916AF3FCE58C0609784BC1AED3A401DF9E5E065CF58C0880D8FC0ADE73A4071483C4DBCD058C030162318AAE43A409BFE5924ECD158C0A0C986CD96E43A40AA16A02E73D258C0A778205705E63A40F0D3415364D358C0A8C9F5E667ED3A4003AFD03EFCD358C0CFA81B85E4EF3A402010F1ECB5D458C0B03D8AEE8CF13A403671119B6FD558C0C055D0F813F23A40B9C24C1D05D658C0608C0B4FDFF03A40C55401656AD658C0608C0B4FDFF03A4050B25F6C43D758C020E674363EF53A409E2188B57FD758C028C3B5BE7BF83A405275A84D54D758C01842324DAD013B408BA0952AE0D758C010881F5603043B400DCF1135B3DB58C08F5EB19C83093B40324878EDF3DC58C080D245A4A80D3B4005B6316E8BDD58C0987068FE8C0E3B40EAF407F38CDD58C04059A78D940E3B4003C28C5E4ADC58C0583A39EDF0163B40045478301FDC58C0606CFC452D193B400033973540DC58C0780C9EB6841B3B40A8D7EFE786DC58C0503DC2D85E1D3B40E05627B8CFDC58C0C02143C4D61E3B4035C501F9F4DC58C0D0DF1ACB00203B40E6756442D2DC58C0F81FE59729253B40575734ECE3DB58C020E7BC3B3C303B405FD152B1A5DB58C040ECC8AF24353B40991AD222C7DB58C01074C8AF1A3A3B40491420BE37DC58C0E03F2E16AB3E3B404B230BD0EADC58C0D010F4A8DC423B4088B27FEAD4DD58C070EC0080CA463B402701917B03DE58C080248F423A473B40DE2EF304BFDE58C0705D432786483B408B2C8981E8DE58C0101964AC65493B4071058A4108DF58C020784861794B3B4076932D3224DF58C020AC8E42304C3B40CFFDBF9190DF58C058A59DB6204D3B40FE5AAF005EE158C010040957AE4F3B40589FDB79F2E058C0902F543861523B406CBB3789D8DF58C0A83CF06EBB563B40776DB21D9EDF58C0A06584CE23593B40BDBF457D8BDF58C068BBC075DD5B3B4011549BD236DF58C02FD764E6325F3B403263CD0504DF58C0472545C44A643B402F3301F971DE58C038EB58D52D6A3B4023A6AF4044DE58C0980446C4386D3B409892221B50DE58C01F9DB0C7BB763B4023A6AF4044DE58C06009856BE2773B407E3275D37DDE58C060E2DAC0857B3B40DE2EF304BFDE58C02709B89EA37D3B405B34D22240DF58C0C084BA9EA17E3B40EF1954713CE058C098047E94DE7E3B40026C53B19BE058C0876A53D501803B406B398901A5E058C0F0DAA353B1823B40A7DE3BE673E058C0B7F136508F883B406F93180476E058C01066519BE2923B401C6DD7DCF5E058C0387B7D94AE963B404A482DF23DE258C08F844AFED59A3B4041B9229B85E358C030B00EF40E9D3B406F0727F89FE458C00728C912549E3B40628B64C201E558C01818A98D709F3B406499FD9BC6E558C0288131165EA43B405FC2592B69E658C0A7CE8E427CA53B40B95FAE4032E758C0609A4861C5A43B4091E252B18BE858C0285D84CE10A23B40D6B2378945E958C0687015CBFAA13B408ACEB85783E958C030E4001D0DA33B402FBFF20428EA58C047FE9A196EA73B40FF6E50148BEA58C0782F3850CEA83B4085FD23DBD2EC58C0E0AC44C4C0A83B403E880B102AED58C0489E3C8AC5A93B400BBB5AAD7BED58C060DC2EBC8CAB3B402F8BEC8A46EE58C0107F7F31F8AF3B401D97AF00C3EE58C0503059721BB13B40CF5B9775FAEE58C00F6F3550B8B33B4024CA71B61FEF58C0309039EDAEB63B4062F82D7263EF58C0189D866BDFB83B407749DB79D4EF58C0D86F07BADBB93B40A126D5FFF8F058C0F069B5642EBB3B40AAC659AB92F158C060527E315FBC3B40E476AFC05BF258C0806F3AED9CBF3B408011A24CE8F258C06090C5750DC33B40A6223447A5F358C03F0A77FA7BC53B40D81EAF00B9F358C0C0690DF4BCC53B40174D568E4EF558C0D059ED6ED9C63B40B10E16674FF558C0809189083DC83B40123CB2DD10F658C018D91BCB27CB3B40A15B346CEDF658C048DA09BAB3CD3B409B18203E41F758C04891BC3BFECD3B403211EAAD57F758C0A0F73E8A77D03B404F5878B028F758C0F8F9A15309D63B409B18203E41F758C090FCA78D7DD83B4046BA8247BDF758C0EF46E3FABEDA3B40DAFC894155F858C0103CAA8DF6DB3B4082D6481AD5F858C058A4365064DD3B40C23DB3DD0AF958C0C8C6523843E03B40CF4B61E57DF858C048D94E9B3EE43B40E2AC60653EF858C0581E2ADCDEE63B4076BDF7E167F858C09FF479F70DE83B4086E7D79C64F958C0F021CF4CB5E93B401CCBB57A84FA58C080545A72A1ED3B40F339D5BF83FB58C0B85DAEC742F23B40E343F4C423FC58C0885A62AC09F63B4005B24F1469FB58C0E8A7957CCBF93B404A81E2B334FC58C05016A88DB6FB3B40D6B245FD8EFD58C02F458E42CCFC3B402A9F71B680FE58C0CFBC486111FE3B40626642A06EFF58C058985538FF013C40591FE690090059C0F8AE129139053C401019342C7A0059C07FE92D7997083C40FE448664E70059C06035D0E9EA0C3C40FAB5903BDD0059C0006924A2950E3C4056484220AC0059C0D06FEBD148103C405DF7C60BA70059C0D0DF8E42A2113C40A5228D1E200159C0106209BA29123C408E0927B8040259C0D8853DEDF0143C40322FC78BE20259C07F61C3D864183C4043DB55CE120359C0EF46E3FA3E1A3C40850C0833210359C02F1C6A83AF1D3C409305CAA89D0359C000A1C0D84E233C40B26B9B12CB0459C07033803187273C405BD4485A100B59C020741C68D3323C400B873AE61B0C59C0D7F366498A333C409B02F0E7A50C59C06099E1FA08353C4097507553E00C59C040317A9468383C402EA0D81CFD0C59C0A0EB5872033C3C40DF0D27382E0D59C04F37AC2A2D3E3C40900775D39E0D59C050D89D19BD3E3C4061D5A806680F59C06863E934EC3F3C406BA64BF7811059C0A029A0B6B1423C407DEE310F9B1159C05F50CC4CF9463C40D7C6D89C321259C0E016D286E84B3C40432A42A0C91159C04F06967C9C503C4046B937C9D31159C0EFFDE934C2543C4047DDF93ECF1259C0FF35243F795A3C40BA1A20FEA51459C0EF2084CE0B633C405425CB283A1559C0C794F10B096C3C404A72FE5B861559C0D04E031D65753C4055FEFDDBC51559C0C7C38DA5D9763C40F52838C94A1659C0FF30018062783C405122C051C11659C06FB6735A6A7A3C403E53ACA3D51659C070C0172E447D3C4092E701F9801659C0B06D3079287F3C40BA1A20FEA51459C04F80A5F0A9823C409A4C342C4C1759C010336D2059863C402F9E2638971859C040B5BD3B84893C40D4C3C60B751959C0307E7AF7BD8E3C406965F721851959C0F0D89DB692913C401886120A6A1959C0604F65E6BC973C401C82CA28B11959C0189770BD2D9A3C40641BA569551A59C000A31E05FC9B3C40AAF9221BD41B59C028D1997C7F9E3C403234685F8E1C59C050D5301662A03C40AB41BC34791C59C0587D38EDCEA43C4018AAE2F3CE1E59C030555638A1AF3C400C4153B19C1F59C0488D904258B53C40F16E342C382159C09F3BA5F011CE3C408E9B128A992159C00FD916CB98D03C40DFE80BD0DF2159C0DFCCC512E8D13C408C54B67A342259C05F6F1E058AD43C408B31310F792259C037FE38EDEBD53C40912B45BDE32259C0F8FE5E0FC8D63C40C3F215A7D12359C0195BC475E1D63C4063AEE92D3D2459C06830755AAED73C402B79EFE7752459C0B042220580D93C400BB119C40D2459C0B03A68E6B1DC3C4063AEE92D3D2459C018E06983AADE3C40BB19CEC5972459C0D89B8A088ADF3C406B5D59EB892559C0C7E756D539E13C40F6DDA806BB2559C05F9561492AE23C40FBD80EED132659C090EB4AFE39E63C4087A2495AD82659C0090980CEFDE83C40DFE804169B2759C01FBB7F31FDEA3C409C9229D5F42759C090893F8ABAEC3C409A02E273FC2759C0E80261AC11F03C403F7182C71B2859C02040253FC6F23C40CBF07FAA5E2859C0A8CA7E31E9F43C40DB798981D32859C090BAE5977FF63C40DA309E2F402859C087C45F0FFDFB3C40E6BC9DAF7F2859C00847FFE251013D406E605D08BE2959C0CF784427790B3D40C2A90E6D4B2A59C0B029D386481A3D405BD4485AD02A59C03FC053D5BF1D3D40FBFD300F672B59C0084585CE911E3D404305207E362C59C0E8BB19CBFA1E3D40DF0D2738EE2C59C060286783A71F3D40DA7997F53C2D59C0F0043DED53213D403177675F6C2D59C0B7EAD523B4223D409AE3C0D1CC3059C0D1217B947C2C3D4083EF8347493159C0F05A7E31F22F3D405622C70BC63059C027017C946A353D4029A56B7C1F3259C098209B193A3E3D4082EAD4FFF33259C0D15556D5F6413D40BAAC0BD03A3459C040D5765A51453D40347BB6FA493759C088D153D5654A3D4033C5F384CB3759C02F0ED786E44B3D40DA55B2DD093959C02066A0538C513D4006666E198B3A59C07F74DBC048563D400CD33E83313F59C07F42CE4CC75D3D40B78ACA28E43F59C0212C36505A5F3D40BF81E82D844059C0002223056E613D40F86DE2F3094159C04F632F79DB633D40959AC0516B4159C09024FFE285663D404FB64120A94159C06F5CEA34136A3D409674453DE54159C0F890896B67713D40C8603F036B4259C090B69DB6C6753D4045C183677F4259C0793AF333E0753D403565EFCD5F4259C0B79F495849773D4044605096DD4159C0D7FD7C6B267A3D40AF338628B04059C0D7C45CFF1B7C3D403AF15AC63A3E59C0294834A0FA7A3D409006E7AE7E3D59C028DF871FE27B3D408A6370AA533C59C0986444D6FF793D407888E1BEBB3B59C0C9436A747C7C3D4066AD52D3233B59C0870680DCF37F3D4019A7D60A003A59C018EA6FA6EE803D40C6549303CD3A59C0F0E78A90AF813D4033E824DCD33B59C098B5196662813D409CF524F2B83C59C0D04E52FB88813D4084743267193D59C010AF6A24A5833D409006E7AE7E3D59C06790E4F1318E3D401F903A18813D59C0BF7CD72CFA943D40451D5028643D59C0C75918B537983D4084743267193D59C07804E812289B3D40DA4C07316E3C59C027AFB770189E3D409AD83FB0AF3B59C0417697040EA03D4063EA09F2123B59C07FD6AF2D2AA23D400E7BE1A8D63A59C04099C595A1A53D40178417933D3D59C03830AAFBB79D3D401FEAD678793E59C07027A78AEA973D408DE614D2983E59C09034050E65933D40F713E7C4633E59C0EFA17BBAFB903D40EE8D5502423E59C0987A83FDE98C3D40CA7AAE2F3D3E59C000BA52ABB1883D40D40040F25E3E59C0D0DA2C0D35863D40A23B12FB0E3F59C0DFC4CB18ED843D40FEFF376DC13F59C04F0F834DC1853D40BEE50C4DFB3F59C05855705617883D4011FB98353F3F59C0F87E4D29688B3D404B633D31BA3F59C017462DBD5D8D3D407CCBE12C354059C0774AF7E8DB8B3D4014BBF47B734159C0774AF7E8DB8B3D4075BCD10C154259C01781323FA78A3D4057F204DE424259C037538B40D8883D40895AA9D9BD4259C050EC54BC2D803D409A3538C5554359C0B859CB68C47D3D403CABDCD6B54459C0A841855E3D7D3D4023CD6050414659C0A0D8D8DD247E3D40B736E2DC5D4759C050EC54BC2D803D40A23B8114E04759C0609BEE459C813D40C7A8C447DD4859C03FC995446B833D401B61C7344C4959C0A0925AEE9F843D40CF0E842D194A59C0C708D40B04883D404B60BFAFAE4A59C0F87E4D29688B3D40E56FA4DBD24A59C0191886BE8E8B3D4043AE388B634B59C0D84348A71E8E3D4098663B78D24B59C0183BB44F22913D40905A18F38E4B59C0005115446A923D40590F59391D4C59C0F038CF39E3913D401D7BBFDB784C59C0BFF0FC1A4E903D4047D74052B04C59C0B8AA0F12F88D3D40E0E6257ED44C59C0F87E4D29688B3D406B448485AD4D59C0CF71EFA5ED8F3D40E62F0022074D59C0C7E5F2C6E39C3D401EE17EC1B44D59C0A96FE8C250A23D40A34F9F85534F59C0901C9D3680A43D40649B334BC95059C06F55BDA28AA23D40C013927E6C5359C07804E812289B3D4007779742655359C058328F11F79C3D4075B08CBA735359C0508EDD0E95A03D409756274F6F5359C058C1251FA4A13D40C8F367DF5F5359C0B08BC71244A23D40751483C7445359C0605FBD3B46A63D40DB635271D35359C040EFEF6E90A73D40FF329EEF845559C04F0F7F3181A73D40F6016B7C565659C098450380FCA83D4083B57C4DE45659C050EC1C68DDAA3D4075E1CE85515759C03FF03AED39AD3D40D57E239B1A5859C097A508575DB33D40D6B09318895859C0481AF06EEFB73D405170685F935959C090DC34B39FBD3D40BB1875D3045A59C048DC9142BDC03D406A4E671F325A59C057D9BE3B0AC43D400E1A8D1EED5959C0EFAA76F747C73D40184A592B7F5A59C090FE83CE3FC63D40A46CD162265B59C000484A617BC53D40F1CCFD9BD85B59C068C99EB626C53D40E8F407F38C5C59C0CFFD5DAC63C53D4070888A012A5D59C027B41E05A2C63D4078BAFA7E985D59C0F0CFC275F7C93D40BBE46E59235E59C0F8CC19CBA0CA3D40ADC66ED9605F59C00FBD23A219C93D4039C50F6D5E6059C03738A3F01DC63D402D91E650656159C08855B36414C43D4025018AC1BE6259C0CFFD5DAC63C53D40DBB23E438A6259C0A705C41279C73D4072F3B6FAF36159C040F9CFE9E5CB3D40CF8416A7D46159C0E1708A082BCD3D408B30DFD60A6259C040D70C57A4CF3D402494C7CB816259C000BE44C466D13D401A4F0F2DF96259C028B6B401F5D13D40D5FAD75C2F6359C0DF04DBC0D1D03D40302FB25D746359C0C07BC375F3CB3D4012519E6F276459C0183DE79756C93D4069CCBF51236559C0408027DC14C83D4023C92638766859C0C776301691C63D4075A66E99D97259C039BDF945BDCB3D4082668207647359C0E1708A082BCD3D400EE7D122957359C0DF95D686DACF3D40D8AEE133037459C04757D04CE1CF3D40B74086E4BD7459C03F82119120CE3D40F47FBCF4E27659C03F82119120CE3D40D6EA9358297859C0774E1A6893CF3D406FBC907BCB7859C0A994BE3BF2CF3D4017CEAB234F7959C0709BAFC701CF3D406289B997C07959C0406A1291A1CD3D40080B8DDE4B7A59C0CFB4F06EC5CC3D409E4D94D8E37A59C057315EAC55CC3D40960638C97E7B59C078717C3137CC3D40E564C091547C59C0D068FA45B9CD3D408E51B25D407D59C07F87476165D03D4064693849397E59C0AF40385074D13D40C622D43F3A7F59C03F82119120CE3D40AFBF1B21EF8059C0F71513919DCF3D4098951F7EFF8659C057B35F0F57CD3D40BD74A846528959C0DF04DBC0D1D03D405AD4485A108A59C0B7AC93DF14D33D401FBD2A15098D59C0BF3202809CD83D40C3A8B57A588F59C07FE93BED60D93D400F96336C389059C0F1D2A3F0F3DA3D402E7F0596879059C0579DF10B9CDF3D4033F8BCF4AC9159C03FB2F8A89ADE3D40BD88495A7F9259C047D1BED8CCE03D407F444FD4569359C080AED523AFE33D405FB078708B9459C02821A92AD9E43D405A31C091229559C0273AF8A890E33D40480383C7BE9559C0BF62ACC7E1DE3D40D524A9C6779659C090B6B99ED9DD3D40E2517F2A3F9759C07042553841DD3D407EEDC3EEB99759C0BF0E018096DB3D40CBCA0496F89759C060A87E311DD93D401D0183071A9859C0A0EF5A0F4DD23D40C6DE89C1529859C0107278F7B6CF3D4069BC7B4DDD9959C008C85C0FE2C73D40A6ECDB79FD9959C07F9646C4FBC63D40F15D907BFAA059C0A0FE5972E3C83D4042E0EFE779A159C0902679F745C83D40265C6BFCFDA159C0D046AB2A19C53D40774CDF96A8A259C0E1DE977C31C33D40CD4A0139C6A259C0B8C1B16497C23D4074F0AB23FBA259C0F065C51204C23D4014AC7FAA66A359C007AF1291B9C13D40A22A2B55BBA359C09880F4A853C23D40C74B3E4306A459C0A8C5CFE9F3C43D40AEEA3EC345A459C0CFFD5DAC63C53D40F15C4CB775A559C050DD061DC3C33D4034D23A26C2A759C00FCB83CE4DBF3D4017075A2BE1A859C020936E2064BE3D4046CC717644AB59C0784B39ED96BE3D40EB4E97F5BDAB59C020936E2064BE3D4096F0F9FE39AC59C07F03B501A0BC3D40C3C2505464AC59C0F0F81E05BABA3D40E4AEFD1B76AC59C07F5765497AB83D4022DE0B10A8AC59C03FB13D8AA5B53D401398EC0A83AE59C0A0F0DD5D1CAA3D40601D4220CDAE59C0685B755A8DA63D4017A97B8D12AF59C0605FBD3B46A63D405DE5D0221BB059C09F8F3950599F3D40AA554FD41CB059C0702D4E9BC29E3D4058D6D0E2B9B059C0A05DA053799A3D40DF532A5520B159C090D1B501E8983D407B238307E6B159C000488231A1973D4090F6DE968AB159C0088244C461943D4031D53789B1B159C0E888355071933D40D2367C0D4CB259C04F1B496162923D40812231CFF7B159C04F274B61E98E3D40D6C5713656B259C000304661ED8C3D4073B7FD1BE9B259C0402E6649558B3D40EAD2F0A7F2B459C049D5EAD172783D409F94E2735FB559C0173549611B763D409251CE45B3B559C0000CB501B3733D4042DFAB23D5B559C040B43AED34703D40E8519458ADB559C09F152ADC4B6D3D40E7E4D16270B559C0C09590426B6A3D40A6B2CDC573B559C000DA200562673D4051FBF2040DB659C0602311F4F9633D409F4BE2F31DB659C0988F0FF47C623D404A01DF56A2B559C008143750DB5E3D40A001A5699CB559C07F42CE4CC75D3D402EED120A2EB659C07F727D949B5C3D407FFFB9D7A5B659C0D01730796A5C3D40D6DA560E08B759C05F4820A2745C3D408C2DE2735BB759C010740EF4095C3D406E4E7C4D20B859C0DFA5C7AFD2593D40169A973584B859C030DF1E0501583D405FE934ECA6B859C0607BCC4C58553D407127AF00ACB859C0C85419CB96503D40BF4C89C18FB959C02800152EAE463D40B89D04D694B959C017A33AED8E433D4025E9A0CC18B959C05004B1C71F413D40379B308F8CB759C0B7AD4EFE893D3D40EDC8A746F6B659C04FE2B064A93A3D40DB09D1E2ABB759C0E89453388B393D406EA652B166B959C0A8287F9464383D4089E7E5104EBC59C048F93F8AB1303D4082C30E6DA4BC59C0F0EADAC0982E3D4015F41F7E10BE59C0C0658D425E313D40507F4CB741BF59C03FD79CB6582D3D4048CAC64B03C159C030491C6874203D40359DDBB98DC159C078055972BC1D3D40CFFF717616C259C00853E0FA361C3D40C6C83D83A4C459C0604CBC3B66173D409176F7212BC559C00FA859D5CF153D40EF39C74B7AC559C0581B496162133D40AC53A4A9DBC559C0A8A66149D00E3D40E043E6501AC659C08F27C4756F0F3D402F35AC23B3C659C0A8A66149D00E3D4095A70039FDC659C0BF6ECAAFFB053D4076370179DBC759C02F1B3BED18FF3C40B2D560A578C959C0BF7C2ADC2FFC3C403F999A92F9CB59C09070D9237FFD3C40E91C35EC78CF59C0D9C96B83E5003D4002A219844CD359C04FC7B4019B003D40A3DF86643DD459C0D06CB69E93023D403AE269DAEFD359C0F8A748B9AA063D400E622DF2D6D359C090D5C512FB073D40FC0F1984C9D459C0EF8768E6DC063D4040AD3BA626D559C06F6DB26413063D40932B5331EDD559C0A9E3B1C78D0A3D40848D5DC881D659C030EA293F170A3D40D50E6BFC12D759C0109C1F05A3073D40C0BF4C37D0D759C06F6DB26413063D406DCB7B8DBED859C06FA666495F073D40AFF62C7289DA59C0085D4CFE6A0D3D4034FBB9571CDB59C0A8A66149D00E3D402C227276E2DB59C039E68DA5A50F3D40B3526E59A0DE59C0E829273F01153D4016506165E7E159C030491C6874203D4086F9BF1147E259C0B7D3755A97223D40667AD53F72E259C0EF7390DF74243D4065AF3B66ABE259C0F731EFD118263D4068886E1937E359C080D7698397273D40B80ACE85B6E359C05F93031DFD273D40ACE58F7B70E559C080D7698397273D403D51017914EB59C0C0EA8B086F2C3D40B91D1D61F5EC59C02FDC597217303D40E2D3346CF7EF59C0709BCBAF14393D408E54B67A94F059C02717CEAF123A3D407F24D53F54F159C06782031DD73A3D4026374220C6F159C057171D683C3C3D4020966B3C3EF159C01037DF5DEE413D402102DCF98CF159C04FE14EFE7B443D40C363207E27F259C0A781698359463D405FC412CAD3F259C05701B46410473D4070AAAFC04DF759C01F70B89E07483D40E4636E5966FB59C000F53850034B3D40CDCCAFC039015AC0A74DAF2A01523D4001591904AB035AC0FF92D923CB563D4087653E43BF065AC070214C9BBB623D40CA6BC64BF2085AC0F8E5F8A88C663D4092AF9E6F580A5AC05034CBAFB06A3D408FF57EEA720C5AC0DFF7FDE2EC723D40C4B9592B960D5AC060F345C4127C3D405F56F027FF0D5AC018A2EF6E657D3D4045290596890E5AC027DB1C68377E3D404926FABE10105AC0A9ED18CB32823D4090624F5419115AC0A735735ACD863D407200E96DBC125AC0DF2BD92367883D40901F5EC884145AC0B7AAFDE241883D403741B6BAA9155AC080E19DB625863D402FF9077356165AC0FF20A0B69E893D403577675F8C1B5AC09F5DF40B32953D407DA22D72051C5AC037CA41C4DE953D401607689F6A1C5AC0A0844AFED5963D40BEE31C21B51C5AC0C82D1B6801993D401A70E2B3EE1C5AC0B8FF30796B9B3D40B20F6F59221D5AC0DF0710F4069D3D405FC404560A1E5AC0E93F745A1AA03D40C01CD99C10215AC04F0F7F3181A73D40C228CE05F9215AC060ACFEE2FBAA3D401D5DA8063E225AC03FA7ED6E84AD3D402A7CE59040225AC0CF69D52317B03D40ADFD86E45F225AC020492ADCBDB33D404EB95A6BCB225AC070E379F767B73D40F0BB75D3ED235AC068CBFCE2D3BE3D40A494E2737F245AC0377EA4539AC93D404582267859255AC0B0273D8A75CD3D409414C32E7A265AC077D01BCB94D03D40CA80B2DDA8275AC0105C63AC43D53D4075EDAEC0EB275AC0E8FE34B36BD73D40AE0C6B3CCE285AC020BA34B353E33D409F5F7593012A5AC09000FEE27FE83D40EAAC6ED9472A5AC048E85B721EEB3D4089FB7F6A762A5AC080D0243F4FEC3D40D15908334C2B5AC00F359D19D4EF3D40D5FE26F88C2B5AC01FDC2F163BF13D406E86E690AD2B5AC0C8BEA68DBEF33D4049ECEB0A872B5AC060929CB6C0F73D40D5FE26F88C2B5AC037BE60ACF9F93D402F775231BE2C5AC0902231160D083E4023C629D5E62C5AC0EF6109BA290E3E407E58DBB9B52C5AC0671FE0FA44133E4096714120D12B5AC02185A353731C3E40D5FE26F88C2B5AC08FFFB26456223E407E0005566F2B5AC05F185A729C2B3E40D6FDD4BF9E2B5AC058D9866B64313E402C7A48DA882C5AC057E5836B5C353E40F96E495AC62D5AC02F075A72763E3E40A5B76E995F2E5AC0E0723CED90403E403B9B4C777F2F5AC0605D432786423E407EA7D5FFF52F5AC06FD61591B3433E40349C8981BF305AC06811F945C1483E40B7D57C8D8B315AC0B7CDEB34C44F3E4080E7C9287B325AC09F81A153FF553E40EB2DD2E2B1335AC0385BE9D1AE583E4098997C8D06345AC0E0DBD2E9C7593E4047275A6B28345AC0507944C44E5C3E40AE64485A39345AC0401E54383B5F3E4003D3229B5E345AC060821F056A613E4059AEBFD1C0345AC00F3268E61E633E408557A5699A355AC0EF18A053E1643E40ED6F6A7C13365AC000C1D186AA663E402A7BA1CC9B365AC0A86DF8A882693E40CECA0496B8365AC07098967CDF6A3E40B68DDCB9A1365AC09F80E6348A6C3E40820BAF408E365AC0179C119159703E4024CBCAA8B2365AC08739836BE0723E40C683A88653375AC038DE19CB46763E406143C4EE77375AC0A7323E2718793E40B644DC3960375AC070B07E94DA7A3E400C6979F003375AC04787967CB97D3E4061693F03FE365AC030BC02804C7F3E401985C0D13B375AC000B0B1C79B803E404F4AED4A4D385AC0BF0D7E31C7823E40AFD7041675385AC04879E7975B853E40A097E69093385AC0F7BC8031B78A3E4006443BE6BD385AC00022EB34488D3E40474C7C8D7B395AC0F0A96349C4913E403E050B50683B5AC038949DB67A993E40C2632738CC3B5AC00F34C6124C9C3E406D3E38493A3C5AC000B1E05D329D3E40F727ED4A413E5AC067A2D823379E3E405EAEC68BE53E5AC03015253FE79E3E403A9C9EAF4D3F5AC0FFBCDD5D2AA13E40E799342C773F5AC0901F18CBEAA33E408D79DF568C3F5AC020873950C6A63E402CC8F0E7BA3F5AC0A029924268A93E402D7E9E2F8B405AC040F8A0534FAD3E406DD01C61CA415AC058D53E8AABB03E40A401BA972A435AC07175E0FA02B33E403BE4453D5C445AC010310180E2B33E4031568D1E92455AC0D8A02BDCB5B53E409F064DF78C485AC008D3BFD806C23E40B63EDBB9FC485AC0E86AAC2A1FC03E40E47708B3CE495AC04F8E674960C33E408E54BD34194A5AC08839BB3B06C43E40AA1F89014C4A5AC0D7C2263F9DC33E40011EABA3694A5AC001E05B0F61C63E401FCF20FEB44A5AC059D6C1D8FAC73E40DA5764C22F4B5AC07F0A08BAB1C83E40332FB917D94B5AC0F74CDDC0DDC83E4061FAD1E27F4C5AC050470480B6C93E4065D2B25D1D4D5AC0E85D48C46ACD3E400E1D7C0D934D5AC0D90C6B8343CE3E404A2A57CEF74D5AC0C00823A28ACE3E4040526125AC4E5AC080C443276ACF3E40EF4EA569E74E5AC0E07C870823CF3E40F1B871B6594F5AC0C0987F3131CD3E4032E72D729D4F5AC06F63210592CC3E4073F55A6BF04F5AC078DA2E1681CC3E403E2A2D729B505AC06F931F0590CD3E401F18059603515AC01FCBBB9EF3CE3E406EF4F30454515AC01032301679D03E401B5F4C77BA515AC0601FE0FAC4D13E404795596B65555AC0AFD9947C03D83E4010D2F30448575AC030C8E397B1D93E40004A273813585AC0AF6E846B0CDC3E40E49C1C61985A5AC0E782785A07E73E402E3461A5C95F5AC0D01B81CEDDF43E4012AB2D72F8615AC0083F6F20E0FD3E40969ACEC594635AC0901D9EB6AA003F40A591ECCA34645AC0182FFBE243043F404628977508655AC0714AD2865A0D3F40DD2F4CF7D1655AC05F5CDCC049123F4073A515A7C6665AC06081283FF9143F40C237B25DE7675AC03824FA4521173F40AAF9221B34695AC0303887088B1A3F4039095331C16A5AC088BB4CFEBB203F40DD531CE1366B5AC0386E3E8AC7213F40C31883474E6C5AC0C797C4123C233F40C6825D082A715AC080E5D723152E3F40631CFE5BC8715AC0F008934256313F406786CAA83A725AC03849D62305363F407D0E90BB2A775AC06037E4FAD2493F409C3C055654785AC0E78CA78D064D3F40E2206F5968795AC0B88056D5554E3F40E83FACE36A795AC0BFFD70203C4F3F403E4E0BD0297A5AC08F207F3127513F4082682D32657B5AC087040EF492533F408D6241E0CF7B5AC0D72EBA9EE3553F406F176BFC457C5AC0D8BF61AC335A3F40575CDC79B47C5AC07822152E7A5C3F40F6BA2A55847D5AC0384A9142FA5E3F409B803AA64D805AC07FC0DF5D9E653F401B5F4C775A815AC0FF29846BF4663F40058D2DF2F5825AC0CF65E1FA96673F4085D953F12D845AC00817422734693F4031E6BF515C865AC0F0A3A153CB6D3F403CD3AF0008895AC0A846FA456D703F407C92F027848A5AC0E16BBFD8A2723F406EF3A8862A8B5AC050068808D3753F4014A82955648D5AC0001A23A2307A3F408E1F6582C98D5AC0D00E7120E27B3F40A9EB8287EA8D5AC058732E161D7D3F406FB82CB2FF8D5AC0DF6AAC2A9F7E3F40EB5049DA438E5AC0B7C917CB2C813F40FB4767DFE38E5AC01FA524A21A853F40AF34917B95915AC027EB200508903F40B9D271B652925AC080BE9D1984943F40E0310596FC935AC021B3EF6E0BA63F402214CB2834955AC09F0D4661A1AE3F40C1CF8981F1965AC050B3273FB1B73F40DFE964C212995AC0085FD486F4BE3F4064E79EEF739B5AC0C1BA967C2BC23F4049A604D6479E5AC008FF75F74BC13F40D38120FE899F5AC0073C72BD50C23F401763EC5917A05AC0CF4684192FC43F404796A52963A05AC088248EA52FC53F408EE32D8065A35AC0D8BBC977EBCF3F40BDDB94E63DA45AC03F802EDED1D13F407502FB4C3CA45AC03F802EDED1D13F40F994C7191FA55AC0A0BCF9AA56D23F40AF52C819DBA55AC0F04FC577C3D33F40D467FA4C72A65AC0281E984400D63F40BD5A94E6E5A65AC0807F9744F8D83F40E9F993E66BA65AC0A1029944E0DA3F4062502D80FFA75AC05FC5CA77B3E23F40284061B378A85AC09F53C87733E73F40CF11C719A5A85AC0988231DE11ED3F407C32C819FDA85AC0DFAE2FDE81F23F40736161B354AA5AC0F0229444C0FB3F40900DC71961AA5AC0E8C1E4BB0900404065A994E651A95AC0E8C1E4BB09004040F3A0FA4CAAA75AC068927F550B0040401DD260B372995AC09456B1880E00404005332E803B8B5AC0B41AE3BB110040402F6494E6037D5AC030EB7D55130040405995FA4CCC6E5AC0B49DB188160040407B5594E693605AC034DF18EF18004040E4EEC7195D525AC050327E551B0040408EE7C71925445AC07885E3BB1D004040F080FB4CEE355AC0F8C64A22200040406882FA4CB6275AC088797E5523004040D21B2E807F195AC008BBE5BB250040402D4495E6470B5AC0300E4B2228004040DEAD61B310FD59C0BF314B222C004040D7E7C619D9EE59C050554B2230004040F13F95E6A1E059C0E896B28832004040EA79FA4C6AD259C0FCE917EF3400404014AB60B332C459C0183D7D5537004040C507FA4C26C459C0EC3D7D5503124040F62B2D8019C459C098CDB088CE234040DFF093E60DC459C0407B4B2298354040C9442E8001C459C024ED17EF644740407BA1C719F5C359C0D07C4B22305940406C662E80E9C359C018ADB088FA6A4040A4FB2D80DDC359C0EC3CE4BBC57C40405658C719D1C359C0B03DE4BB918E4040C6E4C719C5C359C0783EE4BB5DA04040F879C719B9C359C0245D4B2228B24040299EFA4CACC359C0DB7BB288F2C340406133FA4CA0C359C0A07CB288BED540409AC8F94C94C359C05C0CE6BB89E74040F5E32D8087C359C0307EB28856F9404064702E807BC359C0771FE4BB210B41409E052E806FC359C04CAF17EFEC1C41404962C71963C359C0F83E4B22B82E41403F272E8057C359C0406FB088824041406B4B61B34AC359C078CF7E554F5241401BA8FA4C3EC359C04C5FB2881A644140DC7560B332C359C014D17E55E77541403D9194E625C359C0CCEFE5BBB1874140EEED2D8019C359C014204B227C994140A14AC7190DC359C06C32492248AB4140910F2E8001C359C030C27C5513BD4140FB9B2E80F5C259C0E751B088DECE41402CC061B3E8C259C0A07017EFA8E04140645561B3DCC259C0687117EF74F2414016B2FA4CD0C259C0247217EF4004424040D62D80C3C259C0D8907E550B164240B0622E80B7C259C0A020B288D6274240E9F72D80ABC259C0E8C1E3BBA13942408C3CFB4CA8C259C0742BB188A63D4240CD6594E6B1C259C0C74BB288F23F424070B194E603C059C04B0FB18806404240CCE5C719E9BD59C05C0FB1880640424042A0FA4CF4B759C05C0FB188064042404D8B60B3B2AE59C05C0FB18806404240,-26.1%,-625,"1,768",483,"1,285",Texas,true
50,0106000020E61000000C000000010300000001000000090000002011277E2CFA52C05458248B53464240264EB6732CFA52C0533BF6275346424032ECC7194FFB52C0B039B1885646424066775BB559FC52C0B4B1E46E5A464240309FD1284DFC52C0204FD03572464240A128D228BDFC52C0DCB2CE35E247424006D97CD3A9FB52C0B8C5CF3502494240D4C77CD383FA52C060A3CF35B64942402011277E2CFA52C05458248B534642400103000000010000000E0000007230C9CBD1FD52C0A4668408CF8D4240926725AD98FD52C0E81A25706A8D42400CB9C6B819FD52C0346C9EAEA48D4240CAAE2B2E9AFC52C01CF660316E8D42402E41C1503DFC52C018A4952CBB8C4240629A8FEF3BFC52C0B4E00DFCB78B42401E6FC0B496FC52C0A04477C2EB8A42404B1BCEC27FFD52C0CC73FA77C68A42401C3C5A0254FE52C06867B007E58A424016FE6B2ABFFE52C0F0CDE75DAE8B4240ADDB10DEDCFE52C0180384E6A58C42404A99B355C1FE52C010D1D8992D8D424044825E2258FE52C028B2D104CD8D42407230C9CBD1FD52C0A4668408CF8D42400103000000010000000F0000002C12470F7DF352C018E65722F99E42402EB4F966F8F352C078D8D6ECD49E42406AEB333C1DF452C058E60503489F42405CA382A9B7F352C038782D35839F4240D48214585AF352C0E03ED22454A04240DE7543A145F352C028A4310447A14240EE27E48F31F352C02804B881C4A242408A2815D62BF352C0A82CB69513A44240407CE090F1F252C0309D489DF1A34240D04B7C83E9F252C00028406D44A342407A0140F2E7F252C054BBB5DFE9A14240E8668F15D1F252C038119487F7A042404E6EB278D7F252C020B2D0943EA04240AC83C56C1FF352C0F4FCF794A79F42402C12470F7DF352C018E65722F99E424001030000000100000023000000DA39EAA1E3F652C064E8ACBED6984240986B3C31BBF552C0D831C075AD984240F694D8BFAFF452C0C87FC7182199424062B998AB4EF452C0E8349DA77E9A4240CAAE174AF3F352C0A333672CC39A424096C7D2CEE3F352C06CCA6D269F994240BF96CE4F3DF452C030D6F359D197424016476F620FF552C0381C346D9F96424020FC0AB35FF652C0804AFF53F0944240721F2ED6C3F752C0D4723BA3499242409D5452BFBCF852C004151BEEC18F424074ACA5C290F952C074D55005048F4240A2D317C887FA52C0F8702096608E42406FC0D3366EFB52C0181F48465D8E42403496AAC648FB52C044163782158F4240F64543A595FA52C04077FD7A2C8F4240C831E05F16FA52C0BFD2302BBD8F424006576A6AD7F952C04FAA2F188A904240D636CBE623F952C0EF282C9D0192424080838A983CF952C03F72587FA3944240368C7600B7F952C007F3DBDA7996424034A91D68FFF952C028ADDB54E8984240568D2C66F2F952C034EBA4AF019E42404A0DBD9051F952C0C3F5145261A04240CCB9F94BEDF852C078FBE84BE4A34240A04C1B22EFF752C0BCCC582A2BA542403E9AA387F4F652C007EA416C29A442406AD1ED1883F652C0587BAEAFA8A24240E3AF2AD7A8F652C01CA6B2AC64A14240D6A3DE2380F752C0A49632BF86A0424094C8714C1BF852C01CB87058CE9E42400EB2031987F852C078E0FFA8FC9B4240E4955E0D23F852C0702513DB509A42400295B5D6A2F752C0E0825D7566994240DA39EAA1E3F652C064E8ACBED6984240010300000001000000140000002A406CCD1CF152C0982BFCC0E5A64240704C1741E7F152C0B05AC79513A6424050EAAB0E4DF252C0B0A4548A29A64240AEFD79BAFDF152C088880780A9A64240C0A0CC6C7BF152C0DCC950EA12A7424066520B0425F152C0D835C3A8CCA742409286C015B9F052C074BF94DFB4A84240AE5B519EE7EF52C0E0160EC6C0A94240CEC5BB306DEF52C09423F0A3B4AA4240ACEE8235ECEE52C010D04DDA55AC424024E64AB1C1EE52C0F45D6C6954AD42409CFE76838FEE52C060A5CBA7F6AD42401454D10E4EEE52C0703A19C1EBAD42405AE9F1854DEE52C00C777FAD6CAD4240E880609870EE52C0B8824CFD3FAC4240167313BFC6EE52C0F8E61E894CAB42406E92B2E740EF52C05C88836813AA4240FD02A03BF5EF52C088D924B6F0A84240C8BD6A3F9BF052C0009345E807A842402A406CCD1CF152C0982BFCC0E5A642400103000000010000000A0000005411D4A7D7EB52C0C09C72EF1BB54240B436779B07EE52C020C7426024AF42403659A86A5FEE52C04C516EEFDBAF4240EAC27AFC4EED52C03C2AC1D305B3424013416EE2CBEB52C0E05A90EEE6B74240B94F25684BEB52C0C868F7D43FBA4240441A7BADE6EA52C040E428783EBB424004CDDDFDFDE952C020DCBC9C12BB42400D65DF7D44EA52C01492A144BAB842405411D4A7D7EB52C0C09C72EF1BB542400103000000010000000C000000F42DD87836EA52C0C05B3B26D2BD4240664B9E64EBEA52C0C8FF8C3510BD42403EE7B2F428EB52C0E84688D42FBE42405DD2756761EA52C0D0A7E83192C04240F4D9582136E952C0F81A14D775C44240BE2DDD2C97E852C0D027F72478C7424000D1B389CEE752C04C1C96731AC94240AAF91FD041E752C0E887F8FEFBC9424034965E3863E652C0E8B065E09DC9424092E28A5B8AE652C018A796FEFCC74240AA8A02401FE952C0604B707375C14240F42DD87836EA52C0C05B3B26D2BD4240010300000001000000070000001410549FC1FE52C0201E284850E9424000E402650DFF52C0E8FBAB3953E7424056ABEF5C95FF52C020CA862BE3E84240F8E81D6CE6FF52C014F522B7FFEA4240DEED5AA548FF52C09CDA3BB258EB42409420938783FE52C068EC681C2AEB42401410549FC1FE52C0201E284850E942400103000000010000001600000080C4B95D1AD952C098E650DFE2F34240ADC0F84BC6D952C078219F9C90F342407EF6367247DA52C0401BA4ADB8F3424040339683B5D952C090B9BBE069F442403C59EDD123D952C0D471514EB0F54240C29278FA9AD852C0E07D89B055F742408E3F984100D852C0B8A248EFC2F74240324FF64843D752C0B86F12508FF84240046D9D0BE5D652C0846FCF0A84F942401A07D93D8FD652C017E3CFA619FA4240EE5803F9D1D552C0D4BA4AA750FA42409086F24FDAD552C0884B6CBDADF9424006795FF004D652C050287C44B9F842407A88D0B215D652C00C4EA1C0A9F742405F3710EB1DD652C0E465E9FEC2F6424022D442E559D652C044474E7A2DF64240822591EF05D752C0B00CBC371FF6424063316E26C3D752C06C8C6EB5F5F54240243107F518D852C05CA443A06DF54240DC498C17ABD852C02F7C878C1BF542407603DFA9AAD852C0B010B0D234F4424080C4B95D1AD952C098E650DFE2F342400103000000010000009F0000004D45467420DB52C0B01991A9F4F44240223B314917DC52C01487417AF9F34240CCF296BAAADC52C007A5D4A462F2424026BF3B485BDC52C0D8CF528ED6F14240C2AC56A73CDB52C068F98B6445F24240343C77C7B1DA52C0A8434E766BF142402EE4DA7B31DB52C0F806AAB603F04240EAFAE3F594DC52C06C66300408EF4240DAA18A431FDE52C0D857B7E4F2EC4240D1C8169881DF52C0681DE4F560EA4240ECD5AFF0C5E052C018A686E280E742403F47945100E252C0A41A1563D9E44240E6868F50DFE352C0A83B352F38DF4240106686FF47E652C0A0ECB1F799D942404E42EF0E22E852C00CA0EB1E40D642405ED6B9D9C7E952C07050C4273FD242406E9427692EED52C004DA687043CA4240BEDD112FDEED52C0C82F9D5F9FC742404406D228F1EE52C0985ECF359EC4424012F9C90CACEF52C097862B1E19C34240EC371E8FA0F052C0E46C06A104C14240BC607CD35FF152C0B8C5CF35C2BE424019837CD32BF252C0D42CD035E6BD4240603E7CD373F252C0F880CF35EABC42406E7A4D2BDFF352C0C44241CB28BB42405C928FB265F452C0D09E497724BA4240C03B0C22DCF352C0C4225976B7B84240798341C225F452C067AA5706DFB74240969720A9B9F452C0F0713746BAB64240CAC0185C96F452C05823D96FA2B542401C4106929AF352C020D3C1710EB5424022D31D9BEFF252C09016F06AEDB34240E2BF6F9232F352C0544B1B7135B3424006EE073CF0F352C0B8CFE65CFDB24240B42534A77DF452C07075FC2E24B24240B6CEED2805F552C0F4541D3F02B2424078FF2AE386F552C09C2B281EADB24240B89C3267B8F652C0E80D383EDFB24240A2AE77DD0DF852C080747AE346AF4240420DA3A9C9F852C070BCB21AB1AD4240DC43266CA1F952C0D8C9886EAAA94240AA0D848056FA52C0CCDC19D337A542403245B87D1AFB52C0C0169ADC499F42404BEC6BD458FB52C0E0AC141E0E9B424034FEE73DC9FB52C0DF17F4D12E964240BEB0ABB2D7FB52C0A07A9101479442406CC64F34E6FB52C044653537489142407C5D683CBEFC52C00483976CFE8F4240A8CD58F7D9FD52C0D82AF7F8409142403830C9C678FE52C03C4B91A2AC944240F28D88BF0C0053C09C60D9F5E09842402CEA7CD30F0053C028D5CE352E9C4240DC0A7CD3C1FF52C03BD5CE35EE9D4240DC0A7CD3C1FF52C070BF248BB79E424060FB7CD3150153C0988D258BFFA04240765AD128F50053C0E393D0350AA44240DB0A7CD3010053C0740AD035DAA64240DA0A7CD3E1FE52C08071D0357EA842409D28D228BDFF52C08C71D035FEA8424079A57CD3170053C0C0107BE0E4A842402E9FD128AD0053C08071D0357EA84240FA4AD22869FF52C01017268B2FAD4240F6FF267E06FF52C0700AD0359AAF4240AAF97BD35BFF52C098F7CE353AB142405322277E52FE52C0AC5ECF351EB24240663E7CD393FD52C0A85ECF359EB34240329FD1282DFD52C068557BE03CB54240D4C77CD323FD52C098F7CE357AB642406A89277E36FD52C0B4107BE064B64240765AD12895FD52C08B71D0357EB642405EFB7CD3D5FD52C040B6D03556B6424078A57CD3F7FD52C0EC19CF3586B542404A947CD371FE52C0EC19CF3586B54240D0C77CD343FE52C0304FD035B2B742402E9FD128CDFD52C088F7CE35FAB942403EBB267E0EFD52C0EC19CF35C6BB4240FAFF267E46FB52C07B557BE03CBD42402E9FD1282DFB52C05CD2258B97BE4240FA4AD228C9FB52C0985ECF355EBF4240D4C77CD323FD52C038B6D03556BE424004D97CD3E9FC52C0E893D0350AC24240E8E3D12805FC52C0F019CF35C6C442404E947CD3B1FA52C06FBF248BB7C64240603E7CD333F952C00436248B07C842405022277ED2FB52C0FC35248BC7C942405EFB7CD3F5FA52C090F7CE35FACA424042BB267E4EFA52C0BC107BE024CC4240765AD12835FA52C058A3CF3536CD4240A4B67CD3FDFA52C0C82CD03526CE4240E8E3D128E5F952C050D2258B57CF4240A8B67CD37DF852C050D2258BD7CF4240ED717CD3C5F752C0687479E094D04240964F7CD3B9F852C0D8FD79E084D242401E837CD30BF852C0503CCF3592D4424076A57CD317F752C0D0B2CE35A2D54240AE44277EDEF552C00036248B07D64240E8E3D12865F452C050D2258B17D642401A837CD3CBF452C0E093D0350AD84240944F7CD3B9F452C0DC48258B27D94240964F7CD379F252C0985ECF351EDD424074A57CD397F252C09C427AE0DCDD42405EFB7CD3F5F352C0DCB2CE35E2DD42405EFB7CD3F5F352C030B6D035D6DE4240A228D2289DF252C07871D0357EE04240DE0A7CD3C1F152C0700AD0351AE24240FE4AD228C9F152C0680AD035DAE342405CFB7CD315F352C0E048258BE7E54240ACF97BD35BF252C0780AD0359AE74240C4AB277EA2F152C00081CF356AE74240319FD128EDF052C064BF248B77E642408AC1D12839F052C0E048258BE7E54240603E7CD373EC52C0284FD035B2E6424004D97CD309ED52C0F019CF35C6E742407AA57CD357ED52C018B979E02CE9424049947CD351ED52C0C4107BE0A4EA4240382D7CD3EDEC52C0284FD035F2EB424077A57CD377EC52C0B47A248B1FEC42407AA57CD3F7EA52C060A3CF35B6EB42403EBB267E4EEA52C0284FD035F2EB42408CC1D128D9EA52C01804258B0FED42400A1C7CD327EB52C0BBC5CF3542EE4240F9FF267E26EB52C0D848258B67EF4240A8B67CD3BDEA52C0C4107BE064F042404106D228F1EA52C0988D258B3FF24240A228D2281DEC52C058A3CF35B6F3424017837CD3EBED52C0E048258B67F44240309FD1288DEF52C060BF248BF7F34240309FD1288DEF52C0C0C5CF35C2F44240F4FF267E06EE52C074557BE0BCF64240603E7CD373EC52C0B0C5CF3542F842409CDD267E5AEA52C038D5CE35EEF8424060FB7CD355E952C0D893D0358AF94240EAE3D12885E852C0E4B2CE35E2FA4240A2D2EC8276E952C0B7EDD0999CFB4240F1BCD6420FE952C0C435E881C5FC42406D582EF56DE852C0982A2418E9FD424056738092E8E752C08041518444FF4240A4C5CC3D72E752C0E40C01A775FF42408803094ED5E552C0C805854CA5FF4240FA87488C12E352C080C6355B240043408DC471BB57E052C00417138893004340329D043675DD52C0E7249B7822014340C81F89ECF9DA52C0A816A3C381014340CC6441572DD952C0C87FFA4AC10143407206DC392FD852C0BC787EF0F0014340A73901EA26D852C0A4374705F201434062FB7CD335D852C08B71D0357E014340EE717CD305D952C04FD2258B5700434004D97CD309DA52C0FC80CF35AAFF42408CC1D128F9DA52C050877AE074FE4240F4FF267E46DB52C08471D035FEFC4240713FB64BCCDB52C02093F0571DFB4240CCA7FDF2A3DB52C05443A193D5F942407C861E61D3DA52C0B759C55ABDF84240D4B187DF35DB52C088EBB398D2F74240982817FDDDDB52C0CC1EDAA183F74240148AA87AD3DB52C014E8AC267AF6424048B4CC9EDBDA52C01CCC820AC0F542404D45467420DB52C0B01991A9F4F442400103000000010000001A000000949BB0A9E5D552C038AE12A815F0424092BEB5B88BD652C0D8705D400EEF424019EE8CE462D752C07083A5C472EE424064D5BEEB39D852C050C2DEF489ED4240BA15437E25D952C0C80E3B77AEEE4240901C5CAC9BD952C0B81E96F1E2EF424017B5EEBEE1D852C0807F46006FF042403E62ECFE9DD752C0785E06DD4AEF42407E32D6FCEDD652C0D49AB62BE6EF42405A97E9B065D652C06FD0C83BD5F142402446174D47D752C0C8CEF6BD8DF24240BE9891CDF7D752C0C84B53B8E9F24240E6B6EABE8CD752C090FB12155DF44240051C7CD367D652C0A05ECF35DEF44240643E7CD3B3D552C0F019CF3546F54240F8FF267E26D552C0483CCF3512F642404206D228D1D452C0DCB2CE3562F74240B044277E5ED452C0A85ECF355EF84240CE7CD12881D352C0BC7A248B9FFC42401E837CD30BD352C03F3CCF3512FE4240663E7CD3D3D152C097F7CE35FA004340FC8ACC7BD5D052C0783CC0B5E5024340C61FEDCE92CF52C088DA20F62803434016E1FBB511D452C0089DA7E6A4F54240A8B67CD3DDD452C058A3CF3536F24240949BB0A9E5D552C038AE12A815F042400103000000010000008704000027E2C719097653C0F4C6B08836934340D89F61B37C7553C078924A227492434046C1FA4C167553C00C13B2880294434000632D80A77453C0783F7D559B954340541694E69F7353C0D8CE16EF609943400EAEFA4C0A7253C044AA16EF389F4340D45E2E80F77053C0C061E3BB29A34340821261B3906F53C030FCE4BB55A843404A2E61B3246F53C0D05EE5BBE5A943404041C719056F53C0E8004B2260AA4340B8D2C619C76D53C0EC56E5BB75A943409A3594E6856A53C058C218EF70A94340E6AB61B3566953C0107E17EF14A9434064212E80A16653C0086A492260A7434020DAFA4CBC6353C05C03E4BB45A64340D6CBC719096353C0C012B18842A543402AE093E6CD6153C04C907D5503A243407C772E80976053C0579C7D55B7A04340A8282E80255F53C03043B18812A043406E3AC719DF5D53C08CA47D55339F4340ACD5C6192D5D53C098994B22349D434066F4C719695D53C0103BE6BB959A4340508661B35C5E53C0F84CE4BBA19843400434C719796053C0EB32E5BBB1954340505C61B3F26053C077824A2288934340B65C2D80936053C0405F4A2290914340FA2B60B3BA5F53C0B81B17EFDC8F434081F093E6C55E53C0445216EF788E4340704161B37C5C53C0A0504A22D48A4340EA93C719FB5A53C0F07418EF808943407242FA4C585553C0D88818EFA4884340F49C60B34C5353C004AF4922B8874340444F61B36C5153C00C4117EF1C864340007460B3065053C06C86B088C683434024CE61B3A24F53C0F0134B22048243407ED02D805F4F53C0D4AF16EFF87F4340F0A1C719F14E53C0487EE5BB497E434032B02E800F4E53C050A816EF947D4340128094E6254D53C078E6B0884E7D4340BC3461B3024B53C03C397E551B7C4340C61EEEE1604953C05F65B8437C7B4340825F735F794853C080F8C03EAD794340B268EA7DAA4753C038BEF9698F7743407EB2BE0F394653C0D87CE02F4074434058593941654553C0F8163B90A2734340F2B67F905F4453C00830EFB072734340E6E9A872134453C028DE6CA6147243405EFD58EE504353C044B944A7C7704340725D7D44E54253C058EEFA1627704340A84B3F417F4253C084D3BE77236F43407C7F6DA43C4253C000144D5B346E4340D40AA1501D4253C0873B93E74E6D4340D6437669194253C0486FB7B2316C43402ED85F6C5D4253C0B8943AE27F6B4340462C00F8CD4253C0081A2639716B4340D66B4C18C54253C043A1F9D1ED6A43409C26E028904253C0CC7AAD35E8694340BCDEC691674253C09808599253684340C60E0963744253C0387F0E98EC654340DA3464D9BF4253C098B6EE6F5B654340E2CBF2122F4353C05482B6FDF4644340B0C71A145E4353C070FF5AD04E64434074E2B26A0D4353C09861D00760634340C4F24F52FB4253C0C0C7D08643624340D274D436DD4253C0286ABA8FBD5F43407C884DC4B84253C004036EDB4C5D434004A924B00E4353C014C129D49C5B4340E4EACD297A4453C003724E08F75A43405EFB7CD3B54553C038D5CE35EE5A4340A8F97BD35B4653C098F7CE357A5A4340D27CD128014753C02804258B8F5A4340D27CD128814753C0C02CD035665A43402CEA7CD3EF4753C04FA3CF35F65743400E0B97E3624853C094F33E35AE564340C62FBA241D4953C0304BC9B9A756434034D5351B8A4953C0804AABE7C5574340C497248A214A53C0ACF3544087584340D42FB900BD4A53C0775D67CC2F5843400AE6315BD64A53C0BC161A80F456434086C35EFDDF4953C0141CFC76F2544340720DE6EED44853C0E8BC93844153434085A368A1A14853C0D00F4BB971514340BAF2665B6D4A53C020764FF3D55043401C35837EFA4B53C00011E35B764F434006530F5CDB4C53C0E488970FD74F4340408C5FF7644D53C09C7E0185C650434078B6EA471E4D53C0E4D56D1BC9514340DA0A7CD3814C53C01017268BEF53434006D97CD3E94C53C0BC7A248B1F5543404006D228D14D53C09C427AE01C5543406A89277EB64E53C00FE8CF350E544340BC607CD31F4F53C0D02CD035265243404C947CD3514F53C030D5CE352E5043405EFB7CD3D54F53C077557BE0FC4D4340342D7CD38D5053C0EC19CF35064C4340D2C77CD3635153C088F7CE35BA4A434061FB7CD3155153C044B6D035564A4340633E7CD3D35053C0EC93D0358A494340D5C77CD3835053C0D42CD035E64843404E947CD3B15153C040B6D03596474340944F7CD3395253C098F7CE353A474340944F7CD3395253C0EC19CF3546464340D0C77CD3635253C098427AE0DC434340D2487C688B5353C048EDE58846404340A4CF1FE4E65453C03C65D531B8394340601132AC1C5453C0A8E0D005FC33434074121EBB6B5553C09B73DCAF563543406E9CD05B845653C05C418FCF66374340FFD5F534F55653C078D98227F236434038BBE1166A5653C0C7580C426C34434038A4B43EB25453C060EA1CADF131434092205691C75353C078A61D2C93304340504EEAE7075353C01C8576F8322F4340742EA3239C5253C0C43F8BD0482D43403B4FFF96565353C084169D69582D4340A48955BBBA5453C02024A8B4DA2C43400EEAF0DDF45553C03CE676E8A12C4340F604172BAA5553C08C6A92ABDA2B43406C392E48B25253C0F4B74A459D2B4340AE50F944EF4F53C0A840ADA9392A4340A7B67CD3DD4B53C088F7CE35FA2B43401A837CD3AB4A53C00036248B872C434018837CD38B4853C08471D035FE2E4340E45361487B4553C038FCA71B282F4340A5B67CD3BD4353C040877AE074324340641CD0239D4253C073716A2DAD324340FCC481BD4D4153C0987D8F1B3A314340EC77722AF24053C0C43AAF74A82F4340C66AC9C9154153C044D8194E752D4340C6A68962E54053C0E841F899F82B43402C9FD128ED4053C01CE8CF354E2A4340FA569DC8784153C0A8B83A72F7284340353FC4BA7C4253C03012264849294340BECC908D544353C06F2AB3F758294340C8067F10604353C0986FB74A8E2843400A6F8A52784253C06344F4A80E28434039E0BBACED4153C0ACED3420622743401C5D78CD074053C01073A4D57E234340E8E3D128653E53C0C02CD035A622434004D97CD3C93D53C04C877AE0342243406B418DAD6D3D53C03CA37F594C214340368A0CA8203D53C0F01859CAA31F4340283D716B383D53C0084D5DFC241E43401CB78706873D53C02876EFA6F01B4340A43E2B24113D53C028BE99C6E61A43406C5A726D6C3A53C0A4826D527E19434072A3E3F86E3853C064F863CFA81643405C3ED6421F3553C01CB635152E1543408E2EAFBC013353C083AC5B0FAF1543408EA3C4A49B3153C0E0A0A6CB5F154340F94AD228693053C0700AD0359A144340EE717CD3053053C07871D035FE1243404606D228512F53C0988D258B7F114340F2717CD3C52D53C00081CF352A124340CE7CD128412C53C0700AD0359A134340A228D2289D2B53C0E4B2CE3562144340D90A7CD3E12A53C0C32CD035261443409C28D2285D2A53C0503CCF35921343402F9FD128ED2953C028D5CE35EE124340392D7CD36D2953C008E8CF358E12434004D97CD3A92853C01804258B8F12434060FB7CD3552753C09C8D258B3F134340446AAFD8DB2653C01859D89E5C124340421B840F7E2653C0B882C10AF7104340D4003898DB2653C0F44E395E750E4340AE006DAB192653C0EF2FBCDE720D4340F6DB6C79332553C0F805B7397E0C4340D8F642A3E92353C077C91336730B4340023507FE332253C0183391329F094340344B2174D62153C05877768A39084340603E7CD3532153C0BCC5CF35C2064340AE44277E1E2253C058A3CF35760543400A67277E0A2253C047877AE0F40443405CFB7CD3F52153C070BF248B37034340D6C77CD3A32153C0D048258BE70243405D501770492053C030223580060343401A45A4730C1F53C0F8DE7F08CA0243402EAD021F1D1E53C003EA9CFF14024340E612E8F5A21D53C028366BD2E8014340755AD128151D53C0E493D035CA004340362D7CD38D1D53C004CC7AE04C004340F6FF267E061E53C0B87A248B1F0043409CDD267E5A1D53C030D5CE356EFF4240BC91829F1F1A53C0A7A261661CFC4240C2607CD3DF1753C054877AE0F4FA424090E518B4A31253C0F0A19F4B66F64240501E4CA6C41053C0486D43E807F54240E46549BDDD0F53C023DC2AF0A4F342406BF96F5B840F53C04044AD1AD8F0424078A57CD3170F53C00036248B07EE424060FB7CD3550F53C0D8FD79E004EB4240CF7CD128011053C0403CCF3552E94240EAE3D128251153C0F835248B87E94240F84AD228291353C0FC80CF35EAEC42402D9FD1282D1453C0EC19CF35C6ED42400967277ECA1453C0E0B2CE35A2EC424078A57CD3571453C038B6D03516EA42402CEA7CD30F1353C0E048258BE7E5424042BB267ECE1253C024B979E0ECE342405222277ED21253C08C71D035BEE242402CEA7CD30F1353C054877AE074E14240BE607CD37F1353C060A3CF35B6DF4240FA4AD228C91353C0D893D0358ADF4240944F7CD3391453C060A3CF35B6DF4240DE0A7CD3A11453C0F035248BC7DF424030EA7CD3CF1453C0E019CF3546DF42400967277E4A1453C090F7CE35BADD4240EE717CD3451253C09C8D258BFFDA424030EA7CD32F1253C0B0C5CF3582D94240663E7CD3B31253C0E048258BE7D8424030EA7CD36F1353C043B6D035D6D84240643E7CD3331453C0770AD0351AD9424030EA7CD3CF1453C0B0C5CF3582D942406689277E761453C08871D035BED7424048947CD3D11453C090F7CE35FAD64240C6AB277E621553C0948D258B7FD642402BEA7CD3AF1553C0A05ECF359ED5424074A57CD3771553C0A85ECF355ED44240309FD1288D1453C038D5CE356ED2424078A57CD3571453C01C04258B8FD14240BE607CD37F1353C0D42CD035A6D14240309FD1288D1453C0B07A248BDFCF42409E28D2285D1653C0D0B2CE3562D04240F0717CD3E51953C0D8FD79E084D2424006D97CD3291A53C0304FD03532D3424060FB7CD3D51A53C07871D0357ED44240F8FF267E861B53C098427AE05CD5424078A57CD3D71B53C03F877AE0B4D442405622277E121C53C0780AD035DAD442405622277E921C53C09C5ECF35DED542400E67277E0A1D53C08471D0357ED742404206D228311D53C0DCB2CE35A2D84240C6AB277E021E53C048877AE0B4DA4240C2AB277EA21E53C070BF248BF7D8424062FB7CD3551F53C0D0FD79E044D442404A947CD3512053C044B6D03516D44240725AD128152153C0AF7A248B9FD54240081C7CD3872153C000CC7AE00CD8424030EA7CD38F2153C0B0C5CF3582D94240F0717CD3452253C03CB6D03596DB42404406D228912453C00081CF352AE042403CBB267E0E2553C098F7CE35BAE242407AA57CD3572553C08471D0357EE34240A4B67CD33D2753C0E048258BE7E5424002D97CD3892753C0C0107BE0E4E64240382D7CD3CD2753C028D5CE352EE8424099DD267E3A2853C0C0C5CF35C2E84240A8B67CD3FD2853C0483CCF3592E742405622277E922953C0483CCF3512E84240934F7CD3192A53C0647479E0D4E84240FA4AD228692A53C007CC7AE00CEA42406689277E562A53C0284FD035F2EB4240E8E3D128252B53C0A87A248B9FEA4240C4AB277E022C53C02C4FD03572EA4240A8F97BD3DB2C53C0A87A248B1FEB4240A8B67CD39D2D53C028B979E06CEC4240EE717CD3053053C06C7479E094F2424058228DF33F3153C018C599360EF54240F02190C7433553C05744D04FB3F842405790373D6B3653C0A85098CFB0FD4240B330A50A533853C0EC9A34ADD7FE42404A7A09C2533953C03FBBD77EEF00434060FB7CD3953A53C0304FD035F20843406689277ED63B53C08071D035FE0B43409B28D2289D3C53C094F7CE353A0D4340AAF97BD39B3D53C01417268B2F0E4340944F7CD3794053C0985ECF351E0F4340964F7CD3194153C098F7CE35FA0E4340623E7CD3B34153C08771D0357E1043404506D228514253C044B6D035961243401E837CD30B4353C054877AE074144340CE7CD128014453C0978D258B3F154340AEF97BD3DB4653C0C4107BE0641643403EBB267E0E4853C0F335248B871643405622277E924853C0978D258B3F154340ACF97BD31B4853C0C82CD035E6134340D27CD128014753C0503CCF3512134340AAF97BD3DB4453C008E8CF358E1243400C67277E0A4453C030D5CE352E1343402E9FD1288D4353C0DF48258B27134340643E7CD3534353C0E048258B27124340DD0A7CD3414353C08771D0357E104340061C7CD3074353C090F7CE353A0F4340BC607CD39F4253C064A3CF35360E4340E8E3D128054253C014E8CF354E0D4340964F7CD3793D53C070BF248B770B4340A8F97BD3BB3C53C05CA3CF35360A434060FB7CD3753C53C0E093D0358A094340D90A7CD3413B53C0FF35248B87074340A228D228FD3A53C0BCC5CF35C2064340643F40614A3B53C0B7B0AD6794FF42402AAF401A0C3B53C0603DFBF28BFD42407A3E4398F83953C098569DBEE6FC42404A947CD3113953C05CA3CF35B6FC424062FB7CD3553853C09F5ECF351EFC4240F5840A13283853C0F871D61C6AFA42400F2B893D6B3753C03819C7B592F8424060FB7CD3353653C0D048258BE7F642404A947CD3313553C007CC7AE08CF542401E7650D0403453C074F88697A7F3424048C5FCF8E53253C0180158A82BF24240FCFC6BCA6C3253C0C4997CB30DF142403ACC2E7DC73153C0B020A9FF58EE424051EFF3BC143153C008C2FEFAC7EB42405C0607D42B3053C0281404D14BE94240B4F96782782F53C0975FA4EFACE742400B123FE5A92E53C0600DD1E154E642407EA954F3D62D53C068C8FB5CE0E44240A43D9484FE2C53C0936E71F2BAE44240041C7CD3072C53C010E8CF350EE54240F4FF267EC62B53C0E019CF3506E54240D6C77CD3832B53C05F7479E014E542406889277E362B53C050877AE0F4E4424002D97CD3292B53C08471D0357EE44240D5C77CD3432B53C008CC7AE0CCE242406889277E362B53C0677479E054E24240253A174ECB2A53C0F4125046B4E042402C7CB6A1712853C0F8BE57050EE04240CB4242F4412753C08C08DB36A9DE42405E6D389E822653C0C04797801DDC4240B244277E1E2553C0A35ECF355ED942403CBB267E0E2553C04C3CCF3512D942404006D228F12453C030B6D03516D842405CD43EE8BC2453C0608302EC2CD64240606EC012882453C088412C849DD34240C66145AD532353C0C0911E9839D04240A6D820126C2153C008631B6AB4CE424002D97CD3A91D53C018B979E02CCF42409CDD267E5A1C53C028D5CE352ECF4240061C7CD3671B53C0C02CD035E6CF4240C0607CD3DF1953C010E8CF350ECC4240F6FF267E861753C0F735248BC7CA42404006D228D11453C0483CCF3552CA424030EA7CD32F1253C0D848258BE7C842405122277E521353C0FC80CF356AC742403EBB267E6E1453C0E019CF35C6C6424040BB267E6E1753C0F035248B47C64240F8FF267E261953C0C02CD03566C542402E9FD1282D1953C08471D0353EC442401A837CD32B1853C094F7CE353AC342404606D228D11653C0E493D035CAC24240F6FF267EA61453C00781CF352AC04240031C7CD3471353C05CA3CF3536BF42400867277EAA1253C02C04258B8FC04240FFBFC94D8C1253C010316ED57BC24240B659DEB0481153C05088E3B438C24240CC84D742D11053C09F7562F05FC04240DE0014D2E31053C0847369EA5FBE4240CC7CD128211153C0403CCF3592BD4240A6B67CD3BD1153C060BF248B37BC4240CD7CD128C11153C057D2258BD7BA42409C28D2281D1153C0C4C5CF3502BA4240A6B67CD35D1053C0E4FD79E004BA4240F3FF267EA60F53C0D893D0358AB94240273BD622A80F53C020F651731DB74240221D7455B50F53C0A858A7CAF7B24240280DC6FFF20F53C0302007D484AE4240EC44092D7D1053C0A010CA00F2AA424078A2EC0CF71153C06491920A22A94240914A798C161353C0189F188CE3AA424005D97CD3691453C094F7CE357AAF424060FB7CD3951453C0304FD03572B142408EC1D128591553C0E819CF3546B14240F8FF267E461653C0D0B2CE35A2B0424040BB267E6E1753C098F7CE353AB14240D80A7CD3611953C07C557BE0FCB642404A947CD3911A53C00481CF35AAB84240061C7CD3671B53C0EC19CF3586B542402E9FD128AD1A53C0A85ECF351EB542404C947CD3311A53C0284FD03532B44240E8E3D128E51953C02004258B0FB342404E947CD3B11953C0F019CF3506B2424088C1D128591A53C000CC7AE08CB242400A67277E0A1B53C0E0B2CE35E2B242408AC1D128B91B53C0F835248BC7B242404E947CD3511C53C0F019CF3506B24240E4E3D128A51C53C0B07A248B9FB042405EFB7CD3551C53C0A05ECF359EAF4240A7B67CD39D1A53C00336248B87AD4240EE717CD3251A53C0D0FD79E044AD42404A947CD3D11953C0DF19CF35C6AC42404E947CD3B11953C0B8C5CF3582AB4240D4C77CD3031A53C090F7CE353AAB424078A57CD3D71B53C0D848258B27AA424078A57CD3D71B53C090427AE05CA94240E4E3D128C51953C0780AD0359AA9424076A57CD3371953C090427AE05CA9424060FB7CD3B51853C044B6D03556A84240B244277E1E1853C010E8CF358EA642402E9FD128CD1753C0985ECF35DEA442402842D16C391853C0180DA6C9DBA24240FEDD2D89461D53C00792162C6AA14240AE4D21F2BE1F53C0E05FBDFEE29F4240C4BE303B992053C0E04F272281A24240060BF8798F2253C040D2F7BF88A54240585D9DE27F2353C06CAF62BE6AA742404A947CD3F12353C090427AE05CA94240CE7CD128C12453C0B87A248B9FA94240BE607CD33F2553C004CC7AE04CAA4240AD44277E1E2953C0740AD0355AB44240BC607CD31F2A53C0EC19CF3586B54240633E7CD3932B53C074BF248BB7B6424042BB267ECE2C53C0E819CF3586B9424062FB7CD3B52E53C0D893D0354ABF42409E28D228FD3153C0E893D0358AC44240623E7CD3933253C01017268B2FC44240081C7CD3E73253C0F019CF3546C34240329FD1280D3353C09C8D258BFFC14240725AD128153353C02C04258B8FC042405222277ED23253C0F735248BC7BF4240944F7CD3393253C0D893D0354ABF4240D6C77CD3833153C0C4107BE0E4BE424030EA7CD3EF3053C038B6D03556BE4240745AD128352E53C01417268BAFB642405EFB7CD3352C53C0A85ECF359EB4424004D97CD3492B53C000CC7AE08CB24240091C7CD3E72953C00436248B87AE424082BE395ECC2653C088A7D16ADCA54240EAF9334C252253C04F7C7160B4A04240007CB70C472053C0E839F212AC9D4240F49509EAF41D53C098684C3F639B424042136BC8AA1B53C0BCCF4863789C42400C67277ECA1953C03BD5CE35EE9D4240382D7CD3AD1853C0C0C5CF35C29D4240FA4AD228E91753C028D5CE352E9C42402C9FD1280D1853C0B37A248BDF9B424078A57CD3371853C0EF35248B879A42405CFB7CD3551853C0E448258BE7984240332D7CD34D1853C098F7CE35BA974240DA0A7CD3E11753C0F019CF3586964240FAFF267E261753C04C3CCF35529542407AA57CD3771653C0E4FD79E004954240FC4AD228291653C063A3CF3576964240382D7CD34D1453C00881CF356A94424062FB7CD3151353C0B8C5CF35829242400867277EAA1253C0D848258BA7904240081C7CD3671353C0A85ECF351E9042406889277ED61453C0780AD0359A8E42401C837CD3AB1553C0D4FD79E0048D4240A028D2289D1453C0F835248B478C4240EE717CD3051253C0747479E0548D4240362D7CD34D1153C0948D258B7F8C4240EE717CD3451153C0A85ECF35DE8842404C947CD3911153C0D42CD03526864240A9F97BD31B1253C098427AE09C834240765AD128F51253C078557BE0BC8142402D9FD1282D1453C0AFC5CF3502814240AAB67CD3BD1553C0304FD035F2804240944F7CD3D91653C0AC5ECF359E804240EE717CD3C51753C02804258BCF7F42404A947CD3911953C09CF7CE353A7D42406889277E961A53C068557BE07C7C424074A57CD3771B53C068BF248BF77C42403A2D7CD32D1C53C0D0FD79E004824240A8B67CD3FD1C53C08F427AE0DC834240BC455E3E882153C098DBC3B9618742402F869BB4F22253C0FC9608B4718B424011B359530B2453C07414EE16FA8A42402C2D86B21D2753C09833BAE1498F4240D2B46F14972753C0E0B63A96BD904240332D7CD3AD2753C078557BE07C92424077A57CD3172753C040B6D03516964240C2AB277E822753C08471D0357E994240663E7CD3932853C0888D258B3F9C4240091C7CD3E72953C03BD5CE35EE9D42405CFB7CD3D52A53C0483CCF35129D4240A3B67CD37D2D53C017B979E0AC9C424062FB7CD3B52E53C028D5CE352E9C4240362D7CD30D2F53C0D893D0354A9B4240081C7CD3472F53C0E019CF35069A4240944F7CD3992F53C0F835248B47994240A8B67CD33D3053C08071D035FE9942400E67277E8A3053C0EC93D0350A9B4240EE717CD3C53053C050D2258B579C42404406D228113153C03F877AE0749D42402C9FD1288D3153C03BD5CE35EE9D42402E9FD128AD3253C0607479E0549E4240372D7CD30D3553C0E0B2CE3522A042404106D228F13553C0F8CB7AE08CA04240DE0A7CD3C13653C054D2258B97A14240BC607CD3DF3653C0647479E014A44240362D7CD3CD3653C0908D258BFFA64240362D7CD30D3753C090427AE05CA9424019837CD3AB3753C0D4B2CE3562A84240081C7CD3E73753C02C04258B0FA74240C2AB277EE23753C0B4107BE0A4A34240663E7CD3333853C028D5CE356EA24240F84AD228E93853C020B979E02CA14240A028D2281D3A53C024B979E0AC9F42409E28D2289D3B53C0AF107BE0649F424002D97CD3693C53C0DF19CF35C6A04240B044277EFE3C53C0EF19CF3506A342407AA57CD3D73E53C070557BE0FCA74240E8E3D128653F53C08C71D035FEA842409CDD267E3A4053C090427AE05CA94240342D7CD3ED4053C004CC7AE0CCA8424002D97CD3E94253C02C4FD03532A64240643E7CD3534353C0680AD0355AA542402E9FD1288D4353C0B8C5CF35C2A44240F6FF267E064453C0D4FD79E004A64240A6B67CD37D4453C068BF248BB7A74240D2C77CD3A34453C08071D0357EA842401C837CD34B4553C0EC19CF3586A94240623E7CD3D34553C050A3CF35F6A942401E837CD36B4653C0A05ECF35DEA94240C2AB277E424753C090427AE05CA942409CDD267E9A4853C02C04258B8FA84240B044277E3E4953C08071D0357EA8424030EA7CD3EF4953C0878D258BBFA84240329FD1280D4B53C0C32CD035E6A9424000D97CD3694B53C0D848258B27AA42405DFB7CD3154E53C008CC7AE00CAA424006D97CD3094F53C0F019CF35C6AA424005D97CD3095053C0F035248BC7AC424004D97CD3C95153C0D848258B27AA424042BB267E8E5153C08071D0357EA84240603E7CD3F35053C06F7479E0D4A74240643E7CD3535053C030B6D03596A7424005D97CD3095053C038D5CE352EA74240745AD128554F53C0B0C5CF3582A742404E947CD3314B53C00481CF35EAA442405EFB7CD3B54553C00481CF35EAA44240725AD128554553C0BCC5CF3542A44240C0607CD3DF4453C094F7CE35FAA242401C837CD34B4453C094427AE01CA242401E837CD38B4353C07C557BE0BCA24240A5B67CD39D4153C0A77A248B5FA54240964F7CD3194153C0DC93D035CAA542404306D228B13F53C0A77A248BDFA442409F28D2281D3F53C028D5CE356EA24240623E7CD3D33E53C0B0107BE0E49F4240FC4AD228493E53C070BF248BB79E424076A57CD3D73C53C0680AD0351A9E424073A57CD3773A53C07C71D0353E9B42405622277E323953C030D5CE356E9A42404A947CD3513353C030D5CE356E9A424000D97CD3693253C09C427AE09C994240B55369DAD13053C03862095206954240CA469CB8562F53C030BC4CA00A944240EA4C35A1F32D53C0679223A7339342409ADD267E1A2C53C0B0107BE024984240808A0CD3E02A53C05C711C52AE974240A29B1367A42A53C094BE249DDA924240AAEE1F0BF12953C010BDC59D748D42401A75A1DD142B53C0ECE36DFB97884240BCE2383C392A53C028B9842F8B854240920E33BAD72853C08C5587E6FE844240745AD128952453C008CC7AE08C834240745AD128952453C0888D258BBF8242405022277E322553C0F035248B07824240D90A7CD3612553C0C4C5CF35C2814240AE44277E7E2553C0AFC5CF350281424089C1D128192553C0B4C5CF3582804240CF7CD128412453C0A87A248B5F804240725AD128B52353C010E8CF350E804240E7E3D128452353C03F3CCF35927F4240EC717CD3652253C018E8CF354E7E4240039654E7DD2053C0D001933F8B7B4240666FF085A91F53C07B9E6E361C7A42401C837CD38B1F53C0C0C5CF35C27842402E9FD1286D1F53C0204FD035727742405422277ED21E53C044877AE0F47542406789277E761E53C05CA3CF353674424074A57CD3D71E53C0DFFD79E004734240ACF97BD3BB1F53C06F7479E09471424030EA7CD38F2153C0284FD035726F424030EA7CD38F2153C08871D0357E6E4240725AD128D51F53C08F8D258BBF6E42406789277E761E53C0F419CF350670424077A57CD3371D53C0C42CD035A671424078A57CD3D71B53C0304FD035F27242400E67277E2A1A53C060A3CF3576734240A228D2285D1853C0F835248B47734240FC4AD228A91653C094F7CE357A72424002D97CD3491553C0A05ECF351E7142402EEA7CD36F1553C054D2258B976F424002D97CD3C91453C0C4107BE0246E4240ACF97BD3BB1353C038B6D035166D42400867277EAA1253C08471D035BE6C42406889277ED61353C00881CF356A6F424060FB7CD3551453C050D2258B177142402D9FD1282D1453C0C0C5CF3582724240D3C77CD3431353C00817268BAF744240924F7CD3991353C050877AE07475424055273FF3031553C05027AED7F2764240B22B7BB2251553C048A3CFA292794240189D2A47D71353C008185691D47A4240A2E0FFAD351153C09C91A3A80F7B42402E9FD128CD0A53C040B6D035D676424011F1E725100853C0C7F25AC247754240C0607CD3FF0453C00817268BAF7442408290CB36920353C0800773198975424096B37220450253C018F69724A9774240CCF2193C4B0053C0E8C71D85577742401EA56EA14AFF52C06099B80EBB7442404E68CA9574FD52C020EB5BB343674240C2AB277E42F752C050D2258B974B424080BB943399F652C08C5C558C464642408D9B60B37EF752C04C4CE6BB49464240921694E659F852C07881E4BB4D464240F4701B675CF852C050B5CDC04D464240949A277E5CF852C014E8CF354E46424030EA7CD3AFF852C08871D035FE4742404C947CD391F852C088F7CE357A4942405EFB7CD355F852C058D2258BD74A4240643E7CD353F852C0677479E0544C4240643E7CD393F852C0A87A248B5F4D42404C947CD351F952C0304FD035F24E4240D2C77CD3A3F952C0E048258BE74F424044C59013BBFA52C0A8C2723AFF564240C0AB277E62FB52C0C4107BE0645A4240964F7CD3D9FB52C0C02CD035265B4240964F7CD399FC52C060A3CF35F65B42402E9FD1284DFD52C030B6D035165C42409E28D2289DFD52C0DC93D035CA5A42404A947CD371FE52C07C0AD0359A4D424078A57CD3F7FD52C088427AE09C464240461D2C0DE2FD52C09769F22B60464240864494E6D50053C0B45C7E556B464240A45A5E16D90053C0784F055D6B4642408AC1D128D90053C01C9D248B6B4642409EDD267EDA0253C054877AE0744B42402FEA7CD3CF0253C0304FD035B2494240382D7CD38D0253C0985ECF359E4842409ADD267E3A0253C0A87A248B9F4742400A1C7CD3070253C00017268B6F464240E219A4C8070253C0988B424C6F4642400A5C60B3BA0353C0F88517EF74464240D4ECFA4C180653C030CD17EF7C464240EBBEFA4C760853C06C85E4BB854642400691FA4CD40A53C0973DB1888E464240982A94E6310D53C0D084B18896464240A881C719FD0F53C03490E3BBA1464240C0D8FA4CC81253C0DF8917EFAC464240A5382D80931553C038954922B8464240F08661B35E1853C0F01DB188C2464240CC91FA4CA01C53C028B3B088B6464240DC0461B3E22053C05FD7E3BBA9464240EC06FB4C242553C088FB16EF9C464240C81194E6652953C0A81F4A2290464240A01C2D80A72D53C0EC437D5583464240664E2E80E93153C00868B08876464240C4912D802B3653C0408CE3BB69464240CC93C7196D3A53C0E80FE5BB5D46424022DCFA4C504253C09052B2883E464240C6F4C619334A53C0D8174A2220464240C6FB94E6155253C090CBE3BB01464240EA4CC719F95953C0B86D7F55E34542403F95FA4CDC6153C0003317EFC44542400EA5C719BF6953C0D0E6B088A6454240E4B494E6A17153C0889A4A22884542400206C719857953C030DD17EF68454240FAFFFA4C708353C030DD17EF68454240BA022E805B8D53C030DD17EF68454240800561B3469753C030DD17EF68454240400894E631A153C030DD17EF684542403802C8191DAB53C030DD17EF68454240F804FB4C08B553C030DD17EF68454240BE072E80F3BE53C030DD17EF68454240F5D1FA4CDEC853C030DD17EF6845424088C093E679D053C07854B0885E45424003D694E615D853C0332B17EF5445424090C42D80B1DF53C0E890B1884A45424054AAC7194DE753C0A0F64B22404542401E9061B3E8EE53C0E86DE4BB35454240AA7EFA4C84F653C030E57C552B454240F49CFA4C20FE53C0E8BBE3BB21454240B88294E6BB0554C0A0217E5517454240629E2E806F0A54C088777D5573454240548A61B3220F54C0C44AB288CE4542404E7694E6D51354C090A0B1882A4642404662C719891854C078F6B088864642406A45FB4C3C1D54C038DBE3BBE146424062312E80EF2154C08F1FE5BB3D4742405A1D61B3A22654C06C75E4BB994742407E0095E6552B54C0385A17EFF447424008FE60B3BC2F54C080A67D5513484240D2F22D80233454C02CE1E5BB314842408EE7FA4C8A3854C00F3F4A225048424050DCC719F13C54C0CCEA7E556F484240DCD993E6574154C007A8B1888E4842409ECE60B3BE4554C0FC0516EFAC4842405FC32D80254A54C097407E55CB4842401BB8FA4C8C4E54C0DF8CE4BBE94842402A00C819AF5154C0F3B817EF4C494240005194E6D15454C0ECE44A22B0494240069961B3F45754C0EF107E55134A4240DCE92D80175B54C0E83CB188764A4240B23AFA4C3A5E54C0FC68E4BBD94A4240C082C7195D6154C0F49417EF3C4B42401C0CFA4C806454C0F8C04A22A04B42402254C719A36754C0F0EC7D55034C4240529D2E800F6954C01852E5BB094C4240DECB94E67D6954C063C118EF3C4C4240F09CC719BB6954C0E81CB1889E4C42403E6C61B32A6A54C08CAAE3BB054E42400E6AFB4C287054C080654A22684E4240C22BFB4C8E7554C05C4A7D55C34E4240B094FA4CF07954C0986BB1880A4F4240549B94E6817A54C088D717EFF44E4240F82761B3107B54C024037D55BB4E4240F620C719737C54C068B017EFC44C4240F6C8C719F57C54C090CBE4BB694C4240C44FC7190D8054C0BCA118EF704C4240F4ED2D80B78654C090EEB1887E4C42402AFD60B3628D54C068AC17EF8C4C42404C9BC7190D9454C05C6A7D559B4C4240FC7194E6B79A54C034B716EFA84C42402C10FB4C62A154C078F2B188B64C42401CB760B30CA854C068B017EFC44C4240CC8D2D80B7AE54C0446E7D55D34C42402C2395E661B554C018BB16EFE04C424024CAFA4C0CBC54C060677E55EF4C4240D3A0C719B7C254C0C013E6BBFD4C424004B0FA4C62C954C098607F550B4D4240344E61B30CD054C0603C4C22184D42405CECC719B7D654C054FAB188264D42401A3461B362DD54C038B817EF344D42400ADBC6190DE454C00094E4BB414D4240F2A894E6B7EA54C0F3514A22504D424022D2FA4CE4E754C0D0037E553B514240A6DDC719A9E654C0F065B0882E5242408AFC2D8037E654C0D0C44B2240524240C6D1C61993E054C0E499B18892554240C8B194E671DA54C0D0844B2290564240D95E94E6C1D954C0CCB07E55F3564240E23061B342D954C00C064B22605742408A3594E66FD854C0C47EB2887E584240A614FB4CE8D554C0B7217E55CB5A4240CCE3C71955CF54C0588FB0885A5E424058E894E6C7C854C0E0A3B188FE5F424090D593E639C854C030DB16EF6C60424004CAFA4CE0C754C0C4FAB188E6604240B403C719BFC754C094C57D557B6142408A3694E6B9C754C0F0654A22286242405ABB60B3D8C754C038A2B0885A634240D832FB4CD0C754C040627D55D36342405625C719A7C754C00088E4BB41644240E8F060B3E4C654C0D8394A229C65424030F5C71971C654C03C184C22B066424068D0FA4C46C554C0A0504A22D46A42401E00FB4CFEC354C0D8E816EF046D4240523394E699C354C0B45018EF646D42406799FA4C30C354C0F0BF4B22986D4240041B2E8077C054C0975418EF9C6D42400E6494E675BC54C01FF0B1881670424044F6FA4C98B854C03098E3BB79724240F62E61B39EB754C024A24A2254734240FAEFC7195BB754C0A832B288CE7342400BECC71923B754C0EC4A4A2260744240342361B3F6B654C0A774B188067542406C9E94E6D7B654C0401B4A22A875424056902D80BFB654C0D86218EF4C7642404CAC94E6A1B654C0F03E18EF3C784240042CFB4CAAB654C0E8A84A22A07942401CD860B3B6B654C064BAE3BB4D7A424070D2C719B1B654C080BE16EF687C4240A45E61B356B654C090F0B0886E7D4240725594E6B9B554C064ABB2887E7E424032B7C7192FB454C060224B2268804240C286C71985AE54C048A516EFDC844240F809FB4CDCAD54C0C4AA4A2290854240D8442D8099AD54C0581D4B220C864240F8BAFA4C64AD54C04459E3BBA186424099B92D8037AD54C020CA4A2250874240CA3461B318AD54C0B834E6BB09884240EEE7C7190BAD54C028574A22C88842401AD8C71925AD54C0C0837E55AB8B4240E4CF60B360AD54C0C01DE4BBA98D4240C81AFA4C52AD54C01F817C557B8E4240FE19FB4CC8AC54C0585E18EFB08F42403E66FA4C9EAB54C058174B228C914240A27DFB4C7CA854C034687C55FB94424083DD94E6B5A154C0D07D16EF549A4240DC5F94E6A99C54C014BE4A22509E4240B49F2D800B9854C02890B188F6A14240950DC8197D9654C024B0E4BBA5A34240E8F0C719F19054C0088EE3BB1DAB42409CEEFA4CCC8A54C0A4F94A2264B3424012BD60B3D88654C0348C16EFB8B842401679C7195F8154C088354A221CC0424001EBFA4CC67D54C0D7617E55F3C4424072CFFA4C387D54C067584A2208C44240045D61B30A7D54C0009E16EF94C3424097EAC719DD7C54C078D916EFF4C24240487D94E6C57C54C0342DE5BB4DC2424082DC60B3C47C54C080637F5597C142403C2694E6D77C54C0A0814B22E8C04240D2FB94E6EF7C54C05486E3BB61C0424019EFFA4C047D54C018594A2220C042409A8061B30E7D54C06CBF17EF04C04240A2B660B3987E54C0F0F415EF14BE4240FA102E80CF7E54C068E77C559FBD4240CA5FC719F97E54C0186A7D5507BD4240F6D3F94CF47E54C048107E5573BC4240DE04C719D37E54C0FC1416EFECBB4240A8D72D80917E54C0906CE4BB7DBB4240AB0A94E6497C54C0D4ED4B2224B94240E212FB4C0E7C54C0F8854A22C4B84240D20294E6D97B54C0835A4A2250B8424002B4FA4CB07B54C00C9BB088C6B7424046A0FA4C927B54C0001818EF28B742401400FA4C807B54C0A4E817EF7CB64240D3D660B3767B54C060ADB288D6B542402A9B94E67B7B54C0AB7EE5BB19B54240ACC294E6B77B54C048067E5507B242405EC82D80BD7B54C0ECB3B08846B14240488D94E6B17B54C08013E4BB99B04240F25594E68F7B54C09472E4BBFDAF4240DAD460B35A7B54C0282417EF74AF42401684C719157B54C0B0874A2200AF4240882661B3067854C064667E558FAB42401D2F94E66B7754C004F1E3BBB9AA424060A8C719317754C0CFDDB1883EAA42402C242E80017754C06800B188B6A94240F27361B36E7654C064D5B0884EA742404C99FA4C407654C06CC84A22C8A642400F5495E6077654C0B802E5BB49A64240A6ACC719757554C0480BB38862A54240EAEEC619B97454C0B0A017EFA8A44240D0ACC7197B7454C0303CE3BB91A4424014D5FA4CAC7354C0207917EF6CA442400899FB4CC87254C0476DB28872A442403C8594E6617154C0E49817EF38A44240581F2E80D17054C0544E4A22E8A34240F687C719737054C0E8F717EF9CA3424088D894E61D7054C04819B18836A3424034D5C719D56F54C078A0E4BBC5A24240B1ADC719996F54C068C2B0884EA24240EE0B2E80BF6E54C0C88E18EF34A04240FB84FA4C366E54C0571418EF489F424038DB60B3E66D54C02824B388E29E4240B4D560B39E6B54C01C77E5BB019D4240A05BC719076A54C014A04B22289B42401C3CC719416954C0384A4C22CC9A42403672C7195F6554C088C0E3BB359A42409A68C719D96354C0B3DCB188669A42400C3A61B36A6354C09892B288B29A4240130C2E80EB6254C014524C223C9B42401A1961B39A5F54C0B88117EFF4A042409A64C8192F5F54C0407149226CA14240F627FB4CA85E54C0D061B288D6A14240EA39FB4CB05D54C0488DB2884AA24240B2C5FA4C245B54C0C0177D55BBA24240B3E7C619AD5A54C0BC43B0881EA342405013C719275A54C088D27E55CBA342405AA6FA4C645954C0E4D616EF38A54240AAC42D80035954C0ACDF17EF34A64240F6552D80BF5854C09C18B1881EA74240445A94E64B5854C0E0FE7C553BA942401847C7191D5854C04CDC7D55C3A94240CB64C719CD5754C044DD7E554FAA42405AA52D80435754C0A0A87D55D3AA424055FDC719755654C0307E7E55EBAA4240F21FC719ED5554C090A317EFBCAA4240DD82C719895554C05F42E6BB55AA42406A7C94E6455554C00488B288E2A94240B4CF94E6015454C034854A22F8A6424051382E80A35354C04897B1884EA642402AB294E6575354C0D02917EFE8A54240BD9E2D80FD4F54C0C0A2B08882A242402A4DFA4C7A4F54C0C46D17EFD0A142401002FA4C3A4F54C0E86517EF60A142406A3094E60D4F54C080ABE3BBEDA04240D897C719D14E54C06FAE18EF00A042405E9394E6A94E54C098B7E3BBA19F4240DC8E61B3824E54C04CF54A226C9F4240C4662E80574E54C0D8D2B088469F4240B3AEC619A14D54C030D67D558F9F4240265994E6734854C018967D55DFA34240B03A94E6D14154C0F059E5BB3DA54240FCCB2E80414154C0E850492288A54240344D60B3803F54C097D216EFF4A642409B2095E6E13E54C02819E4BB0DA74240ECC2FA4C623E54C07CFCE2BBEDA64240265794E67D3D54C068677E55B3A54240D4A1C619213D54C0A0D9B08892A542402920FB4CB03C54C0147F19EFBCA542401A7761B3783854C0581E18EFB4A94240DEB52E80213854C070E34A2244AA42400AC8FA4CC43754C06BD6492204AB4240DA5DC8195B3754C0602FB18856AC4240A043FA4C463754C04403E3BB39AD4240E87594E6513754C0E8DE4A22F4AD42401267FA4C443854C038CB7D55B3B042407C3995E6613854C0B0ADE4BB51B14240FEC1FA4C6A3854C048067E5507B242400469FA4C603854C00CC47E55C3B242406ED22D803F3854C0344018EF7CB342409C8394E6153854C0E84B18EF24B4424068A6FA4CDC3754C0F05DE4BBC1B442405C62FB4C823754C02494E3BB51B542406AA594E6033754C08C71E4BBD9B54240B424C819233654C06C7E4A2260B6424064BF94E6813554C0309B4B2280B642403A7793E6ED3454C068BF7E5573B6424076BAC719293354C038484B22D0B54240E671FA4CF43254C0DF074A22ACB54240B09D61B3BC3254C0A0874B2268B542408CA460B3A03254C0F4664A2210B54240A03FFB4C9C3254C04823B2880AB4424090E194E67B3254C06CAAE5BB99B34240C687FA4C343254C09465B1884EB34240062DFA4C143154C02C5D7E55EFB242402427FA4CC03054C0B888E3BBB5B24240FE6A2D807F3054C067744B225CB242406C8461B3563054C0109CB088EAB14240D4ED94E6353054C07C29B0886EB14240687BFB4C083054C094E5B28816B14240EC1DC819D72F54C084AB7D55E7B04240221D2E80992F54C058D54922E0B042406A57C8191B2F54C0C79819EF08B142407C27FA4CCC2E54C0303D4B2240B142404ECB60B3EA2B54C04823B2880AB44240046360B30C2954C050864A22D0B642401880FA4CF02554C0D4ED4B2224B9424081DDFA4C442354C060ABB18826BB424058F494E6C72154C0E0B54B22F0BB4240221794E6452054C02BC57D5533BC4240CC7D2D80CB1F54C044964B2224BC4240EE6EC719291F54C018394922E0BB42406A50C819EF1E54C0641419EF64BB4240D47AC719D71E54C050424A22E8BA424076F5C719C91E54C0BCE14B2270BA4240D2B9FB4CCE1E54C07445E4BB4DB94240F7242D80C71E54C043CEB088AAB8424051FCC619AD1E54C0700F4A2210B8424056E0FA4C7E1E54C0E8F0E5BB89B74240CC3E2D803F1E54C058E215EF20B7424002EE93E6F91D54C0B8F6E3BBE1B642403C7A2D809F1D54C0889E18EFC8B642402A862D804D1D54C054F716EFD0B642405E1BC819F51C54C0D8DDE2BBF9B6424092D493E68D1C54C020D4E4BB69B74240DCB3C619A11A54C0546DB28826BA4240164194E6D51254C00C55AF882EC14240349494E68B1254C010D97E55BFC14240787E94E6511254C064A87D557BC242409C81FA4C4C1254C03CDDB188DAC342403C0E62B38E1254C070F549226CC442408EDD60B34A1354C0DCCAE5BB31C542409EB794E6891354C08C8BE5BB99C54240A0F42D80B11354C0F8387D551FC642404C53C719C11354C0C88617EFB8C642408BBB94E6C11354C05C697E5557C7424092E6C619991354C0A05B4A2228C8424062602D804D1354C0D89AAF8806C942405A8494E6A51254C067317E5523CA4240FE7961B32A1254C0D4AE7D55BBCA424046CEC719BF1154C00422B18826CB424070ABFA4CB01054C03832E4BBF5CB424090D8C7195D0F54C00402B1884ECD4240FAF2FA4CC40E54C010EEB0882ACE42404C4EC7198B0E54C018714922C8CE4240985B94E6650E54C0A0994A2290CF4240BB81C719750E54C0A41DE4BBB9D042407FAF93E6A50E54C0F4DB17EF64D142408AE2C719EF0E54C028D1E2BBE1D14240784895E6C71054C048527D555FD34240D72F60B37A1154C0B42719EF24D442403855FB4C481254C09C6918EF5CD54240CEEBC719691254C0D88A4C22A4D54240BAA92D80771254C0E881B088EED54240C8EDC719851254C0E4D0B08866D64240E240C8193B1254C038B3B288B2D74240D8A060B3E60F54C044F517EFA4DE424056EA60B3160E54C0989319EF08E44240986394E6DB0D54C0088B4B22F0E442407C682E80570D54C0B4C84A22E4E74240D6B094E63D0D54C0B8E818EF4CE8424032CAFA4C840A54C0385B16EF38ED4240F0ED93E6450854C0EB9A17EF44F142408C6FC7198D0554C0200880552FF64240867594E6090254C0C04917EF84FC42401441C719FFFF53C028D44A2234004340DEC2C619E1FD53C00032B088BA064340A4EEC61961FC53C03F784B22580B4340D81994E6F1FA53C0E7527D5587124340007DFB4CDCFA53C02CE67E555B1343406075C71907FB53C01069B288A6144340112B61B304FB53C014187E55A7154340AC8294E6E1FA53C0F476E3BB511643403E462E80A9FA53C0C4C47D55EB164340F26A61B3AEF753C07C7EB188461B434060B6C61947F653C094D5E4BB111E434050B960B3A6F553C058C77D55F31E4340CABDC71939F453C0889B7D55732043409265FA4C24F353C09443E5BB3D224340EA17C719D9F253C0F335B1880E2343405831FB4CB0F253C02846E4BBDD23434011222E80B9F253C0DC6F4B22842443402A2794E6CFF253C080E7B188162543402ED7F94C14F353C02C414C22582643406E6294E629F353C02C87B0881A274340D6CBC71909F353C0F4047E554F284340362594E6B3F253C038A94A2234294340D0DDC71911F253C0D813B088862A4340046A61B3B6F153C0A03F7E55972B4340560462B374F153C0DC167D55C32C4340BD41C7193DF153C02C587F55732D4340C87CFB4CFCF053C0084218EFE42D4340EA52C819BBEF53C06882E3BBA12E4340FEC093E613EF53C0A85E7E554B2F4340567C61B3CAEE53C0B09317EFFC2F4340080E2D8027EE53C04CDB7D55CB334340A67FC719CBED53C010367E55EB34434074F1C619C1EC53C0A0C8B18816374340CCAC94E677EC53C0C8E44922E0374340EE332D8053EC53C0506D4C229838434025792D803FEC53C018D64B22F43D4340C87760B312EC53C078FAB188CA3F4340E1B9FA4C04EC53C098E5B0881A404340B65F2D80D3EA53C0EC1FE3BBC5424340F20E94E68DEA53C0DCDB4A22B4434340F54BC81969EA53C09C994B2270444340787B2D8067EA53C04063B18826454340DAB92E806FEA53C014514A22D04543402731C71965EA53C0A0C44B22D8464340929AFA4C44EA53C03F9B17EF14484340E7D9FA4CDCE953C088157D55474A4340DC95FB4C82E953C07871E3BB454B4340423DC71919E953C0F4307D55CF4B4340EEC62D80B3E853C0B88AB288CA4B43404AB193E659E353C0FF834A22A848434038032E8031E353C0707F17EF80484340FE04C719FFE253C097C916EF3448434063542E80CBE253C0BC504A22C4474340CACDFA4C4EE053C0A4C84A22A8404340980A2D8027E053C08C74E4BB19404340A42BFA4C20E053C0FCDB17EFDC3F43409CC32E8021E053C068FDB088763F4340DE3CC71933E053C0E0EF17EF003F434014E42D8077E053C00B057E55033E43404CF5FA4C8AE053C0E8D3E4BB893D4340C499C71975E053C0B06917EF6C3D434017BF60B346E053C04C477D55473D434035C994E649DD53C017444B22B83B4340BA1994E663DA53C05C2EE4BB353A43406A1294E605D753C0089E17EF743843404076FB4C08D353C0988116EF603643403AB62E808FD253C0A4704B22503643406E42C81935D253C0440E7E55A3364340F2B8C619EDD153C010167E5513374340B8FD2C80A7CF53C0B870B1880A3C4340AA4D60B31ACE53C03C45E4BB6D3F43406EE4C719F5CC53C07CC8AF88EE41434046E260B38ACC53C0D0E7E5BB15434340DCD92D802BCC53C0A8E74A225C444340886B94E63BCB53C0BC1D7D55C3484340F4EE93E62DCB53C0F8D24A2220494340D47861B316CB53C00C224B2298494340EA0AFB4C10CB53C00408E4BBD149434053C42D80F7CA53C0ECCEAF882E4A4340B6DE60B35ECA53C024077F55674E4340BCB993E62DCA53C0BC1119EF304F434030C8C619E7C953C05832E4BB21504340FC20FB4C56C953C04078E3BB91514340C24D61B3AEC853C0780FE5BB9D524340E4E5FA4C02C853C0403116EF6C534340E668C7190BC753C0200BE5BB5954434090CF60B390C653C044114C22FC54434070BA93E645C653C068474B228C5543403C59C7192BC653C01C9CE4BB09564340E629C7197FC553C0501DE5BB415D43402AC6C71959C553C0B00FB188125E4340C4482D800DC553C0C02F4922145F434082BEC719EFC353C0E07D16EF906143404CC761B3A2C353C007CF7D55736243405D1C62B374C353C05BB07E5533634340507FC7195DC353C04880B088DE634340764394E613C353C0F0D54A22E864434094C1C619A1C253C0103C7D5513664340B68461B3EABF53C0C0EE16EFD06B4340729960B398BF53C03CFCAF88466C4340DE1CFB4C3EBF53C07032E5BB3D6C4340682EC8195DBD53C0ACAAB0882E6A43404406C719A1BA53C0A0D24B2230674340968C94E65DB853C0A86617EFB46443401EF0C719E9B753C06CF7E3BB81644340EE4661B388B753C0D41119EFE4644340E20262B32EB753C0183B7C5587654340D8B1FA4C52B553C043134A22D06943400098C719FDB253C00C7C49222C6F434032CB94E603B153C0489F17EFB473434010A3FA4C90AF53C0686818EF0C774340462F94E635AF53C0346BB28866774340B2022E80E3AE53C097B87E5563774340144994E6ADAE53C020DF7D55137743400A422E807BAE53C0A842B1889E764340EAA82E804FAE53C05C594B221C76434098C82E801BAE53C09033E4BBAD7543405C21C819D7AD53C05372B188567543405A0F61B386AD53C078917E5533754340B64E61B31EAD53C0C0BA17EF3C754340A2C4C7199BAC53C070E8E3BB6D7543402AE1FA4C24AB53C05091E3BB79764340C05CFA4CA6AA53C068E54922087743404AE3FA4C46AA53C0FC987E5597774340E631C819D5A953C0FC887E55AB78434010322D8027A953C0A802B188EE7A43403C8C2E80C3A853C06FABB088FA7B4340F6502E8069A853C024004A22787C434004CAFA4CE0A753C0D0204B22D07C4340AE9AFA4C34A753C010014B22047D4340B474C7192BA653C0D0E97D55977D4340663261B39EA553C0ACA37E551B7E4340284E61B332A553C0C0F7E4BBA97E43408160C8198FA353C0646117EF00824340459694E635A353C017B7B1880A83434054B761B32EA353C048DCE5BB89834340A9C293E639A353C098427D5507844340EC442D804DA353C02044B188828443400EF893E63FA353C0C033E3BBF984434084D293E61FA353C0F4C9E3BB79854340DFA6C71911A253C0883FB18832884340764DC819899F53C03CB44B22F08C4340325FFA4CFA9C53C014F0B18816904340C0DA2D80E79A53C000367F5517944340420A2E80999A53C018DCE4BBC9944340C8CFC7197D9A53C057C54A224C9543409688C719759A53C0D436E5BBE9954340D64094E67D9A53C05C7816EF84964340CB882E80C39A53C0584FB0885E984340B8B760B3D29A53C00CEAE3BB05994340147C94E6D79A53C094EF17EFB8994340CB882E80C39A53C08065E5BB7D9A43405245C719A59A53C0F07BE4BB419B43409A992D80399A53C0972DE5BB499D434051A6C719259A53C0ECFCE3BB059E4340EE70C7191F9A53C0CB0D4A22C49E434060E160B3309A53C07CDD16EF1CA04340841095E6419A53C0804FE4BBA9A04340FE272E80499A53C0D0677C553BA143407E6094E6499A53C04C1BB188CAA143403ED5F94C349A53C0D36EE4BB69A243403AA161B30E9A53C03C7B17EF00A343406AF0C619D99953C050CF7D558FA34340554AFA4CDE9753C02CD0B188F2A743403C942D80F79653C020484B2268AA4340A4B7C619AD9653C098D017EFB8AB4340E1ACC719919653C090D518EF7CAC4340A6D12D80739653C0BF384C22FCAD434052E0C7197B9653C037C118EF4CAF4340103361B3DC9653C034C14B2224B34340021294E6E39653C09CE4B0886EB4434046AE94E6BD9653C053AB17EF78B5434066A894E6699653C064D54C22BCB643404CE9C619819553C057C617EFF4B84340CE56FA4C9E9453C0A8A718EFB4B94340FAFDF94C9A9353C0FCFA18EF70B8434088432E80FD8F53C09484E5BBE5B343402ED3C619618C53C0AC3D17EF58AF4340425161B3C48853C018747E55CBAA4340989F94E6278553C0B0FD4A2240A64340F4EDC7198B8153C038A57E55B3A143404A3CFB4CEE7D53C0C0BD7E55279D4340F0CB93E6517A53C04CD67E559B984340064A2E80B57653C0588FB0880E94434027E2C719097653C0F4C6B08836934340,-14.7%,-89,515,76,439,Virginia,true
41,,-11.0%,-18,146,109,37,Puerto Rico,false
51,0106000020E6100000180000000103000000010000000F000000126BBCCA33D45EC03066143D03134740960FD582A1D55EC0EC76235EE41247402B79EC2FE7D65EC058561E3A4313474036B268231FD85EC0B093D10DFC1347403AF0988462D95EC0B0F9529B9F154740B4C487954EDA5EC08C7ED00169164740A7D296A0EADA5EC0DC5ADA7BC117474014A864B711DB5EC0F4AF9C060A1847400AA0D384B1DA5EC008807C46381A4740541DD238ECD95EC0B0ED6335B81947404D60B607DBD85EC098CE03095E18474074D90AF56FD75EC028085B1CF0164740929EE5B653D65EC04C625BE34C154740E2924BC5C1D45EC03B1D91F4CB134740126BBCCA33D45EC03066143D031347400103000000010000000D0000008D8B999383FC5EC0A0264075753547401255DD28B4FD5EC0F0B5B6B61134474030D24DC061FE5EC02341B6DB57384740A871BE57DBFF5EC0B874DBEB083A474037D065C56BFF5EC0C80D38F2903C4740E645B7D561FF5EC07B8A5F62803E47400967277ECAFE5EC018B979E0AC3F474087F357F855FE5EC077932652183F474088F8B44128FE5EC0B4D6AE480D3E4740D818E573B0FD5EC0F0A3C385743D4740B96D01FCAEFC5EC0986430956A3B4740574030939DFC5EC09C29B6546E3947408D8B999383FC5EC0A02640757535474001030000000100000013000000B044277EDEAC5EC0A85ECF35DE8F4740ACF97BD33BAD5EC0A85ECF35DE8F4740F9FF267EC6AD5EC0DC48258B6790474049947CD351AE5EC0284FD035F2904740914F7CD339AF5EC060BF248B37924740C1607CD37FAF5EC0C82CD03566924740E2E3D128C5AF5EC028B979E0AC934740914F7CD339AF5EC05BA3CF35369447403CBB267EAEAE5EC0B8C5CF35C294474049947CD351AE5EC0E019CF3506964740745AD128F5AD5EC0A85ECF351E974740E1E3D12825AD5EC0D893D0354A974740C1607CD3DFAB5EC0A85ECF351E9747409E28D2283DAB5EC04C3CCF359296474078A57CD3F7AA5EC0AC5ECF351E9547403EBB267E0EAB5EC0680AD035DA934740745AD12855AB5EC098427AE0DC914740E1E3D12825AC5EC044B6D03596904740B044277EDEAC5EC0A85ECF35DE8F47400103000000010000001C000000E0E3D12805B75EC0888D258BBF964740299FD128EDB75EC070557BE07C954740FB4AD22849B85EC0E019CF350696474076A57CD377B85EC0A85ECF351E974740735AD128D5B85EC07871D035BE984740C3AB277E02B95EC0C82CD035A69947406689277E76B95EC074557BE0BC9A4740AE44277E5EBA5EC0B8C5CF35029C4740D17CD12801BB5EC0E019CF35469D4740D17CD12801BB5EC098427AE05C9E4740299FD1288DBA5EC05CA3CF35B6A04740AE44277E5EBA5EC0E019CF3586A247400D67277EEAB95EC0A85ECF359EA34740C3AB277E02B95EC0A85ECF359EA3474076A57CD377B85EC040B6D03556A44740D27CD12861B75EC02804258B0FA547402B9FD128EDB65EC03CD5CE356EA54740623E7CD333B65EC0C82CD03526A647403E06D22891B65EC0EC19CF3586A4474088C1D12879B75EC0A85ECF359EA347402EEA7CD38FB75EC053D2258B57A247402EEA7CD38FB75EC05CA3CF35B6A04740F8FF267EA6B75EC040B6D035169F47402B9FD128EDB65EC0D0B2CE35A29D47400D67277E4AB65EC01017268B2F9C47400D67277E4AB65EC00CE8CF358E9A47400D67277E4AB65EC07871D035BE984740E0E3D12805B75EC0888D258BBF9647400103000000010000002C000000FB4AD228099B5EC0607479E054B44740AC44277EFE995EC08471D0353EB347400B67277ECA985EC03CD5CE356EB24740914F7CD379975EC04BD2258B17B14740715AD128F5975EC018E8CF350EB147409C28D228BD9A5EC054A3CF3576AF4740E0E3D128C59C5EC0C0C5CF3582AC4740051C7CD3079E5EC013E8CF350EAB4740DA0A7CD3619E5EC08771D035BEAC47405422277E529E5EC0304FD03572AE474084C1D128D99D5EC0E4FD79E0C4AF47403C06D228F19C5EC0F8CB7AE04CB04740362D7CD34D9C5EC050A3CF35F6B04740F5FF267E269C5EC00036248B47B247404D947CD3919C5EC0F019CF3546B34740C4AB277EA29D5EC00781CF35EAB24740FC4AD228299D5EC008CC7AE00CB247400A67277E6A9E5EC063A3CF3536B147403D06D228119F5EC0A85ECF359EB047407AA57CD3579F5EC093427AE0DCAF4740C0607CD35F9F5EC0DC93D0354AAD4740BD607CD37F9F5EC010E8CF350EAC4740061C7CD3C79F5EC013E8CF350EAB474076A57CD337A05EC00817268B6FAA47401E837CD3ABA05EC0C0C5CF3582AA47401D837CD32BA15EC02BB979E02CAB4740B244277EBEA15EC0483CCF3552AC4740D2C77CD303A25EC00C17268BAFAD4740D2C77CD3C3A15EC0DF48258BE7AE474088C1D12859A15EC020B979E0ECAF4740DD0A7CD321A15EC0284FD035B2B04740071C7CD3A7A05EC048D2258B57BA4740CC7CD12841A05EC044B6D035D6BB47401C837CD34B9F5EC00036248BC7BD4740E3E3D128259E5EC05BA3CF3576BF4740FC4AD228299D5EC088427AE01CC047405522277E929D5EC014E8CF354EBE474006D97CD3499D5EC04FA3CF3576BD474061FB7CD3B59C5EC0700AD035DABC4740B044277E3E9C5EC07B71D035BEBB47409DDD267E1A9C5EC0D42CD03566BA4740F94AD228099C5EC0E893D035CAB7474086C1D128D99B5EC07871D0357EB64740FB4AD228099B5EC0607479E054B447400103000000010000002400000030EA7CD3AF9F5EC0988D258BFFCC47404C947CD3919F5EC02704258B0FCC4740EE717CD3459F5EC05FBF248B77CB4740AF44277EBE9E5EC0985ECF351ECB4740EE717CD3459F5EC00C81CF356ACA474018837CD3EB9F5EC0A75ECF351EC9474060FB7CD355A15EC060BF248B77C9474062FB7CD3B5A25EC090F7CE353ACC474032EA7CD3AFA35EC0F835248B87CC4740D5C77CD383A45EC000CC7AE04CCC4740AFF97BD3FBA45EC0988D258BFFCC4740613E7CD373A45EC0A45ECF351ECF4740745AD12855A45EC040B6D03596D04740F6FF267EC6A45EC0C02CD035A6D147405422277E12A55EC0F435248B07D34740FAFF267E26A55EC094427AE0DCD447402C9FD1280DA55EC028D5CE35AED5474060FB7CD3F5A35EC0C0C5CF35C2D747406989277EB6A35EC00BE8CF350ED94740EF717CD3C5A35EC098427AE05CDA47405222277EB2A35EC0A85ECF355EDB47403F06D22811A35EC0DF19CF35C6DB474004D97CD369A25EC07871D0357EDB47405322277EB2A15EC0EB93D035CADA4740603E7CD313A15EC0D048258BE7D94740653E7CD3B3A05EC0533CCF3512D94740C0607CD35FA05EC0CF2CD035E6D44740954F7CD3F99F5EC0F435248B07D34740914F7CD3599F5EC0607479E014D24740C1607CD3DF9F5EC0700AD0351AD147405DFB7CD335A05EC0B4107BE0A4D04740653E7CD3B3A05EC0687479E054D04740C3AB277E02A05EC0D0FD79E044CF474004D97CD309A05EC00BCC7AE04CCE4740392D7CD3CD9F5EC060A3CF35B6CD474030EA7CD3AF9F5EC0988D258BFFCC4740010300000001000000160000005CFB7CD355AB5EC088F7CE353A0648405DFB7CD315AB5EC0E493D0350A034840A8B67CD39DAB5EC02CD5CE35EE00484033EA7CD3CFAC5EC07771D035FE0048402D9FD128EDAD5EC0344FD035F2024840E1E3D128C5AE5EC034D5CE356E054840F4FF267E26AF5EC0D8B2CE35220748400B67277E6AAF5EC0DCFD79E0840948400867277E4AAF5EC02804258B8F0A48402B9FD128ADAE5EC0A77A248B9F0A4840F0717CD345AE5EC0C0C5CF35C2094840964F7CD319AE5EC0B0C5CF350207484078A57CD3D7AD5EC037D5CE352E0648402E9FD128EDAC5EC0F8CB7AE04C064840061C7CD3E7AC5EC07871D0353E0848404006D22891AD5EC050877AE0B40A48402B9FD128ADAE5EC0D8B2CE35620C4840C3AB277E02AE5EC044B6D035160D4840D0C77CD363AD5EC044B6D035160D4840BF607CD3DFAC5EC08871D0357E0C48405EFB7CD3F5AB5EC0B07A248B5F0948405CFB7CD355AB5EC088F7CE353A06484001030000000100000060000000FB4AD22889A55EC0E819CF350632484001D97CD369A55EC0543CCF3512314840342D7CD34DA55EC034D5CE35AE3048403DBB267E0EA55EC0F019CF354630484088C1D128F9A45EC0D848258BA72D4840F2717CD305A15EC050A3CF3536294840BF607CD31FA15EC0E0B2CE35A2254840934F7CD3F9A15EC0607479E05424484079A57CD3F7A25EC0D8FD79E004244840904F7CD3F9A35EC0DFB2CE35A2244840AAF97BD3DBA45EC0740AD0351A264840D4C77CD303A65EC0F880CF356A274840944F7CD3F9A65EC0EB93D0354A264840633E7CD3B3A75EC038B6D03516244840051C7CD327A85EC064A3CF35362248400867277E0AA95EC09C427AE0DC244840E4E3D12865A95EC02C4FD035F2234840D70A7CD381A95EC0A85ECF359E21484031EA7CD3AFA95EC08071D035FE1F4840AB44277E9EAA5EC08F8D258BFF1E48404106D22851AE5EC024B979E0EC1D48404D947CD371AD5EC048D2258B571C48402A9FD1288DAC5EC03CD5CE352E1C48402DEA7CD38FAA5EC090F7CE35FA1C484089C1D128B9A95EC03CD5CE35AE1C48406389277E36A85EC027D5CE356E1B4840AAF97BD37BA75EC0BF107BE0241B4840A028D2281DA65EC0EB93D0354A1A4840F94AD22829A55EC0A87A248B1F1848401C837CD38BA45EC00036248B47154840D07CD128C1A35EC00036248B870F4840B144277E7EA35EC040877AE074084840A9F97BD3FBA25EC030D5CE352E024840F0717CD345A25EC0B0C5CF35C2004840FE4AD22869A15EC00436248B87014840071C7CD3A7A05EC0C0C5CF35820448406589277E76A15EC007E8CF354E07484001D97CD389A15EC0F880CF352A0A4840EF717CD3E5A05EC0985ECF359E0B48402DEA7CD38F9F5EC02F4FD035320A4840F5FF267E869E5EC0700AD0355A0848404206D228719D5EC054D2258BD7064840D2C77CD363985EC0F019CF3506024840E3E3D12865975EC047877AE0F4FF4740C0607CD3FF965EC0BBC5CF3502FD47403C06D22871965EC0908D258BFFFA47404A947CD331965EC028B979E0ACF94740A6B67CD35D965EC0607479E014F94740A9F97BD3BB965EC0403CCF3592F8474002D97CD3E9975EC0E048258BA7F5474087C1D12839985EC0707479E014F547404206D22871985EC0244FD03532F44740BD607CD3BF985EC06C7479E0D4F34740F8FF267E26995EC0770AD035DAF34740C5AB277E42995EC0F419CF3586F44740735AD12855995EC02804258B4FF54740C0607CD39F995EC0E048258BA7F54740F9FF267E069B5EC0EF35248BC7F44740A6B67CD3DD9B5EC0D893D0358AF44740B044277E3E9C5EC030D5CE352EF54740BE607CD35F9C5EC024B979E0ECF74740071C7CD3C79C5EC01804258BCFFA47408AC1D128799D5EC0F880CF352AFD474077A57CD3779E5EC0403CCF3552FE4740D5C77CD3439F5EC048D2258B17FE4740643E7CD373A05EC0E0FD79E044FC4740DD0A7CD321A15EC00817268BAFFB47403D06D228F1A15EC04F3CCF35D2FB4740C2AB277E82A25EC00017268B6FFC4740663E7CD313A35EC00017268B6FFD474079A57CD3F7A35EC0DCB2CE3562FE4740DA0A7CD321A55EC0B47A248B9F00484086C1D128F9A55EC09C8D258B3F034840F0717CD3E5A55EC0DFB2CE3562054840F9FF267E06A75EC07871D035BE0748408F4F7CD359A75EC038B6D03596094840F74AD22869A65EC0D048258BA71048409F28D228DDA65EC02CD5CE35AE134840AE44277EDEA75EC0E048258BE7144840AAB67CD33DA95EC0F880CF35AA144840051C7CD3C7AA5EC0F419CF3546134840A9B67CD35DAC5EC0483CCF3512174840FA4AD228C9AC5EC0D42CD035A61748405522277E72AD5EC02C4FD035F21748403FBB267E4EAE5EC00081CF35AA1848409E28D2281DAF5EC008E8CF358E194840BD607CD39FAF5EC0780AD0355A1A4840A4B67CD35DB05EC0C4107BE0641D4840643E7CD313B05EC08071D035FE1F4840051C7CD3C7AA5EC0204FD035722E4840E0E3D12805AA5EC0E093D0354A314840BE607CD35FA85EC070557BE03C31484075A57CD377A75EC0A85ECF35DE314840BC607CD3BFA65EC0888D258BFF324840D07CD12821A65EC0284FD03572334840FB4AD22889A55EC0E819CF350632484001030000000100000014000000F6FF267E66B45EC0D09679E0A03D4840ABF97BD37BB45EC0D893D0358A3D48406BCC267EB4B45EC0E448258BA73D4840A128D2287DB45EC0DC777BE0483F4840C6AB277EA2B45EC018337BE0F03F4840DD0A7CD3E1B45EC050A3CF3536404840B6D2D1281FB55EC098F7CE35BA4048403A2D7CD3ADB55EC018B979E06C414840FD4AD228A9B55EC038B6D035D641484018837CD34BB55EC090F7CE357A4248405422277EB2B45EC0CF48258B27434840C0AB277EA2B25EC0D0777BE008434840FB4AD228C9B25EC0189D248BAB424840F84AD228E9B25EC0E3B2CE35E2414840D17CD128A1B25EC0A413248B7B41484077A57CD377B25EC0E7647AE0684148409BDD267E9AB25EC0344FD035F2404840D07CD12861B35EC0A0A97AE0403F4840A128D2283DB45EC020337BE0303E4840F6FF267E66B45EC0D09679E0A03D48400103000000010000001B000000ACF97BD35BB65EC03CB6D035163B4840F1717CD385B55EC0B07A248BDF3A48400B67277E8AB45EC08871D0357E3C4840ACF97BD3BBB35EC0C72CD035A63A48407AA57CD397B35EC06C7479E09438484001D97CD309B45EC02C4FD035B2364840914F7CD3F9B45EC018B979E06C354840653E7CD3F3B85EC0E893D0354A3648400B67277E8AB85EC0B0C5CF3582384840D3C77CD383B95EC06F7479E05439484074A57CD3F7BA5EC087F7CE35BA394840D90A7CD301BC5EC0F780CF35AA3A48405522277E52BC5EC0C02CD035E63C484079A57CD3F7BB5EC0E0B2CE35223F48403D06D22831BB5EC0F880CF35EA404840C3AB277E42BA5EC07C557BE0BC414840D6C77CD3A3BA5EC010E8CF350E4348402DEA7CD3AFBA5EC008E8CF354E444840ED717CD365BA5EC054D2258B57454840C3AB277E42BA5EC0DF19CF3506464840ED717CD3C5B85EC0C82CD03526484840D17CD12821B85EC03CD5CE356E4848406589277E16B75EC04C3CCF351245484098DD267EFAB65EC098F7CE35BA42484002D97CD329B75EC0E0B2CE35A23E48404006D228F1B65EC0E819CF35863C4840ACF97BD35BB65EC03CB6D035163B484001030000000100000010000000ED717CD305A55EC0B87A248B1F454840643E7CD313A55EC0F7647AE02844484048947CD371A55EC03F3CCF3512444840FC4AD22809A65EC038D5CE35AE44484032EA7CD38FA65EC068EE7AE0984448405422277EF2A75EC0A8A97AE0C04348404A49D1282FA95EC044207AE0D04348400A1C7CD3E7A95EC03C207AE090454840DB55277EA4A95EC0975ECF359E484840745AD128D5A95EC0E448258B274948402FEA7CD3CFA95EC0C0E1248B434A48400767277E8AA95EC070557BE03C4B4840765AD12815A95EC08771D035FE4A484087C1D12819A85EC02804258B0F49484086C1D12839A55EC078DB79E038464840ED717CD305A55EC0B87A248B1F454840010300000001000000210000008133277E38BC5EC0A013248B3B4A484062FB7CD3F5BB5EC02F4FD035B24948408AC1D128B9BB5EC0BF2CD035E6494840735AD128B5BB5EC068BF248B774A4840AAF97BD37BBB5EC010E8CF35CE4A48405022277E12BB5EC028B979E0EC4A4840F1717CD385BA5EC040D2258BD74A48404849D1284FBA5EC028B979E0EC494840C7EE267EA0BA5EC090F7CE35BA484840745AD128F5BA5EC05058248B53484840FD4AD22829BB5EC028D5CE352E4848400B67277E6ABB5EC088427AE01C4848405622277ED2BB5EC028D5CE352E484840C4AB277E22BC5EC018E8CF350E4848409CDD267E5ABC5EC07871D035BE47484059B0D12873BC5EC014E8CF354E474840C1AB277E82BC5EC0E893D0358A464840091C7CD3E7BC5EC06C7479E0144648402411277E0CBF5EC0F8AF258B0B4748403778277E30BF5EC07871D035BE47484019837CD3EBBE5EC010337BE0F047484087C1D128F9BE5EC040B6D035564848403DBB267EAEBF5EC070BF248BB74948403E06D228F1BF5EC00C17268BEF494840745AD128B5C05EC0A77A248B1F4A4840C3AB277E02C15EC0D893D0358A4A48402611277EECC05EC0D893D0350A4B484010AA267E28C05EC05F58248B134B4840633E7CD313BE5EC0C49679E0204C484048947CD371BD5EC09813248B7B4B4840A7B67CD33DBC5EC0CF2CD035264B48402B9FD1282DBC5EC0D7B2CE35E24A48408133277E38BC5EC0A013248B3B4A48400103000000010000001100000017837CD36BAC5EC04C3CCF3592454840AE44277EFEAC5EC094427AE05C45484074A57CD3B7AD5EC0A45ECF355E454840D3C77CD343AE5EC0F780CF352A4648401C837CD32BAF5EC0BB7A248BDF4948403F06D22811AF5EC0503CCF35924B4840D1C77CD383AE5EC07871D035FE4C48400967277ECAAD5EC0503CCF35924D4840ACF97BD3FBAC5EC0780AD035DA4C48404A947CD391AC5EC02C04258BCF4B4840F0717CD365AC5EC0988D258BFF4A484019837CD36BAB5EC0607479E05449484019837CD32BAB5EC010E8CF35CE48484086C1D12879AB5EC0BFC5CF3542484840EF717CD3E5AB5EC0E493D0354A474840FB4AD22809AC5EC0D0FD79E00446484017837CD36BAC5EC04C3CCF35924548400103000000010000002B000000CD7CD12881BF5EC07C557BE0BC414840F7FF267E26C05EC02BB979E02C4148402C9FD128ADC05EC068557BE07C41484030EA7CD30FC15EC064A3CF35764148400967277E4AC15EC0F880CF35EA3F4840603E7CD313C15EC0503CCF35923F48404D947CD3F1BF5EC08871D0357E3C48404C947CD371BF5EC090427AE0DC3B4840071C7CD3E7BE5EC04FD2258B573B4840DC0A7CD3C1BD5EC0F780CF35AA3A4840DC0A7CD3C1BD5EC0D893D035CA394840299FD128ADBE5EC00081CF356A3A4840C1AB277E62BF5EC0700AD0355A3A484098DD267E1AC05EC0908D258BFF394840372D7CD30DC15EC0D893D035CA3948401C837CD3EBC15EC03CB6D035163A484060FB7CD375C25EC014E8CF35CE3A4840F1717CD3E5C25EC0344FD035B23B484030EA7CD36FC35EC08871D0357E3C484031EA7CD32FC45EC0948D258B3F3D4840CE7CD12881C45EC04C877AE0743D4840A028D228DDC55EC0E093D0354A3D484049947CD391C65EC08CF7CE357A3D48405422277E72C75EC088F7CE35FA3D4840289FD1284DC85EC01017268BAF3E48400A67277EEAC85EC068BF248B773F48401E837CD38BC95EC060BF248BB7404840C3AB277EE2C95EC03CD5CE35AE414840F94AD228A9CA5EC04C3CCF3592454840D90A7CD321CB5EC0BF2CD03566494840E2E3D12825CB5EC0D793D0350A4A4840A028D2285DCB5EC0D02CD035A64C4840D3C77CD323CA5EC00B81CF35AA4E4840D2C77CD343C85EC0985ECF355E4F4840F94AD22889C65EC074BF248BF74D4840CD7CD12801C65EC07871D0357E4C4840081C7CD3E7C45EC0B0C5CF35C24A48405122277EB2C35EC0607479E0544948405F3E7CD393C15EC0E893D0350A484840F9FF267E46C05EC00CCC7AE00C4548404B947CD391BE5EC0B0C5CF350244484077A57CD3B7BE5EC06BBF248B37434840CD7CD12881BF5EC07C557BE0BC4148400103000000010000000800000004D97CD389AA5EC0C72CD035E64E484099DD267E7AAA5EC0CCE1248BC34D4840091C7CD3A7AB5EC018B979E06C4E48404849D128CFAC5EC0C7E1248BC34F4840924F7CD359AC5EC0D0777BE008504840CAEE267E20AB5EC06CBF248B37504840DC0A7CD3C1AA5EC0A8A97AE0C04F484004D97CD389AA5EC0C72CD035E64E48400103000000010000000D0000001C837CD3EBC65EC01804258B4F5148403D06D228F1C65EC018337BE030514840D955277E04C95EC0189D248BAB514840BB607CD39FC95EC058A3CF3536524840B6D2D1287FCA5EC078DB79E0B85248405122277E72CA5EC068BF248B37534840A7B67CD3BDC95EC0A0A97AE000534840E3E3D12865C95EC0D793D035CA5248406BCC267E74C85EC0B0F4258B63524840A8B67CD3BDC75EC08826258B1B524840091C7CD347C75EC0189D248BAB5148405FFB7CD315C75EC04C3CCF35925148401C837CD3EBC65EC01804258B4F51484001030000000100000015000000FD4AD22869CC5EC0F835248B87564840A36BD128FBCB5EC08BF7CE357A5648400FAA267E68CB5EC0C0107BE0245748400FAA267E28CB5EC0747479E0145748404749D128EFCA5EC0406B258BB35648404449D128CFCA5EC0B3F4258B23564840FC8DD12807CB5EC0687479E094554840ACF97BD37BCB5EC0687479E0945548400E67277E2ACC5EC043207AE010564840061C7CD3A7CC5EC0A77A248B1F564840D4C77CD383CC5EC043D2258BD75548406E17D228F7CB5EC0A813248B7B5548400CAA267EC8CB5EC010E8CF35CE544840D855277E24CC5EC050A3CF35765448406CCC267E14CF5EC008E8CF350E574840352D7CD34DCF5EC0DC48258BE75748403EBB267ECECE5EC0CC2CD03566584840091C7CD3C7CD5EC0D02CD035265848407017D22857CD5EC0D8FD79E08457484074A57CD337CD5EC0E048258B27574840FD4AD22869CC5EC0F835248B8756484001030000000100000030000000F9FF267EE6B65EC050A3CF35B65A4840AAF97BD3BBAF5EC0E793D0350A5548403EBB267E0EB05EC014E8CF35CE5348406A89277E76B05EC048877AE0345348409CDD267E3AB35EC040D2258B975048409D28D2287DB35EC038B6D035D64F48401B837CD38BB35EC060A3CF35F64E4840F2717CD3C5B35EC08C71D0353E4E48400B67277E8AB45EC074BF248BF74D48403E06D22831B55EC018B979E06C4E484086C1D128D9B55EC090F7CE357A4F48400A67277E6AB75EC0C82CD035265348402CEA7CD34FB85EC034D5CE35AE56484087C1D12879B85EC01704258B0F584840CD7CD128C1B85EC0B07A248B1F594840A7B67CD35DB95EC0503CCF35925948409CDD267EFAB95EC0B0C5CF3542594840C3AB277E42BA5EC01704258B0F584840FC4AD22829BA5EC0D42CD035A6564840A4B67CD3FDB95EC0C02CD035E65548405CFB7CD3F5B95EC0C0C5CF3542554840C3AB277E42BA5EC0F880CF352A54484002D97CD329B75EC0E0FD79E0044D48405EFB7CD3F5B75EC0888D258BFF4B48402C9FD128CDB85EC0E3FD79E0844B48405322277EB2BA5EC0780AD0355A4B4840AAF97BD3BBBB5EC0B87A248BDF4B4840C0607CD33FBC5EC0D0B2CE35224D4840FD4AD22889BC5EC0700AD0359A4E4840DB0A7CD3E1BC5EC0FCCB7AE0CC4F48409EDD267EFABD5EC088F7CE353A514840954F7CD3B9BE5EC07B71D035BE5148404A947CD311BF5EC0F035248B07514840B144277E1EBF5EC0E819CF35464F484061FB7CD355BF5EC0B8107BE0644D484032EA7CD3CFBF5EC00817268B6F4C4840A6B67CD39DC05EC07871D0357E4D48401C837CD36BC15EC0D048258B274F48405322277EB2C15EC02C4FD035325048402CEA7CD3AFC15EC070BF248B775148406689277E56C15EC067557BE03C5248404306D228D1BF5EC017E8CF358E544840FA4AD22849BF5EC0E793D0350A554840623E7CD393BE5EC098F7CE357A554840914F7CD379BB5EC03CD5CE35AE5A4840C3607CD3BFBA5EC02004258B0F5B4840C2AB277E62B95EC0D048258B275B4840F9FF267EE6B65EC050A3CF35B65A48400103000000010000000E0000006889277E16A75EC027D5CE35EE5A48402711277E2CA75EC00436248B07594840934F7CD3B9A75EC00436248B87584840E1E3D12845A95EC00017268B2F5A484076A57CD3D7A95EC0089D248BEB5A48404E947CD351A95EC0CCE1248BC35A4840FF8DD12887A85EC0D848258BE75A4840A9B67CD33DA85EC0443CCF35925A4840F2717CD3C5A75EC02404258B8F5A4840A8F97BD39BA75EC0CCE1248BC35A4840C3AB277EC2A75EC0483CCF35D25B4840715AD128D5A75EC0CC9679E0205C4840A06BD1285BA75EC0A0F4258BA35B48406889277E16A75EC027D5CE35EE5A48400103000000010000000E0000005122277ED2C05EC0D4E1248B03584840C3AB277E62C25EC0C4107BE0A45648402311277EACC25EC08C26258BDB564840E1E3D128C5C25EC0908D258BBF58484089C1D128F9C25EC057A3CF35F65848406889277E36C45EC0D02CD035A65948402C9FD128CDC35EC05758248B535A4840A06BD128FBC25EC0306B258B335B4840031C7CD3A7C25EC0B8C5CF35C25B48404549D128EFC05EC088427AE05C5C4840BF607CD39FC05EC097F7CE35BA5B484002D97CD389C05EC0B0C5CF3542594840FA4AD22889C05EC0B37A248B9F5848405122277ED2C05EC0D4E1248B0358484001030000000100000013000000A4B67CD33DA75EC08F8D258BFF5248405CFB7CD3B5A75EC027D5CE35AE524840289FD1288DA85EC00081CF356A534840382D7CD3EDA95EC038B6D03516554840DA0A7CD361AA5EC0FFCB7AE0CC554840ADF97BD37BAB5EC044B6D03516584840BC607CD3FFAC5EC090427AE09C5A4840A8F97BD3DBAD5EC000CC7AE08C5B484088C1D12819AE5EC0D893D035CA5C4840E3E3D128C5AD5EC0770AD0359A5E4840653E7CD3B3AC5EC0EC93D0350A5E484078A57CD3F7AA5EC060BF248B375A4840D3C77CD363AA5EC018E8CF354E59484041BB267E6EA95EC0FC80CF356A584840F4FF267EA6A85EC058A3CF357657484074A57CD337A85EC00481CF35AA564840E2E3D128C5A75EC0473CCF3592554840DE0A7CD361A75EC014E8CF354E544840A4B67CD33DA75EC08F8D258BFF52484001030000000100000019000000F7FF267E26B95EC09FF4258B63624840C6EE267E80B85EC0985ECF359E6148401B837CD34BB95EC09FF4258BE3614840A8B67CD3DDB95EC08026258BDB614840CE39D22863BA5EC0D0B2CE35626148404206D228D1B95EC004CC7AE0CC6048404949D1288FB95EC07C557BE0FC604840C5EE267EC0B85EC0C89679E0A05F4840F9FF267E86B95EC014E8CF35CE5F4840AF44277EDEB95EC0D0E1248B43604840091C7CD307BA5EC0E393D0354A6048407017D228D7B95EC088DB79E0F85F4840944F7CD3F9B95EC088F7CE35BA5F48402C9FD1286DBA5EC0EB19CF3506604840E6E3D128A5BA5EC084DB79E038604840D3C77CD383BA5EC08026258B5B6048402211277ECCBA5EC0344FD035B2604840F84AD22809BB5EC050A3CF357661484087C1D128D9BA5EC0988D258B7F6148407C33277EB8BA5EC0B8C5CF358261484085C1D128B9BA5EC020337BE0B06148405322277EF2BA5EC090427AE0DC614840FF8DD128E7BA5EC034B6D0355662484049947CD311BA5EC0F4647AE0A8624840F7FF267E26B95EC09FF4258B63624840010300000001000000090000006A2B932F42C25EC0FC3E78B70A7F4840C1AB277E42C25EC0E493D0350A7F4840F1717CD3E5C25EC0888D258BFF7D484000D97CD3A9C55EC0284FD035727C484076A57CD3B7C55EC058A3CF35767E48400B67277ECAC55EC0E493D0350A7F4840BF45E28ECAC55EC07C1B78B70A7F48404A5A8C7542C25EC0B81578B70A7F48406A2B932F42C25EC0FC3E78B70A7F4840010300000001000000500400000A5B9B5A31B05EC030175FBA0A7F484057B7B6FACEA95EC0B81578B70A7F48409F01A569BC9B5EC0B81578B70A7F48402AB6F344AA8D5EC0B81578B70A7F484003DBC0D1997F5EC0B81578B70A7F4840433ECE8588715EC0B81578B70A7F48407FA1DB3977635EC0B81578B70A7F484061AD898165555EC0B81578B70A7F4840A610973554475EC0B81578B70A7F4840C586A5E942395EC0B81578B70A7F48409DAB7276322B5EC0B81578B70A7F4840DD0E802A211D5EC0B81578B70A7F4840BF1A2E720F0F5EC0B81578B70A7F4840037E3B26FE005EC0B81578B70A7F484041E148DAECF25DC0B81578B70A7F484023EDF621DBE45DC0B81578B70A7F484005F9A469C9D65DC0B81578B70A7F4840EF0453B1B7C85DC0B81578B70A7F484023817FAAA7BA5DC0B81578B70A7F484061E48C5E96AC5DC0B81578B70A7F4840815A9B12859E5DC0B81578B70A7F4840BFBDA8C673905DC0B81578B70A7F4840A7C9560E62825DC0B81578B70A7F4840E52C64C250745DC0B81578B70A7F4840BE51314F40665DC0B81578B70A7F4840FEB43E032F585DC0B81578B70A7F484082698DDE1C4A5DC0B81578B70A7F4840CBC1521171425DC0973378B70A7F484056412E8063425DC0441F17EFCC6A4840816561B356425DC05C5F7D558356484031512E8049425DC0709FE3BB39424840D33CFB4C3C425DC0F83E18EFF02D4840AEA1999961425DC0472C369C281B4840B047C8ACBF425DC090F5DFCF04074840B047C8ACBF425DC01F1E5CDF50F24740B047C8ACBF425DC04C3CFBEB5BDE4740B047C8ACBF425DC0083C439D30C9474031AB23CDA7425DC0A816BCE7CAB5474031AB23CDA7425DC0A7BBA778B7A0474031AB23CDA7425DC073F438E9BB8B4740B10E7FED8F425DC020CFB13356784740B10E7FED8F425DC08F7E7AC78362474031AB23CDA7425DC090EA1C99404D4740B10E7FED8F425DC0DC4826623A3A47403272DA0D78425DC0E42032B14F364740BDB3C71991425DC07C114B22C03247405D372E80D1425DC0FC9DE4BB7130474024FA2D805B425DC0D06E7F557F2E474042A260B3523F5DC0B042B088FA28474017DD61B32E3D5DC008D7B188F223474059E2C7194B3C5DC010F6B0883E21474025662E80913B5DC0006616EFF81A4740ADA52E802F3A5DC0D0F7B0887A174740743D61B32E3A5DC0F30A4B22CC14474045112E80C53A5DC0EC6A7E552B1247401D4561B3983B5DC0E0D418EF641047404DD4C7197B3D5DC0906117EF680D4740C830FA4C203D5DC0D0AFB1880E0C4740216EC719BF395DC0A88318EFF0054740616161B33E385DC06C1E4B2230004740A66F61B3EE405DC0D06B17EF2C004740167661B32E495DC05CB9E3BB290047404D1494E66D515DC02084E5BB25004740F77960B3AC595DC02472E3BB21004740D7D62D80EB615DC07B4EE3BB1D004740C2A4C7192B6A5DC0688AB1881A0047402A3AFB4C6A725DC0C066B18816004740DB9FC719A97A5DC020D2E4BB11004740BBFC94E6E7825DC0A01FB1880E00474072D32D80278B5DC0685B7F550B004740A47160B366935DC068497D55070047400C0794E6A59B5DC0D8B4B08802004740662BFB4CE4A35DC0A0F07E55FFFF464096C92D8023AC5DC0203E4B22FCFF46408697C71963B45DC0F849B088F6FF464066F494E6A1BC5DC0D814B288F2FF46404F9A61B396BF5DC058D34A22F0FF46407BD060B326C05DC058D34A22F0FF4640344994E6D9C25DC0387A4B2274FB46402DA6C719F9C55DC0BC9E7E5573F946403E86FA4CD8D55DC0187E7D551BF9464057A2C71975DB5DC03CA4E4BB95F746405AE393E6B1DE5DC09494E4BBB5F6464090EFF94C20E35DC0604AE5BB01F74640F4DFC719D1E45DC02F9A7D55BBF646408229FB4CDEE55DC054664A22E8F54640B85F61B3B6E75DC088CC7F55A3F24640A5BD93E665EA5DC06B2A4C2298EF4640F9F494E6C9FB5DC05076B18842EB46405DCAC71925055EC020F77C55BBE546404C3A61B324085EC0EB0917EF00E5464085B5FB4C4E095EC04F67E3BBE9E34640C5CFFA4C440B5EC0E4274B2228E1464015CC2D80EF0C5EC078377D5577DF46408FC161B3B60E5EC0383C4B2258DE464047B5FA4CB40F5EC038EA4B2234DE4640F97CC71997115EC0C01AB288BEDE4640CD7CC71991125EC08802E4BBC5DE46402AACC7193D135EC058D54A2284DE4640F170FA4CC0155EC0903C4B2264DC4640500162B334175EC024E517EF8CDB46401D98FA4CF0175EC02F04E5BB69DB46408067C7193D1B5EC0D701E3BB45DC46401183C719CB1B5EC0AC864A2218DC4640A66BFA4C581D5EC080D218EF00DB464035ACC719171E5EC0634AE4BBE5DA4640BA0794E6BD275EC0944F18EF8CDD464009C6C71969285EC01099E4BB51DD46408D09FB4C1C2A5EC0407E17EFB8DB464075F393E68D2A5EC0FF7EAF88FADA4640388361B3CA2A5EC0D78D492208DA464004E793E6CD2D5EC0B0447D554FD8464010F293E65D325EC010DA17EFFCD646404FA961B3D6325EC0B8D64A22B4D64640BF0BC719AD355EC0AC357D5587D346401EE261B302365EC028314A2260D3464040B0FA4CE0365EC0878BB2884AD346402B702E809B395EC0300DB28826D24640508F2E80553C5EC0E3614B22A4D24640D7E2C619413D5EC0D07F7C553BD34640B5A32D80F73D5EC034C07D555FD3464061E0C61913405EC007984A2234D34640255D2E806F405EC0D0024B2240D346407EDC2D8023415EC0270618EF88D346407214C8197D425EC0487C4A22A0D346400C412E80CF425EC070A07D5593D34640B991C61981485EC090044C22E4CF46409790C719EB495EC07F2A18EFA4CF464084B8FA4C104B5EC0784EB088DED04640264E2D80ED4B5EC0C4B84B228CD34640DE1C94E66D4C5EC048DF18EFCCD546408B3DFA4C124D5EC07FCD4922ACD74640DA16FB4C5C4E5EC068B9E4BB35D9464093E893E665515EC0D45116EFB8DA4640804561B37E645EC0D874B1885EDD4640D1C393E6EB6D5EC0D326E4BBE1DA46403B7960B3BA725EC0BCEFB18856DC4640DB44C81989745EC07CE8E4BBD5DB46405AFC2D8031775EC0180E7E55B3D94640C035C819957B5EC0D438E5BB7DD446406C4794E6257E5EC0408F492238D24640401B61B396895EC01740E3BB05CC4640C162C7195F8E5EC05059E4BBF9C946401717FB4C788F5EC0A768B188F6C84640D8E4C719B5905EC0A03718EF7CC846404A6DC719DD955EC0D41EE5BB25CB464054792D80459B5EC0D470E4BB49CB464033172E802F9D5EC0BFAFE4BBD5CC464020402E8075A05EC060F77C5513CE4640D22CC81989A25EC0BB30E4BB99CF4640CB2F2E807DA35EC07F9BE4BBA5CF46400A65FA4C12A65EC0805DE5BBA5CE4640B789FA4C14AB5EC0D0E44B2218D0464077B92D80A9AC5EC0A873E4BB5DD146400E5261B32EAE5EC0A475B0880ED3464078E82D8049AF5EC0ACAC4B22D8D44640075D2E80E1AF5EC09098B088FAD64640AA1D2E8049B05EC08CBF4B22D8D946406EC7C71999B05EC07CB4E4BBD9DE46404230C81989B05EC0B86517EF44E04640C4AFC71943B05EC0AF4E7D55BBE24640EA592D8033B05EC0C03B7E5523E44640C84561B374B05EC07077B18866E54640F0DEC719E9B15EC0D7AFE5BBF1E84640301162B3F4B15EC03C3518EFDCEB4640C922FB4CA8B15EC0F83A7F5573EE464082D694E689B15EC060DD17EFD0F04640ACB694E6B7B25EC048E3B1884AF54640427994E63BB35EC0608316EF14FB4640093DFA4C9EB35EC088287F5533FD4640954994E683B45EC0102B7E55D3FE46408D6FC7198DB55EC0783D18EF0C0047404C1161B366B65EC0C45F17EF78014740BF9CC71917B75EC068977D555B0647407D3E61B3F0B75EC0D77CB188360947405A7BFA4C12B95EC0EBABB188D60B47407F5BFA4C40BA5EC030407E55CF0D474050C6C619E1BB5EC010357F55A70F4740E9ADFA4CDEBD5EC0C88F4922601147403E2F61B3F6BF5EC0F0B97E55A31247406767C719EBC15EC04091E2BB21134740E4F993E6CDC25EC0A043B188D21347403DB893E60DC55EC068D44B2230164740F2F161B3E8C55EC0B3817E55631747408B42FB4C28C75EC0D894B088DE1747407754156D02CB5EC000CFDFB3D9164740FAEFCEBE57CB5EC03FE48198EF164740912D65AC86CB5EC0CB8844D1EC164740EDE6241F91CB5EC03C62A6270B174740A9898FF947CD5EC0F7366F9CD416474015019C11D7CF5EC0048010F4D0144740A8F3759A3ED15EC0206782CA401347400E9CB56C11D35EC0EC253AD0651347404CB3DD230CD55EC0F8D23BEC30154740FDA707D72CD95EC028EFA92A211A47404D5EB69364DA5EC0608D589D321C474090DB31335BDB5EC0B0B8DE01A11E474010B81E8072DC5EC090C11FFFFE204740A9351DCC29DD5EC0732545822E224740F7FF267EA6DE5EC02804258B4F2347409DDD267E9AE65EC0E893D0354A214740F94AD22869EA5EC050D2258B972247405FFB7CD3B5EA5EC01017268B6F234740D07CD128E1EA5EC010E8CF358E2447406789277E36EB5EC00781CF35AA254740D39E329459EC5EC0145B0BDE10274740D830A757ECEC5EC08453382CD426474071E379B0D2ED5EC0D01EF56596264740EC60F3C053EE5EC068070E0F7126474045FF32E279EE5EC02BEC2869262547401D4A04750DEF5EC0406CB905DB2447400EE59193D7EF5EC05F18911E4225474041FD003422F05EC05CA7CED39B2447407C8959DE7EF05EC05CAF04BA85234740740B97C7EDF05EC010C2576CFA224740CAE39C7DCAF15EC080049B3315234740524CF2779DF25EC010B4FE1A39244740AF415F0D9FF35EC077D4E153462447407856C4A929F45EC093FD786B3D234740E7E5496261F45EC010A838C7662247409C1DC4EF62F55EC05F680CB2662247406D986622DBF55EC07379B3AD76214740C966CB7577F65EC0E85A36A542214740FE4CDB57AFF65EC05039B9C845204740FF096B4C30F75EC03899F8DDD31F47404CE4DAC7DFF75EC0548F6BF2BD1E474028B49B62F3F85EC0781E68B4FE1E4740C15A295519FA5EC0DC2C08068C1F47407D53430E36FB5EC0D0F25A7B322047406922938924FC5EC09BE58E52D72147405FED9F6FB7FC5EC084593CF7892247408385E5C5E5FD5EC0E067D923AC25474030672A154BFE5EC008BD45415F2647407C4C87BB0BFF5EC020D8927E902747407CD8006F98005FC0C0825D4F1F284740F722E29275015FC067F2B0713928474009DBA0A01B025FC040B469952E2747403084D17C93025FC077F70D4EEF264740E28FA8D11D035FC060BD5909F1254740DF1554F64B035FC0785C395A9924474089FE534E94025FC05741F0F8F62347408C8DB0A36F025FC008E7550F6B2347402F4446EEA6025FC0F8022907EC224740F6F5CDA755035FC004D4DFB505234740F0C7BBF0F1035FC0C08083A26B234740D9EEA46C8E045FC0B0E4E0CFB922474099DD267EDA045FC048D2258B572247401ABECF9521055FC0E892BEABC6224740D3C77CD303055FC0AF107BE0242447404955812AF3045FC0A441AE74C12547409416C258A9045FC0BC259D884B274740941C3FA068045FC0A0439BBB54294740B98C084A3A045FC08CFA1B035E2B4740F9333C2315045FC0600F6A299A2D4740F4AEE3EDF8035FC07F596D54A031474024432915E5035FC0C82EE1AF4D384740DC0A7CD301045FC00436248B474C4740E3F033D5A3045FC0FFDEE0C43D5247400BBE802906045FC068AFE019D553474058B4A7B443035FC07F2DBB16A3524740C75A77E449025FC08873CCA7BE5047405522277ED2025FC0403CCF35D24F4740613E7CD373025FC0F019CF35C64D4740D4C77CD3A3015FC0D8B2CE35A24B4740E4E3D12825015FC0E819CF35C6484740392D7CD3AD015FC0D0FD79E0043F4740745AD12895015FC040B6D035963B474069421A4869015FC0387C5A9EB735474086C57B7DE9005FC0707F47914B314740319DEF9D94FF5EC0F0FE1817A7304740D1C2BBA892FE5EC010E638EFF33047404B947CD351FD5EC00481CF356A3047400B867D12AAFC5EC0201887A79533474046B89449A6FB5EC0E4A6EEFA273547401DF6F5BB51FB5EC0FC13922F5538474037341C64ECFA5EC073A0A3763B384740C633FF4D47FA5EC03083D51ED73647408DE90C960EF85EC0849DD5BBA5354740392D7CD32DF65EC0E4FD79E0C43247402C9FD128CDF55EC074BF248B37354740725AD128D5F65EC038B6D03596364740A028D2285DF85EC078557BE07C374740944F7CD379F95EC00436248B873847409E28D2289DF95EC020B979E02C394740745AD128B5F95EC0E493D0358A3A474004D97CD3E9F95EC007CC7AE0CC3A4740EF717CD345FA5EC074BF248BF73A4740A9F97BD3BBFA5EC0C82CD035663B4740FA4AD22829FB5EC060A3CF35F63B4740184D5A90E4FB5EC0870A44B2743C47408A9FD431E3FB5EC0408862A17F3D4740924F7CD3D9FB5EC0503CCF35523F4740465774E103FB5EC0C4ECE09F534047409D28D2281DFA5EC02804258B0F414740E5E3D128A5F95EC064A3CF35B6414740A7B67CD35DF95EC06FBF248BB7424740F9FF267E46F95EC0B8C5CF3502444740A7B67CD35DF95EC00017268BAF4547406789277E96F95EC003CC7AE08C464740AE44277EDEF95EC0A05ECF351E474740F4FF267EE6FA5EC0747479E0544A47406789277E76FC5EC018E8CF358E4D47405FFB7CD335FD5EC0B4C5CF35C24F47403D06D22811FC5EC044D2258B574F47403FBB267E4EFA5EC08C71D0357E4D4740F9FF267E46F95EC0C82CD035264D4740A5B67CD39DFA5EC00717268B6F5047400D67277E0AFB5EC040877AE034544740362D7CD34DFA5EC0F8CB7AE04C574740E0E3D12825F85EC030B6D035965847409EDD267EFAF55EC018B979E02C594740E4E3D128E5F45EC0B87A248B9F5847403A2D7CD36DF45EC0D42CD0356656474062FB7CD3F5F35EC02804258BCF544740C6AB277EE2F25EC050D2258B975447404D947CD3B1F15EC0D42CD03566554740E2E3D128E5F05EC038B6D035D65647402D9FD128EDF25EC0D893D0354A574740BD607CD35FF45EC014E8CF354E594740AF44277EBEF55EC0607479E0D45B4740041C7CD387F75EC06C7479E0D45D47402A9FD1288DF85EC0CC2CD035665E4740A0C3F78999F95EC034A3B703AB5F47400250810362FA5EC0B49C3BD6D95E47406109A3A06EFA5EC047E44986275D474006CFF40DEAFC5EC0572A9F5AC75C47406B290BE578FE5EC00435C6DFDA5E47401D579A5CD8FE5EC098D30A52375C47404F0BC46963FE5EC0B8D20C65055B4740B3472876A7FD5EC07F76644C845A474074CA4BAD40FE5EC0C8306FF4C2594740E9FC567637FF5EC0044A2F83545A4740215C7A270B005FC0FFC496C5545A474098996AAAEA005FC040EEADABF65A4740AE74DD129B015FC03CC11D66375B4740FA4AD228E9015FC033D5CE352E5C474066D1313680045FC0EC17DC580E5E47407EC2BDEBF9055FC038419E1B225F4740D172E23670065FC0C8FED41A78614740A9F97BD37B065FC0B8C5CF3582674740279FD1284D075FC00017268BAF6C4740934F7CD359085FC0E048258B67714740A4B67CD31D085FC0BBC5CF35027347406B17C96D27075FC060464018C7744740FCB41FF6D0055FC0201C58A033734740B044277E3E065FC0A45ECF355E704740643E7CD3F3045FC018B979E0EC6D4740D1C77CD3A3045FC0B7107BE0E46B474076A57CD3B7035FC050D2258B176C47404106D228B1025FC07871D0357E6B47403E06D228D1015FC0908D258BBF6A47409C28D2285D015FC0D893D0358A6A4740C3AB277EE2005FC03CB6D035D66B47403B06D228F1005FC0344FD035F26C4740AD44277E5E015FC02004258B0F6E4740E0E3D12805025FC0C4107BE0646F4740965F3EA0A6035FC018EA88D4586E474004D7EFFE82035FC0500000981C704740972701DE00035FC0B8832DBD107247403A1C645F20025FC0A7C32277F27247403A2D7CD36D005FC06C0AD0351A734740ACF97BD37BFF5EC028D5CE35AE734740AAF97BD39BFD5EC0B7C5CF35827547407B3142A86DF85EC0E0A7D87588784740F84AD22809F45EC0978D258BBF7A47401EA7A6BFFFF45EC0D0001E8B8C7B474003CE04B60FF65EC0D0E02AE7FC7A47401B837CD38BF75EC09C427AE01C7C4740FDAC8075CEFC5EC04B2A8496F47B4740AD0677E62CFD5EC0D016CDF3757C47406FE062667BFC5EC0BF654FBB857C4740F6FF267E06FB5EC044877AE0747D47406CA4C023C6FD5EC02CFA98C3F97D474061874416D3005FC04C5EC6BCEA7D47409296B9423D015FC0508802E83D7F4740CD14534CD2005FC04FB1095432814740EF717CD3C5015FC0740AD0359A834740E199B318FE025FC0D027032B3A8447407D5F42E931045FC097EEABD5CB84474042599C8AC4055FC090F04D453D85474018660CCC7A075FC0106E5C4D7E854740C8C7B6EBE9085FC07F8B4D268C844740ADF97BD37B095FC0B37A248B1F834740924F7CD359095FC050877AE034824740BF607CD3BF085FC07871D0353E8047403DE662BDC5085FC02851F4DC5C7E4740FC28FC42DD085FC0C8FA01DA197D474080E1590BBE085FC05025658DE57B47406643C5385F085FC05C99F74C777A4740E63B82C5E8075FC03417AB5929794740B08888981B075FC060E175EE57794740B1A6A7FFB4065FC04C387829EC784740D1DAADC5C4065FC0288746597A774740D159A508D1075FC0D762CED87C784740E3708879D5085FC050126189E87847407011FE297B095FC0C0AB87CAA77847406E368BE7D1095FC0E89C5AE81078474006C151C2D1095FC08894914D0E7747400100DD836F0A5FC0B40BA9F6B7764740DA6E40E66B0B5FC0243EFB0177764740DF5FADD53C0B5FC04CD35E26C57747400A67277E4A0B5FC0DF48258BA7784740A3B67CD33D0B5FC04FD2258B177A47407D09DEBB060B5FC0E454CC649F7D47403148A648000B5FC0F043D5915E8547401ECEC252280B5FC0303E03998688474085C1D128790B5FC034D5CE35AE8D47402DE51518CA0C5FC017898856FF974740237C589D8C0D5FC0C3CCB979029D474099664A16900E5FC09856FC79AFA14740BFA672338C0F5FC0D864224C21A54740523D49823C105FC084C823DE98A647403985D3B7A9115FC0B0991587BCA64740EDD23B7FF4115FC030FA8E5106A84740781AE70427135FC098862BF891AC4740DAD55DCC5B125FC05FD8F7D476AC474008906A03D0115FC00CC34051C5AB4740D0C77CD363115FC0680AD035DAAB4740508FEC2B1E125FC07F4AC73CF5AC47408ED4A43CBC135FC0381BFF4024AD474036A915F756145FC01816FEAEBDAD47405854620951165FC0071F68E4F7BF4740663E7CD373165FC08471D035FEC54740F5FEE226FE175FC0B8C86CB9C8CD474078B7BF018D185FC0A8A9C0FE68D14740180AF13E4A1A5FC0E84C066616D84740B17D600B9D1A5FC0D8304809E0DC47403DBB267E0E1B5FC05FA3CF35F6DE4740A9B67CD3DD1B5FC0DC93D0354ADF47407AA57CD3971C5FC0FFCB7AE00CE04740289FD1282D1D5FC0B0C5CF3582E14740813C610D801E5FC0F4CED6D89DE347403C06D228F11E5FC007E8CF350EE84740C00D22C6A9225FC0B07EF35CCBEA47408B1DE3D699235FC0A8A2827445ED47408F4F7CD359245FC0503CCF3552EF4740B247D4E3F5255FC077785A4E27F04740C0BC172A02275FC0AF125041FBEF474032F7A71FD7285FC0F41967E534F44740AD44277EFE295FC098427AE01CFA4740DA0A7CD3012B5FC02004258BCFFE4740924F7CD3B92B5FC02004258B8F034840910100FD672C5FC008A9B4358A094840BD607CD31F2C5FC04C3CCF35D20C4840E6E3D128452E5FC058A3CF353613484054A713CE032F5FC0942609C9CF154840A187EBF5072E5FC0B08C10DC90164840B3D9D2E2CD2C5FC0940B08D38E184840BD607CD31F2C5FC0483CCF35521B4840E5E3D128252C5FC0E0FD79E0041C4840934F7CD3792C5FC0A87A248BDF1C4840F674BA2E272D5FC0E00C143E7C1F48408291A13A082D5FC028D02D3CFB1F4840B86995C11A2C5FC0D076B62E522048405BC443BAAD2B5FC03FD9B45CBA214840924F7CD3B92B5FC02C4FD03572244840C2AB277E822B5FC054D2258B97254840382D7CD38D2A5FC02404258B8F27484062FB7CD3552A5FC0C82CD035E6284840B9493112EA2A5FC0605C425C7E2948402867A5FFDB2A5FC038D1D4E3A52A4840CCDEF1376B2B5FC07425310BE42A48408554C45B1A2C5FC087DBC300372B4840FFD28CECFA2C5FC0E8AD381E712C484077A57CD3F72D5FC07871D035BE2D484088DDDD81BC2E5FC0D74897E08F2F4840013E90D38F2E5FC0BC860510A131484056A11CC0932C5FC08F97E11E0F324840274E1C43572A5FC06F0B54A8693148406FBD009DD7285FC00472A92E063148402373D3C9A6275FC02013149F382F484060A3150DE9265FC0E0DB79C4E32E484012AD6EB8F9255FC030E34349FB2F4840004FD00FCB245FC038C85D84692F4840F7D924790D225FC0745325D9C92C484031EA7CD34F1D5FC014E8CF358E2848405091D2B88C195FC09851E806942548405622277E32165FC097F7CE35FA234840AAF97BD39B155FC05CA3CF35762348409C2D1E46F7125FC0106073507A214840C105FA5389115FC0D0403D0EE72048405C3D71DD0D105FC0E08D64ADA62148404B947CD3910E5FC04CD2258B17214840498479343A0A5FC0BC0475DEC71D4840EC4C5D6921075FC03C652FA1A31B4840243F44CB63065FC08051BC16A91948401C3D392E36035FC0F0BA098EB01648406AED331DD0FF5EC0B73DFED51A16484052E40DB924FE5EC0D7715D54321548403CAE5FA669FC5EC0483E29863015484011087A29CEFA5EC0DC99F57BC51448404D12E832E6F75EC08C8F89BAAD14484081CC8C1929F75EC034ED05BA041448404A9E83AB5FF45EC01C02F349941448409C28D2287DF25EC0770AD0359A134840A4A194437DEF5EC04CEB951778144840DB00816ED2EC5EC06C0A2FCB1B15484071A20B8711E95EC09C48D63F5A134840FB889F5F91E85EC0EF2844F01A124840B55C87146AE55EC0BC23895655114840DC6122574AE45EC0B8CC58BDCE124840B515166A5AE35EC0943609D65F134840C964E3E73DE25EC058FCC3969E1248408E0D8FF082E15EC067F9D7F24A114840964F7CD359E05EC090F7CE35FA104840DDA7875470DE5EC01000C70B1A11484077489BB7E5DB5EC0F8B306663A124840967373CEC8DA5EC06794DBFB3612484045F2B4E0EBD95EC03FD2D8B2CA114840442D1C8748DB5EC0989C28838F114840EA28EAA636DC5EC0C7426BBA28114840D93A84F904DD5EC0A8CA0E96D6104840D8D05D3DC7DC5EC0982C569003104840360352B1FDDA5EC0C03B0CFC140F4840F6B32073E9D65EC0209EF4B1070F4840C05CFBFDA0D45EC0EC5DA2A5AB0E48403576D8C365D25EC0603A5DB8210F4840C0F2BDA5CDCF5EC000999541C30E484030EA7CD34FCE5EC0A05ECF359E0F48407876A21FEBCA5EC0034E64370A15484079D53F259AC95EC07C576049AB164840C86C9193EDC65EC0C8A3E3FD8717484039BDF0B58DC75EC0E051B8D2F6164840DFBD8EBE5DC85EC04CAEF9303C164840258849043FC95EC0001BB9D6ED1448405422277E52CA5EC0244FD035721348405013C95F53C95EC0031C25D05C134840CB9CA4E227C75EC08CCB4D5513134840745AD128B5C55EC0304FD03572104840B15668AB08C45EC0C03CB2A00D0F484043CE83CD96C25EC0680F00FEE40A4840F1717CD3E5C25EC0B8107BE0A4074840F6FF267EE6C15EC0D893D035CA054840CB7CD12881C05EC01017268BEF0448401B837CD3CBBF5EC0304FD035F2044840A7B67CD35DC05EC0473CCF35120A48404D947CD3F1BF5EC08071D035BE0B4840AE44277E3EBD5EC088F7CE357A0C484098DD267E3ABC5EC0F835248B870C4840ADF97BD35BBB5EC020B979E02C0C4840A9B67CD3FDBA5EC0E819CF35060B48402A9FD128CDBA5EC07C557BE0FC0848400A67277E4ABA5EC04FA3CF3576084840725AD12895B95EC098F7CE357A084840D4C77CD3C3B85EC0B0C5CF350208484074A57CD3D7B75EC0A45ECF355E064840A4B67CD3DDB65EC0F835248BC7034840A5B67CD39DB65EC030B6D03556014840D1C77CD3E3B75EC0C0107BE024004840D1C77CD3E3B75EC0304FD03532FF4740392D7CD3ADB65EC0B0107BE064FF474086C1D128D9B55EC054A3CF35B60048400867277ECAB45EC0C0C5CF35820448402FEA7CD38FB55EC0E0B2CE3562064840D90A7CD321B85EC02F4FD035320A4840289FD1286DB85EC08071D035BE0B4840289FD1282DB85EC0D02CD035A60D48405422277E92B75EC0DBFD79E0440F48402D9FD128CDB65EC0334FD035F20F4840934F7CD3B9B45EC0F735248BC7104840C0607CD3DFB25EC0403CCF35121248400C67277E4AB15EC01F04258B0F124840F7FF267E06B05EC0888D258BFF0E4840DB0A7CD3A1B05EC098427AE05C0E48405EFB7CD335B25EC020B979E02C0D4840EF717CD3A5B25EC0D8B2CE35620C48402FEA7CD3AFB25EC088427AE09C0A4840765AD12835B25EC0700AD0355A094840C2607CD39FB15EC0C0107BE0640848406589277E56B15EC04B3CCF359207484030EA7CD3EFB05EC058A3CF35B6054840A228D2283DAE5EC0304FD03532FF474074A57CD3B7AD5EC0AC5ECF355EFE4740CC7CD12881AC5EC010E8CF354EFD4740392D7CD30DAC5EC0483CCF3592FC4740D80A7CD3E1AB5EC0483CCF3592FB47403FBB267EAEAB5EC048D2258BD7F84740F0717CD365AB5EC0D8FD79E0C4F74740613E7CD313A85EC09C427AE0DCF147402EEA7CD3AFA75EC040B6D03556F04740745AD12835A85EC02404258BCFEF4740A6B67CD31DAA5EC028D5CE35AEEF4740A7B67CD3BDAA5EC050A3CF3576EF47400D67277E4AAB5EC0740AD0355AEE4740E4E3D128C5AB5EC034D5CE35EEEB47400C67277E4AAC5EC0403CCF3592EA4740CE7CD12821AF5EC01017268BAFE54740F7FF267E06B05EC0B8107BE024E3474049947CD331B15EC060A3CF3576DE4740A128D2289DB15EC0C4C5CF3502DC4740EC717CD3C5B15EC028B979E0ECD947409E28D228FDB15EC0687479E094D84740D5C77CD383B25EC0985ECF359ED7474086C1D12839B35EC0EC19CF3506D747405DFB7CD3F5B35EC06F7479E0D4D64740F0717CD305B55EC0204FD03572D7474047947CD311B55EC044D2258BD7D847409DDD267E5AB45EC0F035248B47DB47402EEA7CD32FB35EC08C71D0357EE34740D70A7CD321B35EC0B0C5CF3542E7474032EA7CD38FB35EC060A3CF35F6EB474040BB267E4EB45EC0EC19CF3546EA4740DC0A7CD361B45EC0EC93D035CAE74740715AD12895B45EC038D5CE356EE54740725AD128B5B55EC0680AD0351AE44740F84AD228C9B55EC0304FD035B2E647404A947CD331B65EC0888D258BFFE847402DEA7CD3CFB65EC07C557BE0BCE94740AE44277E7EB75EC043B6D03596E747405222277E72B75EC0543CCF3592E54740382D7CD3EDB65EC0C0C5CF3542E34740725AD128B5B55EC0403CCF3592DF474002D97CD329B75EC0975ECF35DEDD4740623E7CD313B85EC0CC2CD035E6DA4740AE44277EBEB85EC0687479E014D8474099DD267EDAB95EC0F880CF352AD64740A3B67CD33DBA5EC05CA3CF3536D34740D17CD128C1BA5EC0E093D0358AD247400867277E8ABB5EC028B979E02CD24740EE717CD345BC5EC0DCFD79E044D1474087C1D12859C15EC0E048258B67C84740ADF97BD31BC25EC0D32CD03566C647400967277E2AC45EC0D848258B27BF4740081C7CD327C55EC0E493D0354ABD4740ACF97BD37BC65EC01BE8CF358EBB4740D4C77CD3A3C75EC0DF93D0358AB94740F84AD22889C85EC0E019CF35C6B44740D3C77CD323CA5EC0B87A248B9FAF47405422277E52CA5EC027B979E0ACAD47405FFB7CD355C85EC06F0AD0359AAB4740AE44277EBEC45EC090427AE01CAC4740352D7CD3EDB95EC018E8CF358EB24740061C7CD3C7B75EC058A3CF3576B44740725AD128B5B55EC0E893D0354AB74740FC4AD22889B75EC04CD2258BD7B747402A9FD1280DBA5EC0908D258B3FB64740ACF97BD37BBE5EC008CC7AE00CB2474075A57CD357C35EC090F7CE35FAAE4740D07CD128E1C55EC0E019CF3506AF4740D2C77CD343C75EC008CC7AE00CB247405022277E12C75EC07C0AD035DAB34740A9F97BD35BC65EC0908D258BBFB54740E2E3D128A5C45EC00036248B07B947402D9FD1280DC45EC060A3CF3576BA47405322277E72C15EC028D5CE35EEC24740A028D228BDBC5EC028B979E06CCC4740AD44277EDEBB5EC00481CF352ACD4740D1C77CD3E3B75EC0E893D035CAD0474061FB7CD315B35EC00481CF356AD34740C2607CD39FB15EC04C3CCF3592D44740A3B67CD3DDB05EC0C82CD035A6D54740613E7CD373B05EC03FB6D03556D7474000D97CD389AF5EC0E493D0350ADD474062FB7CD3F5AE5EC000CC7AE00CDF4740DB0A7CD3A1A85EC08FF7CE357AEB474004D97CD3E9A75EC00F17268B6FEC4740AC44277E3EA75EC038B6D035D6EC4740C1607CD31FA65EC0304FD03572EC4740F6FF267E06A65EC08371D0357EEB4740765AD12835A65EC0687479E054EA4740F0717CD3E5A55EC04CD2258B57E947400D67277E8AA45EC028D5CE35EEE84740DE0A7CD341A45EC02804258BCFEA47405322277E92A45EC048877AE0B4ED4740F7FF267EA6A55EC0D0FD79E0C4F34740F0717CD3E5A55EC040877AE0B4F4474098DD267E1AA75EC018E8CF35CEF74740AC44277E3EA75EC0607479E014F947400B67277E6AA35EC0A85ECF35DEF547401A837CD3CBA15EC0DC48258BE7F34740DD0A7CD321A15EC0F019CF35C6F04740392D7CD30DA15EC0C0107BE0E4EE4740071C7CD3A7A05EC0403CCF3592EA4740E4E3D12845A05EC0EB19CF3546E94740914F7CD3999F5EC01F4FD03532E84740A028D2285D9F5EC0BC107BE0E4E64740DA0A7CD341A05EC0AF107BE0E4E447403FBB267EAE9F5EC0A87A248B9FE44740C4AB277E029F5EC087427AE01CE44740F94AD228699E5EC040B6D03556E34740051C7CD3079E5EC06F0AD0355AE247408F4F7CD3F99D5EC044B6D035D6E047402C9FD1284D9E5EC0988D258BBFDF4740613E7CD3B39E5EC05FA3CF35F6DE4740081C7CD3E79E5EC038B6D03556DE47401B837CD38B9F5EC08F427AE01CDE4740CD7CD128A1A25EC034B6D03516DF474061FB7CD3B5A35EC0E819CF35C6DE47404C947CD391A35EC0EC19CF3546DD4740D3C77CD323A45EC044877AE034DB4740934F7CD319A55EC0AC5ECF355ED94740C1AB277E22A65EC0483CCF3592D84740613E7CD3B3A95EC0DCFD79E0C4DD47403DBB267E4EAA5EC0888D258B7FDD4740AC44277E1EAA5EC0C72CD035E6DB474003D97CD3A9A95EC01804258B0FDB4740765AD12815A95EC048877AE074DA4740E1E3D12885A85EC0F835248B87D9474074A57CD337A85EC0304FD035B2D84740F0717CD3E5A55EC028B979E06CCC4740BF607CD35FA65EC008CC7AE08CCB4740F0717CD3E5A55EC04CD2258B97CA4740AAF97BD37BA75EC070557BE07CC94740623E7CD333A95EC0E0FD79E044CC4740A8B67CD39DAB5EC00481CF356AD34740A9F97BD31BAC5EC0A87A248B5FD24740663E7CD373AC5EC00C81CF352AD147409ADD267E9AAC5EC0AFC5CF35C2CF4740041C7CD387AC5EC044B6D03516CE4740F84AD22829AC5EC0AC5ECF355ECC4740B144277E9EAB5EC038B6D03596CB4740EC717CD365A95EC0700AD035DAC94740041C7CD3E7A85EC08F427AE0DCC94740E5E3D128E5A85EC0483CCF3592C9474041BB267E6EA95EC090F7CE35FAC747400D67277E0AAA5EC0BC7A248B9FC64740C6AB277E42AB5EC0483CCF35D2C44740A8B67CD39DAB5EC0F019CF3586C34740705AD12855A85EC038D5CE35AEC54740904F7CD3D9A65EC07C0AD0351AC74740BE607CD37FA55EC054D2258BD7C84740F4FF267E66A35EC018B979E0ACCA4740D2C77CD3C3A25EC00CCC7AE08CC8474004D97CD3A9A25EC08871D0353EC547403BBB267E2EA25EC0F019CF3586C34740DB0A7CD381A05EC0740AD0359AC24740A028D2289DA05EC0BC7A248B5FC04740643E7CD373A15EC0F880CF35AABD47406389277EF6A15EC0B8C5CF3542BB4740623E7CD373A25EC0878D258BFFB74740352D7CD34DA35EC08771D035FEB4474086C1D12899A35EC018B979E02CB24740F5FF267E66A25EC030D5CE356EAF4740C4AB277EE2A25EC0BC7A248B9FAD4740FF4AD22889A35EC0985ECF355EAC4740E3E3D12865A45EC0E493D0358AAB4740BE607CD37FA55EC013E8CF350EAB4740DA0A7CD3E1A35EC0483CCF3592A64740F2717CD3A5A35EC030D5CE356EA44740C2AB277E62A45EC0F8CB7AE0CCA1474074A57CD357A55EC0533CCF35D2A147403DBB267E4EAA5EC0700AD035DAA4474018837CD3EBAB5EC018E8CF358EA64740A6B67CD3BDAB5EC090F7CE35BAA7474085C1D128D9AA5EC0BC107BE0E4A847403DBB267E4EAA5EC0503CCF3592AA47405522277ED2A95EC02C4FD035B2AC4740AE44277EDEA85EC08071D0357EAE47402DEA7CD32FA85EC0D8B2CE35A2B04740E1E3D12885A85EC0E093D035CAB34740C1607CD3FFA85EC0D448258B67B14740745AD128D5A95EC0284FD03532B04740392D7CD30DAC5EC0D8B2CE35A2AE47402A9FD1288DAC5EC0E0B2CE35E2AD4740AE44277EFEAC5EC050877AE0F4AC474074A57CD377AD5EC03CD5CE352EAC474002D97CD309AE5EC0680AD035DAAB47405CFB7CD375AE5EC0C82CD03566AB47406689277E96AE5EC0483CCF3552AA4740FC4AD228A9AE5EC0D893D0350AA9474003D97CD3E9AE5EC08871D035FEA74740FB4AD228E9AF5EC00FE8CF35CEA547405122277E32B05EC07F71D035FEA3474085C1D128D9AF5EC058A3CF3536A247400A67277E4AAE5EC0EF19CF35869E4740A8B67CD35DAE5EC0E019CF35C69D4740F7FF267EC6AE5EC00017268B2F9D4740F4FF267E26AF5EC0A45ECF351E9C474003D97CD329AF5EC08071D035BE9C4740633E7CD373AF5EC048877AE0749C47402FEA7CD3CFAF5EC0DF19CF35C69B4740F7FF267E06B05EC07F71D0353E9B474004D97CD3E9AF5EC06CBF248BF79A47405222277EB2AF5EC074557BE03C9A4740F8FF267E86AF5EC0607479E054994740279FD1288DAF5EC0E893D0358A984740705AD12875B15EC0DC48258B27964740A7B67CD31DB35EC074557BE03C9A4740F7FF267E26B45EC090427AE01CA04740051C7CD327B45EC098427AE01CA347400767277EEAB25EC020B979E0ECA347407AA57CD357B25EC0C02CD035E6A54740299FD1282DB25EC0770AD0355AA847405EFB7CD335B25EC0A77A248BDFAB474042BB267E4EB25EC0680AD035DAAC4740EF717CD3A5B25EC0D8B2CE35A2AE4740613E7CD313B35EC00CCC7AE08CAF4740BF607CD39FB35EC0284FD03532B04740FC4AD228E9B35EC0B87A248B1FB1474032EA7CD38FB35EC00781CF35EAB24740A128D2287DB45EC02804258B0FB147400967277E8AB55EC0E793D035CAAA4740E5E3D12825B65EC038D5CE356EA847403FBB267EAEB75EC010E8CF354EA647403FBB267EAEB85EC0E493D0354AA547404006D22871B95EC0700AD035DAA44740735AD12875BA5EC0DBFD79E084A44740FD4AD228E9BA5EC030B6D03596A34740FE4AD228C9BC5EC0AF107BE0E4994740D5C77CD3C3BD5EC00817268B2F974740F6FF267E66BF5EC0BC7A248B1F954740E1E3D128C5C25EC0D7FD79E0C4934740C2607CD35FC45EC03CD5CE35AE9247400C67277E0AC55EC020B979E0AC9047406589277E16C45EC003CC7AE08C914740AD44277E9EC25EC064A3CF3576924740C5AB277E62C15EC068557BE07C924740EF717CD325C15EC020B979E0AC904740DB0A7CD3E1C15EC008E8CF358E8F4740CD7CD12821C35EC0DFB2CE35228F4740ABF97BD35BC45EC0C02CD035668E47400C67277E0AC55EC014E8CF354E8C4740F5FF267EC6C35EC0B8107BE0248D4740B044277E5EBE5EC08C71D035BE924740C6AB277E02BE5EC0D748258BE7924740BF607CD3BFBD5EC0483CCF3552934740289FD1284DBC5EC0D893D035CA964740F94AD22889BB5EC0707479E0549647404E947CD3D1BB5EC08FF7CE357A944740F94AD228A9BE5EC08771D035FE8C4740EB717CD385BF5EC0D8B2CE35A28B47401C837CD3ABC05EC02C04258B8F8A47405522277E32BF5EC0A45ECF355E8A4740ADF97BD3BBBD5EC0DCFD79E0848B4740FD4AD22889BC5EC06FBF248BB78D4740A5B67CD3DDBB5EC020B979E0AC904740914F7CD379BB5EC00881CF356A8F474086C1D12859BB5EC00BE8CF350E8E4740914F7CD379BB5EC053877AE0B48C4740A5B67CD3DDBB5EC02FD5CE356E8B4740A9B67CD33DBB5EC0E019CF35068A4740D3C77CD3C3BA5EC00C17268B2F874740A6B67CD31DBA5EC00017268B2F86474018837CD32BB95EC003CC7AE00C864740F7FF267E26B95EC048D2258B57874740A128D2289DB95EC0DC48258B27894740A6B67CD31DBA5EC02C04258B8F8A4740725AD12855B95EC06F0AD035DA8B4740C0607CD35FB95EC038D5CE356E8D47402D9FD128ADB95EC037B6D035168F4740352D7CD3ADB95EC020B979E0AC904740A028D2281DB95EC00017268B2F924740755AD12895B65EC0BC7A248B1F954740A8F97BD33BB65EC0985ECF35DE934740E0E3D12845B65EC0204FD035B29247403E06D22891B65EC0D0B2CE35A2914740E0E3D12805B75EC020B979E0AC9047409D28D2281DB65EC098427AE0DC9047401B837CD32BB55EC0C0C5CF35829147400B67277E8AB45EC00017268B2F924740613E7CD393B45EC0BFC5CF3582924740F6FF267EA6B45EC08471D0357E9447401A837CD34BB45EC058A3CF353695474061FB7CD315B35EC028B979E02C9447403C06D22891B25EC040B6D035169347402C9FD1280DB25EC0D0B2CE35A2914740705AD12875B15EC0780AD0355A904740DA0A7CD3E1AF5EC098427AE05C8F47406789277E16AF5EC0D4FD79E0448E4740AAB67CD37DAE5EC0700AD035DA8C4740A228D2283DAE5EC02FD5CE356E8B4740EF717CD3E5AB5EC090427AE05C8D4740C0607CD3BFA95EC0BC107BE064904740745AD12895A45EC0E093D035CA9A47406889277E36A35EC0E0FD79E0049F4740BF607CD35FA25EC0D848258BA7A34740F5FF267E66A25EC038D5CE356EA84740372D7CD34DA15EC0670AD0351AA747403D06D228119F5EC0C72CD03526A54740633E7CD3B39C5EC094427AE05CA2474073A57CD3B79B5EC0E048258BE7A147400A67277ECA9A5EC08071D0357EA24740C0607CD39F995EC09CF7CE35FAA3474085C1D128B99A5EC0EC19CF3506A54740A6B67CD35D9B5EC040877AE0F4A54740ABB67CD37D9B5EC0E819CF3506A74740C2AB277E029B5EC038D5CE356EA84740653E7CD3339A5EC0740AD0359AA947400D67277E0A995EC050A3CF35B6AA47403E06D228D1975EC0F019CF3586AB4740924F7CD3B9955EC088427AE05CAC4740F0717CD305955EC05CA3CF35B6AD47405DFB7CD3B5945EC00717268BAFAF47404106D228D1945EC008CC7AE00CB247409EDD267E5A955EC090F7CE35BAB34740944F7CD319975EC0E493D0350AB74740914F7CD379975EC0700AD0359AB8474078A57CD377975EC0AC7A248B1FBE474049947CD3B1975EC0E0B2CE35A2BF4740FA4AD22869985EC010E8CF354EC14740AAF97BD3DB985EC00081CF35AAC24740725AD128159A5EC044877AE074C84740352D7CD32D9A5EC04CD2258B97C947406889277ED6995EC08C71D0357ECA47409D28D228FD985EC08771D035FECB474031EA7CD32F985EC02004258B4FCC47406989277E76975EC05FBF248BF7CA4740FFD87CD3C9965EC0B87A248B1FC94740CE7CD12821965EC090F7CE35FAC747405F3E7CD3D3955EC09C5ECF359ECA4740C2AB277EC2955EC00481CF35AACC474078A57CD317965EC06B7479E054CE4740C0607CD3FF965EC03CB6D035D6CF4740A9F97BD3DB995EC040B6D03596D147406689277E769A5EC0D0B2CE3522D2474078A57CD3179B5EC038B6D03556D347403E06D228719B5EC0EF35248B87D447405DFB7CD3359B5EC02FB6D03516D54740934F7CD3799A5EC0FF16268B6FD547404C947CD3319A5EC0503CCF3552D64740FA4AD228099A5EC050A3CF3576D74740C0607CD39F995EC0483CCF3592D84740B144277E9E985EC0908D258BBFDA4740D2C77CD363985EC030D5CE352EDC47404C947CD391985EC008CC7AE04CDE4740332D7CD3CD985EC0F8CB7AE04CE04740AD44277E7E995EC0DC48258BA7E14740A4B67CD3FD995EC0483CCF3592E34740D07CD128E1995EC048D2258B17E647403B06D22891995EC00017268B2FE84740735AD12815995EC028D5CE35EEE947405FFB7CD375985EC0D42CD03566EB47403E06D22891965EC0780AD0359AED4740A9B67CD3BD955EC074BF248BB7EF47404006D22891955EC0D893D0358AF24740D6C77CD363955EC0D893D0358AF44740F0717CD3C5945EC0473CCF3552F64740E3E3D128C5945EC0403CCF3592F74740DB0A7CD381945EC030B6D03596F84740C5AB277E02945EC08871D0353EF94740ACF97BD3BB925EC0EB93D0358AFA4740FC4AD22849925EC07871D0353EFB47409F28D228BD915EC0707479E0D4FB47406489277E768F5EC0DCFD79E084FC4740051C7CD3E78E5EC068557BE03CFD4740B044277E9E8D5EC01F04258B4FFE4740C0AB277E628D5EC058A3CF35F6FF4740E4E3D128458D5EC04CD2258BD70148409ADD267EDA8C5EC028D5CE356E0248402CEA7CD38F8C5EC0C82CD035E6024840E4E3D128458C5EC0985ECF355E034840C2AB277E628C5EC060A3CF35F603484000D97CD3E98C5EC02804258B4F044840041C7CD3478D5EC00BE8CF35CE0448403DBB267E2E8E5EC0DFB2CE35E2044840A128D2283D8F5EC0985ECF355E0348404C947CD3B1935EC0A05ECF355E084840E1E3D128C5955EC0E819CF35860B484031EA7CD32F975EC03CD5CE35AE0F4840FE4AD22889975EC030D5CE356E144840091C7CD367975EC0B0107BE06418484004D97CD309985EC0E893D0354A1B4840362D7CD3AD9A5EC0975ECF35DE1C4840BB607CD3FF9A5EC038D5CE352E1D48400D67277E6A9B5EC05CA3CF35B61D4840F5FF267EE69B5EC0F435248B071E48403A2D7CD36D9C5EC08871D035BE1D4840AAF97BD3BB9C5EC0F019CF35861C4840289FD1288D9C5EC0D8B2CE35E21948409C28D228DD9D5EC0747479E0941848401C837CD30B9E5EC0F880CF35AA1648403EBB267ECE9D5EC090427AE05C144840362D7CD34D9D5EC0E0B2CE35621248402C9FD128AD9C5EC028B979E02C114840061C7CD3A79B5EC02CB979E0AC0F4840FB4AD228899A5EC0C82CD035660E48406A89277E96995EC0780AD035DA0D4840745AD12895985EC06B557BE0FC0C4840BC607CD39F975EC06CBF248BF70A4840F0717CD345965EC0244FD035F20648402A9FD1286D975EC0D02CD035E6064840081C7CD327985EC058A3CF35B6074840B044277E5E995EC00C17268B6F0A48405DFB7CD3F5995EC074557BE03C0B48406A89277E569F5EC02C4FD035B210484005D97CD3A9A05EC0B47A248BDF1248401C837CD3ABA15EC0D0B2CE35E2154840CE7CD12821A25EC0740AD0351A194840C2607CD3FFA15EC0AF107BE0241C4840034DF33D2CA25EC0FF48CD68F51F4840279FD128ED9F5EC0A45ECF355E204840E1E3D128C59D5EC0F019CF354621484000D97CD3899C5EC00081CF356A214840D4C77CD3839B5EC0F880CF352A214840FAFF267EC69A5EC0284FD0353220484075A57CD3379A5EC0D02CD035E61E4840F7FF267EA6995EC09C427AE01C1E4840E2E3D128E5985EC0284FD035B21E48405622277E32995EC0908D258BFF1F4840BD607CD3FF985EC013E8CF354E214840E6E3D12805985EC00C17268BEF234840051C7CD347985EC0680AD0359A24484031EA7CD36F985EC07B71D035FE25484048947CD3B1985EC0D8B2CE35E22648405222277E12995EC0D02CD035A627484084C1D128399B5EC0D7FD79E0442A4840CD7CD128219D5EC044B6D035D62B4840DA0A7CD3A19E5EC018E8CF350E2E48405522277E729F5EC094F7CE35BA2E4840EE717CD365A05EC0680AD0351A2F4840643E7CD373A15EC094F7CE353A2F4840FC4AD22829A25EC04C877AE0F42F48402A9FD1286DA35EC0A75ECF355E3348400C67277E4AA45EC073BF248B773448400C67277E4AA45EC018B979E06C354840745AD12855A35EC0D8FD79E0C4364840EF717CD3C5A35EC010E8CF358E374840BF607CD3BFA45EC0304FD035F2374840081C7CD367A55EC0DF93D0350A384840B144277EDEA55EC02004258B8F374840EE717CD3E5A65EC09B8D258B3F354840E0E3D12865A75EC073BF248B7734484076A57CD357A85EC0D7B2CE35E2334840DC0A7CD361A95EC030D5CE35AE3348409BDD267E5AAA5EC0888D258BFF334840ABF97BD31BAB5EC0344FD035F2344840A6B67CD3BDAB5EC02004258B0F374840372D7CD36DAB5EC027B979E02C3848402D9FD128CDAA5EC08071D035FE384840603E7CD373AA5EC088F7CE353A3A48406589277ED6AA5EC0D8FD79E0843C4840705AD128B5AB5EC030B6D035563D4840A8F97BD39BAC5EC088427AE09C3D48409F28D2281DAD5EC08071D0353E3E4840653E7CD3F3AC5EC08071D035BE3F4840924F7CD319AC5EC088F7CE35FA3F484005D97CD309AB5EC0A85ECF35DE3F4840AAF97BD33BAA5EC0D8B2CE3562404840D2C77CD383A85EC05F7479E014424840BB607CD33FA75EC0D893D0350A4048405EFB7CD335A65EC08471D035BE3C48400867277E2AA55EC0F780CF35AA3A4840299FD1282DA55EC0D7FD79E0043E4840BB607CD35FA45EC0E048258BA73E4840D0C77CD343A35EC0E0B2CE35A23D4840A9B67CD3BDA15EC02CB979E0EC3A484007D97CD3E9A05EC0AFC5CF35023A484004D97CD309A05EC0D848258BA739484003D97CD3499F5EC088F7CE353A3A4840EE717CD3C59E5EC0D048258B673B48409DDD267EBA9E5EC0304FD035323C4840F9FF267EE69E5EC08871D035FE3C48402B9FD1280D9F5EC08071D0353E3E4840DC0A7CD3419F5EC0D048258BA7414840D80A7CD3A19F5EC0B8C5CF35C2434840954F7CD339A05EC030B6D03596454840D4C77CD303A15EC0AF7A248B5F4748405EFB7CD395A35EC010E8CF35CE49484006D97CD349A45EC028B979E0EC4A4840A9F97BD3FBA25EC0780AD0355A4B4840AEF97BD39BA15EC0D02CD035A64A48402CEA7CD30F9F5EC0D848258BA7474840715AD128F59D5EC097F7CE35FA464840ED717CD3A59C5EC040877AE0F4474840342D7CD32D9C5EC0607479E0544A48402CEA7CD36F9C5EC05FBF248B374D4840362D7CD34D9D5EC0FCCB7AE0CC4F48409CDD267EDA9D5EC090F7CE357A5048401B837CD36B9E5EC0F7CB7AE0CC504840AEF97BD3FB9E5EC0988D258B3F514840F5FF267E869F5EC043B6D035565248403C06D228D19F5EC0D748258BA75348404D947CD331A05EC08771D035FE564840FFD87CD329A05EC0FF80CF35AA574840AEF97BD39BA15EC094427AE09C584840904F7CD359A15EC0BCC5CF35C25A4840279FD128ED9F5EC0DC48258BA75E48402A9FD1288DA05EC094F7CE35BA6048400D67277EEAA15EC0DCB2CE3562624840BF607CD37FA35EC0988D258B7F634840E5E3D128C5A45EC0CC2CD035E6634840A6B67CD3FDA55EC038B6D03516634840F9FF267E06A75EC0680AD0351A6148403C06D228F1A85EC070BF248B775C4840BD607CD39FA95EC024B979E0EC5B4840BF607CD33FAA5EC074557BE07C5C484060FB7CD3B5AA5EC037D5CE35AE5D4840D3C77CD3E3AA5EC040D2258B175F48403FBB267EAEAA5EC0C0C5CF35C25F4840FD4AD228C9A95EC02804258B0F614840643E7CD393A95EC0948D258BBF614840BD607CD31FAA5EC0988D258B7F634840633E7CD353AB5EC01804258B8F6548400B67277E8AAC5EC0888D258B7F6648409F28D2281DAD5EC0780AD035DA6448406989277ED6AC5EC04F877AE0F46748401B837CD30BAD5EC0E048258BE76948405DFB7CD3B5AD5EC0D893D0354A6B4840A8F97BD37BB05EC0A87A248B9F6E48400A67277E2AB15EC0BC7A248BDF6F48404006D22871B15EC088F7CE357A714840299FD1282DB15EC0A75ECF35DE7248405DFB7CD395B05EC064A3CF35F6734840B044277EFEAF5EC017E8CF35CE744840AAF97BD3BBAF5EC05FA3CF35767548403D06D22891B05EC0F8CB7AE0CC77484075A57CD3B7B35EC0A85ECF359E7748404006D22811B45EC0647479E0D4794840D4C77CD343B35EC023B979E02C7B4840C4AB277EC2B15EC08871D0357E7B484048947CD3D1AE5EC00036248BC77A484042BB267E6EAF5EC0F835248B077D48404206D22831B05EC0E493D0350A7F48400A5B9B5A31B05EC030175FBA0A7F4840,14.8%,191,"1,484",485,999,Washington,true
9,0106000020E610000001000000010300000001000000140000000C9A79BB774153C050A22016C166434055D231B7C04153C0E88740B1F2684340347BE633604153C0B0C87DBF196B434034C0C34F244153C05CB904D82E6C43400C3C6B08054153C050B6B607596D43400E57E2C2404153C09C3B043F3E6E434083BA47EAA84153C0E034CC29B16F43404E97A1FE4E4253C09B66DE0A9E70434034D868272D4353C0C8F45E38B4714340A29F536AD84353C06816DCA714734340F2B67F905F4453C00830EFB07273434058593941654553C0F8163B90A27343407EB2BE0F394653C0D87CE02F40744340B268EA7DAA4753C038BEF9698F7743402FDCB8C90F4553C0705702D2B67B4340363AE04CAF4253C0B8DEE55E817F4340B09C69EDC03E53C0C818D9E66379434026D89E35323A53C0F4ECD5014D7243406C52243BF83D53C0D0559C0E4F6C43400C9A79BB774153C050A22016C1664340,-14.2%,-58,350,28,322,District of Columbia,true
5,0106000020E61000000D0000000103000000010000002D0000000CE49BCB1FA65DC058FA001984844040A5109F39C0A55DC08B9663F6D58340403D6BD144F0A45DC0F0428E822784404073513D971EA45DC090D008A30A834040075B099630A45DC023AB932E5B8240407A42BEFDD9A35DC0CC49BC71CF8040407F3D11B72FA35DC080B752AC338040400D4A8016E2A25DC000498090287E4040DF793B8506A15DC004091610A57A40405408D77B48A05DC0C8ECDB797D784040204A8EB0F29E5DC06071A5FCF67540404BD7010DDF9D5DC02C7218D118754040C589C2A3D79C5DC0F8E7855CE57240400CF6CA150E9A5DC0B0726C00A06E4040CE732C6B72985DC0E4519B33806C4040C8225007F6965DC0FFA7C048F669404060FB7CD375965DC0D893D035CA684040E0E3D12845975DC01BE8CF358E68404023A3A66A96985DC0DCB5EEA7856940402DBF58E7B1995DC068E0D46FF5684040A8B67CD3DD995DC070557BE0FC674040623E7CD3539A5DC0DB48258BA767404067D9B461339B5DC0A08A7392B56640404F968B72759B5DC0F896F988C4664040EEC516360E9C5DC0A0408EE39068404015237A68CB9C5DC0D0F4FF0FCF6840402608D8535A9E5DC0282D9792476B404056AEC48A5A9F5DC0C3D3CBCC256C404063BAA911F29F5DC0C0952A60E16C404015529DF26EA05DC0644BDD7CC06E4040454BA7D38CA05DC01000F620307040406FCAC4294AA15DC0040676FA5671404053024CC0FFA15DC0787D04DDA2734040D9FF2FED67A25DC0581B43AAEF734040D6A642B300A35DC038AAB799997540402EFE868115A35DC0949871DEF5774040FACB47154FA35DC0B0B0463B03794040930C8A90C1A35DC060B0DB74FF7940407A28E6C0D5A45DC088239155087C4040A128D2281DA55DC01417268B6F7E404010E5695E8DA55DC0DC1B321B6D804040D07D9D2700A65DC067B014FCC8814040C2F4A07AEDA65DC0148D3419D7814040F2D2819DDCA65DC07C5BD719F38340400CE49BCB1FA65DC058FA0019848440400103000000010000001F000000D131F98FDAE05DC0E80EA0EE62A34040D4EEBABEDCDF5DC04C4FDA6010A24040689CAB4B45DF5DC06C86733833A24040CFE159C9E1DE5DC0B03D25C1BDA140400BA9F3BF94DD5DC0C0917673D6A04040E4A4328360DC5DC02044C46AFF9E40408154263CCEDB5DC04BD214CC9B9D404058C44F2DCCDB5DC0F8640F6BAC9C4040C3C8B2901BDC5DC05CC000D9239C4040A4DC339498DC5DC05836E1E2119C4040FD295DA638DD5DC0A81EA43FA59B404082F00E74FDDD5DC0B80D1A76AF9B4040AE13C5AE44DE5DC07CCFD5BE8F9B4040D2FC88F72DDF5DC0E8ACC0B1E39B4040403B07CC6CDF5DC0FC23DE11009C4040315BC80FB4DF5DC0B76A2F60D19B404081B9CC3229E05DC0586A6D29469C40402BBBF165F7E05DC018E1A4D86D9C4040734568187FE15DC0A40943E72C9D40405C464DFBD3E25DC028B3A7E29B9D40402FC61C3E48E45DC08886F92AAD9F404019A9B1C949E45DC03C9C37CA51A0404043B1311CC0E45DC010D3AC4320A1404010F7F217A7E45DC0DC277B83E3A140400F72D21F0DE55DC077D4C62257A34040B426A837FCE45DC0CC3EB15DC0A340409E114025FFE35DC02F63BD6AC8A240405933C1BC3CE35DC0086F2FE0DAA340406A21B3A6BEE25DC09409E3E1DCA34040C5E8CBFB0DE25DC040D515C4A4A44040D131F98FDAE05DC0E80EA0EE62A3404001030000000100000063000000A99A418B4BA25DC06071687317BD40402BECFB33EDA15DC020C3E62D28BC404061C743688FA15DC09CC82850BDBB404086337AC622A15DC0C04EC126DABA40408165B00584A05DC01B9372FC32BA404015BC9A2FFB9F5DC050B6F3FDD4B9404081B98BCDFA9F5DC03819B0195DB940403D3A5ADAEB9F5DC0B8322445A9B84040365DF44D8E9F5DC0B0D6ADFE85B8404099634867639F5DC0A4CE5B0AC2B84040100A45AB149F5DC084D858B7F1B840400025C041FF9E5DC01096BF5C3AB940404397938A859E5DC0C85016E445B94040D568A86D3D9E5DC028F6E34592B84040101522F4F49D5DC0F89A40D9A0B84040E94F44E79E9D5DC088E8C5CD4CB840402CBFB457489D5DC0102BF0B0B1B74040874D3AB0CD9C5DC00829F84047B740401A5D5675779C5DC048B647D7DBB64040C086D6D9FC9B5DC0503C775AF5B6404037594540C49B5DC04C7EE906ADB6404032446F007C9B5DC068CEE6F7D1B64040FA68C2A0F39A5DC02809E1FCC6B6404066DCC3A73E995DC038B88F443EB5404068DC35FDE6985DC0D490B9586FB54040A56C6B807C985DC0B4E12D208CB44040FBB85AAD47985DC0502141DF80B44040B9454D12F0975DC0472BCFA781B4404009903B14A1975DC0C09BF33546B44040E143CB4592975DC05C8D1C5EDAB340405152A7697B975DC0E8DC21900EB34040CA8C8035A7975DC04011B06F8AB240402D9DF50D92975DC0C8052ED6CAB14040722A118F41975DC010224114B3B1404055E80278BA965DC08CAF59E24CB0404069F31D01FE955DC02C2C4410F2AE4040A97507833B955DC068CDCA68F7AD40405FFE669CE5945DC0EC6FD5CBA8AC4040948481D0E2945DC0E041CD191CAC40409A59062DA8945DC0409B56C3EBAB404096C066E64D945DC0288E3C7DF5AB4040804E812CC1935DC0100283CF0FAB4040FFDD24617A935DC0B41CFECDDDA84040A60AA9E2B3935DC084F860F6CBA840407361299AE0935DC0BF93BDBC38A84040631FF54E7A935DC06CF89B9F8EA740405D180AE7F9935DC01C9954021CA74040BC4F4F3124945DC0E8A5A8C89BA64040D3BA83C1DD945DC07850789939A64040BBF35C2325965DC0384F38D211A74040D586E071B7965DC090E2B9910EA84040047347D44B975DC0E077E57D53A840408A6407A9FC975DC00CBF10C3E5A84040739527A359995DC05090750BF9A84040194DDD11459A5DC058377EF201A9404074B168EE0C9B5DC03010F77787A840402A261ACA679C5DC0A3B65050CFA840400EB1E062AB9D5DC08C9EBAEA68A94040D5C86DE2419E5DC0C79AAFDE9DAA4040FEB04FDAFD9E5DC0CC68C12B4CAC40404528E44D559F5DC00C54114BE3AD40404E55BB68009F5DC0D481402F28AF4040A7B19F531D9F5DC0DCC66FB6ABAF4040AD9EB27EB99E5DC004C49088A8B04040714ED44E649E5DC040550D88F1B040400C86903FAD9E5DC0D091750881B140407D71DECF2E9F5DC0D0FE0A578FB340407E2A166E029F5DC044603F87E3B34040E9A96F752D9F5DC00468394F43B44040DA75234A209F5DC080152F6F3EB54040F9864432689F5DC060A3FA48B6B54040804B923DDB9F5DC064BA3B72F1B54040AA354D0540A05DC0CC78CC3B2CB640409AB177F8ABA05DC08F33BF9A43B64040C149227A00A15DC068D1790925B64040E141F59A54A15DC0B440FDCCB8B640405130E68BF6A15DC0A80931BDDBB640405E0A41D43EA25DC0A8149CB0F3B64040F3ADA851C0A25DC0C8916B036AB74040358C21B741A35DC0D09422DB74B74040B3C4035DCAA35DC0A8CA75C267B74040BCCB636545A45DC07898DAE5EAB7404075DB1D96A9A45DC09C81F5520DB84040201C32FFB7A45DC0184606D560B840405B6F2D56BEA45DC0C49AD1A32AB9404009ACF2230FA55DC0285A6CAC67B94040F2E7E18566A55DC0D0948773F7B94040558A1B1FBCA55DC0F05A5669E4BA40405F80E5EA22A65DC018B59202BDBB40403F8B7B1289A65DC094C3B52159BC40404E4B4184A6A65DC0682B4ADE00BD4040E6110C1533A65DC02C284B750DBD40403FC275C78DA55DC0ECE8B485DFBC4040F9F611FFFDA45DC007732C10F9BC4040F96CE6BB74A45DC0F817229DBDBC404033E671550FA45DC0307DF63D99BC404053FD01A4F0A25DC098B912BECDBC40402590A8699AA25DC09CFA7876E6BC4040A99A418B4BA25DC06071687317BD404001030000000100000010000000735AD128F5C15DC0189D248BABBE4040735AD128F5C15DC05058248B93BE40402C9FD128EDC15DC08C26258B9BBE40402748998BDAC15DC0D8369EACF1BD4040D0C612B5D8C15DC00490895783BD4040A7913859BAC15DC0B86196A8E4BC4040185D9D4A03C25DC0B871CBEE99BC404028B0BFD301C25DC0D4C78D46B1BB4040DB8967A36FC25DC0083811657EBB40407C2C514486C25DC008C62BF7DFBB40407BAFC1C5C1C25DC0C0683B5F59BC404099937EC5D1C25DC0140D774729BD40408B41607814C35DC008C9730B8ABD4040D855277E04C35DC0406B258BF3BD4040BAFC10795DC25DC07F0595FDE2BD4040735AD128F5C15DC0189D248BABBE4040010300000001000000160000005358703F808E5DC070DC7E40FAE14040BDD5C8AE548E5DC0A09D9BC9C6E0404095836FB39B8F5DC0380ECCA91BE04040243F6F4B208F5DC0B001C99C30DD40407FD1D23302905DC04F137D859FDC40406E1C8371B78F5DC0A8588A2B81DB4040F60264FC7C905DC0AC3B340BB8DB4040401E1F92B9905DC0B40902CECCDC4040055B3C8795905DC0EF968D365DDD4040F4029DF0A28F5DC07879053FFDDD404036B2F583EF8F5DC04037823BEDDF4040FD2FB0243F905DC0C447541A84DF404092954F2412905DC07F9405113EDE404094A0A10DAD905DC0284D9FD1E1DD4040323D6FFD30915DC050CC28A04DDD40409BC49DC155915DC038FD6982ACDE40403973E3D11E915DC03885A6A39EDF404095C8CDBC51905DC0B0D221DA08E1404010D8F93D05905DC094DA9F93F7E040408DFD3C0BB78F5DC068BC264B3DE14040E38462EE048F5DC0ACC2E6FDAEE140405358703F808E5DC070DC7E40FAE1404001030000000100000010000000EA89AA9C2CD85DC0E821C76E50014140A03501E4F6D85DC08C796AFD46004140A128D2287DDA5DC004CC7AE0CC004140C30B62001EDB5DC0A09E96DD9B004140C146482685DB5DC024B1383E08014140EB8B64F21ADC5DC058B4BCBC4A01414003BBEF857ADC5DC0FF2350FACB01414089BCF55F1CDC5DC010C50EB1E1014140EF04EC17CADB5DC02410BEF0FD014140CFC643A5D2DA5DC010C6AAE3E6014140FA44F97053DA5DC04C1D2E5D34014140F162F07C1BD95DC0C04D56E4CE004140FA0FBCC96BD85DC0F0BE4B926F0141401329FE694FD75DC05C04C0D13E024140CE1643DED7D65DC027FA48C601024140EA89AA9C2CD85DC0E821C76E500141400103000000010000002A000000F94DE771B5025EC05036DC2998034140BD2AC92D32035EC0340B575BFF01414051DB061B02035EC0808041EE7C0041401382598A2C025EC04CB22C77AAFE4040AC458B9988005EC0F0C7F4BE50FD4040E39225FEBEFE5DC0D4222F40E2FD4040B958F25AA4FE5DC0944636ABCCFA40406C82A1D41FFE5DC020163BA5F9F940400125375001FE5DC0B843108276F84040748DAEE9F9FF5DC0D00F2F6482F8404049D31B7936015EC00054D65592F74040497A27182E035EC088F3B68D17F54040ED58220690045EC07861A65FB5F440406CC747FD28055EC0D36E7AB203F44040D62A97AC7B065EC058737DEF14F4404078387509FA065EC050E1109D2AF34040EEDFF27408075EC028A59D6A52F24040FA8C46FCF2075EC0C027BE3092F24040C425D1A289085EC014320DC08FF340403040B1C7C4095EC07846C22EB2F440403D9BA9313D0B5EC0BFBCFBAE0BF6404020BDB450CE0B5EC0539C1273FDF74040F4A0CF961F0C5EC058ADD932EFF84040164EF655AD0C5EC0C0BF3776DEF94040F82833A3740D5EC027626D7A7AFC40402D484BFC090E5EC0C8199F4305FD404033C408796E0E5EC0604887CE85FE4040FF7C08FB2D0F5EC0F02B3B76F0FE4040FC1E9CB2E70F5EC0B85F49EF2400414047EE7CE1230F5EC0F8FFC276200141407DC5A86BED0D5EC064FE9D6959014140D8A43917DE0C5EC06076BBDD99004140ED5D8C79E40B5EC0E09A2A3B24014140EC21350EF10A5EC0F8D175F0F20041408E8084A0240A5EC000EFA3B50A0241400A81448F4F095EC0C0E1DFB62203414060FB7CD3B5085EC00481CF352A0341409AD5ABC32F065EC07FC42842490241403010F478A3045EC02CC19ABE2F03414061F8A738B4035EC0546F6722D60441408875402BD3025EC030811C5AC5044140F94DE771B5025EC05036DC299803414001030000000100000020000000871E068D15175EC0F0465BE6CB064140F507C6FEC8165EC07824AFBF06064140D48BFFA00D165EC09C350275F3054140DF2A20317D155EC0F831C1E53B064140459B65A723155EC0EC8303D3090641404E4612735F145EC02B42BC8520054140DBFF0A70EC135EC0341A4EBA69044140E8F94B9F9E135EC08C5874FA60034140BCFD3F35BB135EC0A0E9EF6354024140D34F5D5E18155EC0C007357162024140B5654C967A165EC077E101516F024140A8FFBE6F11175EC0E40D5292E30141409B5CC2BDEC175EC03856851A46024140D07E99F278185EC03CB7FAA516034140FFE2733623195EC050AE81D8520341406C23329AFF195EC0277279670504414056AFE689921A5EC0F8B5E6EF2704414015DE550A1F1B5EC080B5CB6D3103414031C62F6B0B1C5EC090A16E9DC803414073AA3EB58C1C5EC004728E23DE0341407CAC94BCBF1C5EC0FC0F8141970441403C0CF0B4071C5EC0D03C79D2EE044140292133D8931A5EC0CF7720BAF9064140DD7D2F67D1195EC0FC7E0823960641406981E0FE37195EC0E455CE0CD20641404D5F591352185EC02026C67ECB074140BC9D375A9D175EC09880C2BA2009414073A382CF9E175EC040D17BBEC10941403FBB267E2E175EC028B979E02C094140ED59414DF9165EC0DCD1AA03510841402411AAFFCC165EC078DAEC457D074140871E068D15175EC0F0465BE6CB0641400103000000010000004B0000008DEC5E4273F55DC008754F9323084140C0AB277EC2F45DC004CC7AE00C074140EC717CD3A5F35DC0D02CD035A6064140184DD2556AF25DC0E021E12F3107414099644D5AC8F15DC080112D86260741407103C3C197F05DC0088352BE24074140D469206D2EF05DC09F66262AB1064140C2AB277EA2EF5DC02CB979E0AC064140929FEE182BEF5DC04C950C6DF10541408B181381DBEE5DC0B4ED8721370641404D3C4FB88EED5DC02C7D7D9B680541407F255AFC0AED5DC0A861F0846C044140D0763EFC4FEC5DC08876F7D59C034140F54B70EFDCEB5DC0383174248B024140FE4FEF5654EB5DC0D87F70F4A70241406D35602DAAEA5DC080B1105A25024140A50201A7E1E95DC018315A5E7102414045B7961086E85DC0C092BACABE014140AD7C9DA166E75DC07323B76380024140EE929D56E8E65DC09C17FFCFC5034140AB48288A0BE75DC058B63D1E130541409508AD4AACE55DC05499D9F65C064140DFE3E77AD3E45DC034CD3F977C064140071C7CD327E45DC0707479E014074140E2F8A9D614E25DC08B5CF1604D0541403A6E512960E15DC0C84B84A8630441406056D71DE2E15DC0F005FB563B034140682DA00BBBE25DC09CDDC4BE9402414070F92E89D9E25DC0FC60B235BE014140162EAFB20FE35DC0970706107E00414071411632CFE35DC0F8CA7C8145FF40406AF21A0F24E55DC0708A70D52DFF4040D46EEC53BAE55DC0084625BC97FE40407815FC10FDE75DC0EC7B255B60FE404069A16B2C4FE95DC02B84DB353CFE4040D650BF7817EA5DC0C0E0B34537FE4040B859BAEAB0EA5DC0B0B69A96D4FD4040779E39FD16EB5DC028B7204732FD40409B4939CAA7EB5DC0807B3780F8FC4040671C2624D6EB5DC0884D6DE8A7FC40404ADEB8A6CFEC5DC0A00D7B9FFFFB40406C86C9F136ED5DC0DCA25287FDFB404064AB1BBA9CED5DC078EBAA2418FB4040EF5D3C7C0CEE5DC020749AE9C4FA40404A23226C80EF5DC03857B18B31FB40404A3787D338F05DC020BFE4B12CFB4040E8CBF95F97F05DC0B0263C2C8AFA404032F0EB3969F15DC0FC671E1ED4FA4040DE8F10B572F25DC0D8097995D9FA404005E96ED94CF35DC0701995804AFB4040491D82154DF45DC09423CF95CBFA40403411BC08D0F45DC06C7A0955B7FB4040AEDF81D1CAF55DC060177F011BFC404077DCD2F872F65DC0F06C0835D3FB40406D56063378F75DC0532DE6B74DFD4040B0B43868F1F75DC0C09D742A72FD40409F14B89866F85DC094AD4389E4FE4040F437098799F85DC04F7B4E3D3C0041402EC3D7BBC5F85DC01B8AF1971F01414076660C1D22F85DC0809FFC1A1F03414061BBE96624F85DC0C3D3306528044140CB48CA64B8F85DC0D8525BBFE0044140F1FF08288CF95DC0A0CC18565906414079A57CD377FA5DC0D448258B27074140A8D0F9E9D2FA5DC06CCED55E5D074140F6C1EEABFAFA5DC02802A2BBFF0641406EA5A0066CFB5DC0787F0776240741409DBEB695B6FB5DC0172BB296B50741406E61D39927FB5DC0543C90D18E08414029AAF4FCF1FA5DC0E0EBD5AE66094140050CE4CFB3FA5DC0D85CD3C8160A4140DAF1646CE5F95DC0B0F5B2B88209414025C21854C5F85DC098CFB1B182094140E208FF73CFF65DC0B3C795D8070941408DEC5E4273F55DC008754F93230841400103000000010000000A000000F7FF267E26C05EC0F8CB7AE0CCD942403D06D22831C05EC068EE7AE098D94240AF44277E1EC05EC09813248BBBD942409E28D2285DC05EC08071D0357ED842405022277E52C05EC088F7CE35BAD8424087C1D12859C05EC0F8CB7AE0CCD84240EE717CD365C05EC02004258B8FD84240A06BD1285BC05EC0F8CB7AE0CCD84240AC44277E7EC05EC0F8647AE028D94240F7FF267E26C05EC0F8CB7AE0CCD942400103000000010000000D000000717702399F975EC040C88F2B87E84240BE891A1278975EC048676C31FDE74240F2B7D3EF25975EC0B058909B1EE842403A97E5F504975EC0E88F27989DE74240D2C77CD343975EC06058248B53E74240650FCEE9AA975EC058E8CD399CE74240C2308A92CE975EC0D447541A84E84240B2BBF24C14985EC07B47BB8831E94240ACFA290F44985EC024A6220122EA42405A96CA69DC975EC037B26F2499EA42407EDAAE5188975EC01CC3E9BF6FEA4240C005D1D437975EC078781CA107E94240717702399F975EC040C88F2B87E842400103000000010000000D00000011A6051B369B5EC040DC092E8AEF42405B4E4534BE9A5EC090DCA10879EE424002C85CEED39A5EC0D007ADC94BED42401C837CD36B9B5EC098427AE05CED4240342D7CD3ED9B5EC0C0107BE024ED42406E17D228579C5EC068557BE07CED424076A57CD3579C5EC00436248B87ED4240BE607CD35F9C5EC014E8CF358EED42401C837CD36B9C5EC08026258B9BEE4240C2AB277E429C5EC00C81CF352AEF42406489277EF69B5EC0B07A248B1FEF42408B39E004D09B5EC044332AE57FEF424011A6051B369B5EC040DC092E8AEF4240010300000001000000E6050000583894E60B005EC06F4DE5BB7DE84440C88E61B30A005EC018107E550BD14440912694E609005EC03CC118EF98B9444009EE2D8009005EC0D412E5BB25A2444081B5C71909005EC088464A22B48A44407B44FB4C08005EC090F7E4BB4173444042DC2D8007005EC044BA7D55CF5B4440FC7360B306005EC0E80B4A225C444440FC7360B306005EC0F0BCE4BBE92C444074CA2D8005005EC0B4F0492278154440665961B304005EC04C4216EF04FE4340E420FB4C04005EC060F3B08892E643405EE894E603005EC0FCB5492220CF43401F80C71903005EC02CD8B088AEB74340170FFB4C02005EC0C4297D553BA0434095D694E601005EC0D8DA17EFC888434095D694E601005EC068E7E4BBB18143401806FA4C00005EC054CEB088E67F4340F60E61B302F15DC05397E3BBF96A43409D20C71905E25DC0A84E18EF0C56434049322D8007D35DC038B87C551F414340293B94E609C45DC098FEE4BB312C4340568560B30CB55DC080C717EF44174340348EC7190FA65DC080904A2258024340DB9F2D8011975DC070E8B0886AED42408AB193E613885DC0E09FE5BB7DD84240C6BFFA4C587C5DC0AC85B188DAC64240439EFA4C9C705DC0686B7D5537B54240C27CFA4CE0645DC034E07C5593A342407DC3C71925595DC0DCA24C22F091424081DA2D80694D5DC0988818EF4C80424005B92D80AD415DC0608C4B22A86E424084972D80F1355DC02C7217EF045D4240B9A594E6352A5DC0E857E3BB614B4240ACED93E6ED1F5DC0D44D7D553B3B4240CD2C94E6A5155DC020A3E5BB152B424072332E805D0B5DC00C997F55EF1A4240103AC81915015DC0E88E19EFC80A4240FE81C719CDF65CC06496B188A2FA41409D8861B384EC5CC0288C4B227CEA41400598FA4C3CE25CC0A02217EF54DA414073A793E6F3D75CC08C18B1882ECA4140A4D1C61967CC5CC07C567E550BB841409021FA4C00C05CC0A03D4B2200A541403CBA61B31CB45CC0602FB288BE9241409AFF61B334A85CC06CEB16EF74804140A1A661B32AA85CC034474A22907F4140F32CFB4C7CA75CC05C4A18EF8C7041405213FB4C0AA75CC018947F550B6F4140922BC71907A65CC03046E5BB716E4140E9CBC7191FA55CC050B2B088AE6D4140EFAEFA4C64A45CC0608D17EFE86B4140A0C594E6E1A35CC0B86A4A22E0694140DD35C719A5A35CC0B0BA7D55536841408D7894E685A35CC074A67C55BB64414041F794E6B5A25CC08840E5BB496241408C27C8195DA15CC0040618EFE4604140D89C94E6A19F5CC0386FE4BB7560414003ACC719739B5CC0E83AB2884A524140B0A8FA4C2A9B5CC070ECE4BBC1514140524E2D80F39A5CC0CCE54A22305141403B49C719DD9A5CC0C00616EF2C504140524E2D80F39A5CC0F852E4BB214D41403B49C719DD9A5CC00BBA4922484C4140F89194E6179A5CC0F097AF882E4A41404261C7193F995CC050A216EF144941408E6D93E68D985CC0A0F516EFD047414002BBFA4C3E985CC0A849E5BB35454140C0E861B322985CC038A9E2BB2145414079EBF94C80975CC078A97D55DB4341408A1E2E80C9975CC05F6D7C55FB414140868094E621985CC0D46117EF0C404140CE592E8023985CC0AC5CB188F63F4140954861B310985CC0B43819EFBC3E4140594AFA4CDE975CC0CB4C7E55333D4140B255C7199D975CC05B847E555B3C4140C3DEFA4C48975CC02CAD4922C83B41400C3361B3DC965CC0E04F18EF983B414065ED2D8007965CC0F820E6BB893B4140745594E6B9955CC008E0B188763B414006C02D8077955CC0087CB0884E3B414049E961B334955CC0B8F64B22F43A4140D7F394E6B5945CC0D88D4922083A4140DC52FA4C66945CC04F21E6BB9539414052232E801F935CC0EC397E55333841408F7093E6CD925CC0749DB188BE3741401635C719D9915CC03C9D7E55DB35414038C961B3828C5CC00074E4BB692F414071BE60B36A8B5CC020FA16EF6C2E4140A80B61B3CC8A5CC0E849E5BB8D2D4140105AC7190D8A5CC080627D552B2C4140CF1CFB4C02885CC0A7C417EFF4294140426AC719FF875CC05816E4BB3528414019C160B39E875CC0889A4A2288254140D2DFC61927885CC0C89E4A22CC2341406620FB4C2E8A5CC088DA4A223821414053862D80538C5CC0047EE3BBB91D41402E97FA4C5A8E5CC0108FB1885A194140BE7FC8199B8F5CC0F8C97E55CB184140507E61B322965CC0C83B18EF0C1141405915C81975985CC0F06AE5BBD50F41400B6261B37C995CC04C224C220C0E4140E4C0C619279A5CC0E08B18EFA80B41404E9EC719AF9A5CC088DC4B2234064140A7E793E66D9B5CC0787017EFB80341401E8561B36E9C5CC0206618EFA8014140BA3F61B37C9D5CC0005EAF88EEFF40405E012E8005A05CC0C8D17D551FFD4040DE06C71905A15CC0BCCA4B2258FB404071E52D806BA15CC0D00818EF80F840404A8261B334A15CC0AFF8492204F74040EC1E2E80AFA05CC06FD64A2298F540408F2D61B36E9F5CC0132F4C2224F340404731FA4C589F5CC0A0CEB288FEF140400C7A2E80DB9F5CC0B08B7C55D3F040401D6F94E605A15CC0E0F37D553FEF40401382FA4CE6A05CC0E4884A2250ED4040C53794E6E3A05CC00C6CB18806EA4040FB3FFB4CA8A05CC0F07CE4BBEDE64040683561B3DE9F5CC018D7E3BB8DE54040C401FA4CA69F5CC038F5AF88DEE44040C1E72D80939F5CC0FC20B0885EE34040C401FA4CA69F5CC0C84CB088DEE14040683561B3DE9F5CC04C597E552FE14040124D61B334A05CC028E24A228CE040404DFCC719EF9F5CC087B3E2BB21DF40408426FB4C3C9F5CC0F8EC16EFD0DC4040CB7BC719A99F5CC0CC7B17EFECDA40409D8C2D8067A05CC0D83518EF7CD940402C032E801BA15CC068A0E5BBA5D7404071E52D806BA15CC0AF997D5583D44040691B61B360A15CC060AD4A22C4D1404086D0C7196FA15CC03079492254D04040D7B0C719A3A15CC00C1418EFB4CF404008F0C71935A25CC0AC507E55F3CE404008F0C71935A25CC0240D4B2240CD4040C3B4C719DBA15CC01827E4BB75CA4040396BFB4C16A25CC03807B188C6C8404019F52D804BA25CC01F8C7D55EBC74040B99361B32AA35CC05C684A2204C64040AEA82E806FA45CC01411B288E6C340402AD293E613A55CC004477E5593C24040C6C061B3AEA55CC0BC1C16EF6CBF40406D3C94E60DA85CC0B8CD4A22F4B74040D22B61B332A95CC044644B2280B64040C44994E6C5AA5CC0B8CA7D55B7B54040DA022E80E9AD5CC0B02D7E5553B54040D3A32D8085AE5CC0F0217E55ABB44040A52695E63BAE5CC0B04D7E552BB34040F28260B392AD5CC0284B7F558BB140400EF0C7190FAD5CC0AC9BAF8886B040405E0EFB4CAEAC5CC0B4B44B2228AF40407850FA4CECAC5CC098D0B0880EAE4040743794E6B1AD5CC0A0667E55ABAC40406DD893E64DAE5CC0284CB1881EA9404001BFFA4C2AAE5CC0C8E616EF34A74040C14BFB4C2AAC5CC0F839492260A340402EA3C719B9AB5CC0984AB288A2A14040817960B312AB5CC0174E19EF3C9A4040DC4FFB4C68AB5CC030C94B22B0944040B046FA4C60AC5CC098B4B288E28F40408ED92D8097AC5CC0C0844C22708B40402D03C719ADAA5CC03049B088EE8640404B53FA4C26A85CC04047E4BB3D854040A8F760B356A25CC02C8F7C55878440402D36FB4C1CA05CC0D4074C227C8240405B8594E6519E5CC08C2A18EF1C7E404035C9C719119E5CC0100AB2887E7C404027A8FA4C189E5CC0F080B2883E7B40405962C7193D9E5CC0D4687F55FF7940405B8594E6519E5CC0787D17EF64784040553E94E64F9D5CC098C9492238704040BA3F61B37C9D5CC07FE3E2BB6D6D404070F460B3369E5CC0DC7B7C55C76B404090402E8097A05CC0D0A717EF0069404071E52D806BA15CC074B74922506740403BE6C719A9A15CC060E4E5BB15654040DD60C8199BA15CC0FC2F4B22B46240409F12C719ADA15CC03051B1886A60404019F52D804BA25CC0C098B1887E5E4040F0C0C61901A55CC0FC607E55735D4040C976C819B5AB5CC060D4E4BBC15F4040C0062E8021AE5CC06379B188BE5C4040571B66AC5AAE5CC080E0852F3E5B40405590E9AD5AAE5CC0E06F2B393E5B40407C14913BEEB05CC04CBA9002DC5A4040DE9F120AA3B55CC0EC02CB6F235A40403F2B94D857BA5CC000DBC0186F5940403C78D57F0DBF5CC010817837B8584040C4F0554EC2C35CC0F4D5EE2E02584040078FD81C77C85CC00F7CA64D4B574040691A5AEB2BCD5CC060A5DD1D9656404012F71CE1DFD15CC018EE178BDD554040D1D9FD1B95D65CC0909ACE0C2A55404033657FEA49DB5CC0B840862B735440409BF000B9FEDF5CC09095FC22BD534040ED94A1CCB4E45CC01C10751A075340409D7164C268E95CC044B62C3950524040A3A586241DEE5CC0DC30A5309A5140400B3108F3D1F25CC0B0851B28E45040406EBC89C186F75CC04800941F2E504040C5602AD53CFC5CC074A64B3E774F404029ECABA3F1005DC00721C435C14E4040D2C86E99A5055DC0A0F2BA7B094E4040D7FC90FB590A5DC078F0B224554D4040F436D1A20F0F5DC018C2A96A9D4C4040922CB3DDC4135DC06CEBE03AE84B4040FAB734AC79185DC000665932324B40405D43B67A2E1D5DC02C0C11517B4A40406477D8DCE2215DC0C4868948C5494040CC025AAB97265DC013B0C018104940402E8EDB794C2B5DC03056783759484040CD83BDB401305DC0F8AAEE2EA34740404EFC3D83B6345DC0D876A84DEC464040EFF11FBE6B395DC0BCCB1E45364640404F7DA18C203E5DC05446973C80454040FF596482D4425DC0289B0D34CA4440406BCA8FFD01485DC068ECEFBE0D4440405322277E12485DC018E8CF350E4540405DFB7CD375485DC060A3CF35B648404046BDB89E92485DC0B0A77E01E44B4040BD0C87B7C4485DC0082F203FD14E40406889277E96495DC093F7CE35BA524040ED717CD3A54A5DC0304FD035B25540403FBB267E0E4C5DC0D8B2CE3562574040C6EF8C9A554E5DC0D89809B9A45740401990FAD4794E5DC048C65F113E594040B072FFF6144E5DC04049E1BE715A4040D1367C0D2C4D5DC0A00207CB505B4040718FF59F384C5DC0C885367F5A5B40409E85D0E3054C5DC028F8C2185C5A404090D98876C14A5DC01853EF7172594040D80A7CD3814A5DC0F019CF35865740401D32C780F9495DC0580D5F1F105640405C256E9423495DC0C88B9B4D9953404074D7DADA66485DC0AC472B4FC45040408CD47604F1475DC050517083AA4D4040FA0B1F9F5D475DC0B41DC85ED54C4040AB1692D89D465DC01C1B03F7AB4D40401F1BAF438C465DC0D002FC806B4F404043956D4FAC475DC05086798289534040DA2DB0F79D475DC0530E2D8CD6554040F9FF267E86485DC008CC7AE04C584040B486C4635D495DC0FCD1F593DD584040FC4AD228A94A5DC06FBF248B775A404025AF1198594B5DC07834761F865B40409BE062452D4B5DC0402DE08E055D40403D4C424F6E4D5DC0203F5D1CD65C4040D87528035A4E5DC0C835E269FC5B40409A424BAA384F5DC0D8603849865A4040D0C77CD3234F5DC060A3CF35B655404077A44BA9B24F5DC0902C80C6585640406889277E56505DC0888D258B7F5840409ADD267E7A505DC0543CCF35D259404004969C734D505DC0A43BAAA98B5F4040C2351F863F505DC01875B106BB614040758F08CD7B505DC0D854322162644040074CA6BED7515DC030E055EB51694040F191157526525DC04C78EB3E386B40409A88F0C285515DC048578B57F26C4040F27927C706515DC0944004A86B6C4040F05D91C5A1505DC0480DEB0F526D40407C8E35A73B505DC044319A584A714040D6A9622584505DC088DBBD90597440405EFB7CD395515DC00781CF352A7F404055223D63E4515DC0207C99B6EC8040403DBB267E4E525DC017E8CF350E83404020D02AAA13535DC0C8F2698098844040BA341B4A9E545DC080A82259E38D4040691ED49929575DC097F0CFA23D954040185350E790605DC010EE2B02E8AA404002D97CD329665DC090F7CE35FAB14040CE7CD128E1695DC0543CCF3592B840402B9FD128ED6A5DC0BC107BE0E4B94040EC717CD3C56D5DC0FC35248BC7BC4040382D7CD30D6F5DC000CC7AE00CBE40405322277EB2715DC0C0C5CF35C2C34040F2717CD3C5745DC0B8107BE0E4C740407EDB7D0856785DC0C854657FE3CB4040630C4BBA887B5DC020E3EC45D0CD4040C1607CD39F7E5DC0D048258B67D140400D7C6658CB855DC0FC173FA990DD404055C6D34683875DC0C014D27F2EDF40408DB7C8E2C3895DC0282B81391FE1404041DBE7E71C8B5DC0E4E43843B3E14040780A71C6DF8B5DC0D8B36CFCF5E04040B5800FDFBB8C5DC094E59FEBCBE14040A5F2BDEC428D5DC09838634CC5E14040E24BAEE3518C5DC0B3AEAAA84BE04040B534648DF18B5DC034A96CF5E8DE4040A43A9922DA8B5DC008582661BEDD40407054A0DC578C5DC0FCF61548A9DD4040F1F22B6BF58C5DC0685A1443A0DE4040E59B3DC8F98C5DC0B400B2C68FDF4040C918374C6C8D5DC0F03C734103DF4040B4565058AF8D5DC0987C7AB3E0DF40402C9FD1282D8E5DC02BB979E0ACE24040D3C77CD3C38E5DC0344FD03572E240400F5054A8618F5DC044300B2A40E240401498F87D01905DC02CB1DE61C0E14040B9550C944A905DC08CC1F9A4F8E1404002D97CD3A9905DC0687479E054E1404080F0B1B93F915DC08BC7FFDD75E04040760F149BB6915DC058326DCAD8E0404054FA4ACC85915DC078730D7A09E04040F4C5CBF1CF915DC06C0895398FDE40408AC399F290915DC04041A9FDA3DC40401A837CD36B915DC018E8CF358EDB4040E3BAF08313925DC0D0F6B0AAADDB4040AAB60DC907925DC08022F56918DB4040BD93D75CAB915DC09C56E54A96DA4040298E739617925DC07862F6BC9FDA4040ED7593C4A4925DC0EC397ABA02DA4040CDD123A641935DC088180353DCDA40409CE7933852945DC00057360964DB4040F9E605A536955DC0F8D240A52ADC4040E07F9550B5965DC020A0DA3EF6DC4040AFD5D5B22F975DC06CE336FE2ADE4040945B23AD11985DC0781A4B2D5BDE4040A595F9DCA3985DC0905A1020BCDE40403C2818633A995DC088EF52C44BDE404036F94AD9AF995DC08819E9CB26DE404015F5AB61E8995DC08C5345E9B9DE4040AFEBFCE05E9A5DC0881A994FEFDE40408169FCE8929A5DC078EAAA7D90E04040817591DF0E9B5DC0779A6B29C4E1404057D7E1485D9B5DC04BE8089C09E34040FABB0713FF9A5DC00040E74558E44040355DF504329A5DC074DB648C43E54040A840A816279A5DC0036EEFF724E640405D622C6653995DC068077BAB1FE740408C482C4013995DC000CB24A6A8E84040C15C80800C995DC0A4DD481D00EB4040A5E72DE96B995DC0F8AEEEF008EC40407E0C253F94995DC098BE9F40F6EC4040BD3687103C9A5DC0606CE03CCCEF4040719A154F329B5DC0200509DDE7F34040745AD128759C5DC0F419CF3586F94040D2C77CD3E39E5DC0AF7A248BDFFF4040F6FF267EE6A05DC034B6D035D60241404D947CD3D1A25DC088F7CE35FA044140CFBC0BDDAAA35DC02FA6435BD9044140EF6BA11A85A45DC0789085F242054140D6172BC549A55DC0D02C4EFEAC04414009BB3DA8CEA55DC0D8E7ABFD000541400A2CB71C9EA65DC08CE57D00F80441407508D935FEA65DC0F8E786399004414054D074A9C3A85DC0D812DF81A8044140A17A1F65A9AA5DC098954B22FC0441406A626C143EAB5DC04818F623E10441409AF3D69D67AB5DC0B77EE2563A0441400369235D87AB5DC00FF9B7DDE1034140927788BE5CAC5DC0401312C4140441402DFE17E43BAD5DC064F3C345C4034140FDE2D0F0C0AE5DC0F0C80B6F2A0441406BD1E7A8E5AF5DC05C143AEC140441406A3723AB64B05DC0AC154EC84A034140EC958D2279B15DC0482F78B20A0341403EAA1B3423B25DC0B857CCA0CB02414061F2FD6F6DB25DC067F3EE588402414088CB676282B25DC0D4EDEB28DD014140DA59946FBCB25DC03BD0572B7B01414042AA100BCCB25DC054E8E31EEE0041405F7F3DB2FBB25DC040B085BBDB0041409C34698D60B35DC0CC2755299D004140EA3539B975B35DC070F73DF421004140D3198A61A5B35DC0E8626C8BECFF4040EF2F46AD1BB55DC0DC814D59AA0241400E6DA50F91B65DC068ABC8DE4E0441406D06C3DC35B75DC07CF8355068044140073275C90BB85DC0D067527ACE0441408262AEE93AB95DC0C87C2894EF0441405FE9405FC5B95DC03C48BA9923054140766C14578ABA5DC098703E9B33054140CC0C0B16F0BA5DC05C3B6BADAB0541400D60343885BB5DC05026C0EDDF054140A20C67A7F4BB5DC0902A759687054140847944EF0EBD5DC060B0F53520064140BE05346C8FBE5DC028FAD2DB9F074140FA16DBD9D4BF5DC078DAE843670841403F68A96184C05DC0844AFA9A76084140E05EDFD572C25DC0C05B35B6B40A41403418FDDDE5C35DC0A8995AA2F20A41403F19889DBDC55DC008D4BEA7DC0C4140B100890069C65DC09059CAC7280D4140A805B5C67DC75DC0C4EE730A9F0D41409D3C9F73AAC75DC0E0EAC8B7950D4140A11BFB6EA7C75DC0A88A8853470D41403F06D22851C75DC0FC35248B070D414016C78E1471C65DC0C472ADD2AA0C4140632F3098D0C65DC03C5E2877170C414039F182D93BC85DC0087E94B8DE0C41405088442AD7C95DC0608279C0E30E41409E23809B65CC5DC0C80741772412414094495B8F14CD5DC0F0D97EC271124140267357022BCD5DC0941BC02DA8124140AC29499711CD5DC06CFF5239FF124140A5D05F3919CD5DC04B8698FC23134140B828772855CD5DC098A8F4467F13414075F4ECDD72CD5DC034ABBED47E134140B4DF1BEF80CD5DC0788D253FF1124140CD2779A8BFCD5DC038164888A6124140DD4CDCC2E4CD5DC09C0EB9CD9F124140E5B3719421CE5DC0DF4AA8ED9A134140F4BFC87061CE5DC03807B50A1B14414043039B1A78CE5DC0ECC93F515E144140B6906157CBCE5DC018CA63896B1541403C4DFBB32DCF5DC0306AF383A31641409C28D2289DCF5DC0707479E0541841401A837CD32BD05DC06B0AD0351A1A4140A19EEE04A7D05DC0CC4FE1B7CA1B414016D13DEBDAD05DC06CBC3978001D41403D3DC52391D05DC0E0AE4582DE1D4140D1C77CD3E3D05DC044B6D035161E41408AC1D12819D15DC007CC7AE04C1F4140A366E8353CD15DC02067777BA2204140AE44277EFED15DC0C4107BE064224140976E78F88DD25DC02400B54E252341408E875320F2D25DC0882290F71C234140A7C303907BD35DC068A62CC4DC224140AFECD79D0ED45DC04C396CF0782341406473643186D45DC0080500692D244140A515C44510D55DC07CFDF55699244140F50C1A8DABD55DC0207C4E722E2541404AC201045ED65DC0981AAFEDEB26414004A1EB11F6D65DC0C04C2728B1274140F2219A3957D75DC0E03B08B36928414013D16F25BCD75DC030D34218EB284140FE03302103D85DC090200CB8FE284140E57CC0B573D85DC01075EB1EE1284140998272C4C2D85DC0F063795CB6284140F94D500C0ED95DC0C01869CDC22841400456B70839D95DC0C84D94FE4A2941401B22A742ABD95DC0D848EE2A502A4140546AA78D3ADA5DC0601DF7B5072B4140478EB2B3C5DA5DC0B477E42ED32B414080FC7A5884DB5DC00851E98D3E2D41408CFFFF88F1DB5DC0041F217C882D4140187349FB5DDC5DC02FAE11CB6A2D4140F9AB7981FEDC5DC047006EC5272F41408BC6B96474DD5DC0A82A608EE02F41409AFDA5CBD6DD5DC0C0D414B700304140B2523BD517DE5DC088EA67AA1A30414001A6352E45DE5DC073F32495DB2F414041E1795D6ADE5DC0B04B0395AA2F41401EF30E3E94DE5DC070F812AEB02F4140B25D7421B2DE5DC05C17C844EE2F4140DEB1C4D5F1DE5DC0904AA70B7730414085A393213EDF5DC0D0E43766C83041403B31B8D4ABDF5DC078922BD126314140957D143129E05DC050E20F2032314140AD80DC5A13E15DC0B868CE2F873141401F8F3F0253E15DC0A857931902324140143D8127E2E15DC054FC433A8932414001BD04955BE25DC058D40A61A23241408D0CB97F90E35DC0007D99A48934414041BAAA0F0BE45DC0ACF291FC1735414077EE57435AE45DC0CC8771C2FA344140D31CEFA7A9E45DC094EAA37CD6344140F06C3971DBE45DC0D88CDBEEB9344140E4FA23113CE55DC068A96A66D3344140C5AB277E22E65DC088427AE09C35414000D9298B7FE75DC0FC6899D5D3354140447B04B0C1E75DC0B08EF7B286354140A65797413FE85DC0F81089C683354140D36BF35FDDE85DC0383730AA26354140C84358801BEA5DC0C4479C1350354140B5A79B5965EB5DC0CC9F55910A354140AE59934603EC5DC0B857197998344140457A725C2CEC5DC0ACDAEFDC3D344140BBC6C5B644EC5DC070BDB39EE333414092566DAB37EC5DC0F03336D4A53341400118A1FBD9EC5DC0C40966424F3341404DFBF92BEEEC5DC0E0B0461AF53241403FCF35E54DED5DC0E70254CE9D324140A9110BC612EE5DC01C42BB3B993241402E539E9CE8EE5DC08440BF1AE0324140B0F5F1D590EF5DC098546FA58833414068B364CD49F05DC018246806D0334140C8B6D3D668F25DC0504EE62C673541406D7E46C663F35DC0BCF4693B84354140CCD64443BFF35DC034E56FCE4A35414029143D1140F55DC060F00F264835414039FFC5B287F55DC088F133051D3541407B1FDF22D3F55DC07803CB9FDC344140649748FFD1F55DC06C66E92E7C344140F34C64B6E9F55DC0BC931072FF33414067A581660AF65DC0406ACEBFB2334140ACC314BCB3F65DC028C789C853344140A07C1D4591F75DC03C2875D169344140CDAF605AF5F75DC0A0FDCC9052344140F9C6B8913BF85DC0E46991E50B344140424BD6C2FBF85DC00C0425D2A43541409C484D74A3F95DC0E0CD61D8D0354140CD727450FAFA5DC0C4FF05B279374140F99E286ED4FB5DC00C2752CFBF374140C20DEC1C56FC5DC080392EDBB537414028164E1ECBFC5DC02C09C4839737414079FDB6AB40FD5DC0E046AD51CB374140CD6CAB7A95FD5DC0E4D777DB4B3841408B77B3AB75FE5DC0C8B9B42B3E39414091265CCA04FF5DC0FCCEEEBE9A39414016218C6A54FF5DC0480B71FB91394140C680664FA3005EC0A8309770023B41400D22F9AD6A015EC0776F8FC9953A4140B4B850A357025EC0841D7913483B4140954F7CD3D9055EC098F7CE35BA3A414004D97CD389085EC0B0C5CF35823C4140A5B3A8EFFF0A5EC0509DE675283C4140426570E5C3125EC0E0DDBD55F73B41406889277E361B5EC0DCFD79E0C439414052211C1B701C5EC074BD0A56C0394140AA44E618101D5EC03082E20EAE3841404D0AA069401E5EC0B481748BA23941406A89277E761F5EC0BF107BE0E43E4140E2A9749BA3205EC084FCA066BC42414076AF6DC653225EC0984E957D84444140FB20F293B3235EC0D012B3B74445414078A962D4FC245EC060F4C580DA464140E30A2C690D265EC007B2304E00474140C854838EC8275EC068C3870ABC464140AD44277EBE285EC000CC7AE00C48414015F962733E295EC0CBC041227D494140950A8C1D76295EC02069EE6AF74A414085BFE85018295EC09C865554EE4C4140E3355A345B285EC06CB373AC68504140AF9AA5FF4D275EC0BFECD653675441405C4D6299C9265EC094A5C0F0F456414030905C6E98265EC0E407814B365A41409F28D2287D275EC0D8B2CE35E25C41400867277E2A285EC00C81CF352A5F4140944F7CD3F9285EC05CD2258B176141404916599350285EC0FC98885E1664414013B6122CA1275EC00C59D3BFDB6841405D82A3AF83275EC0CC11831EFC6B414003D6178D65275EC08B257507D36D4140565F58EFD1275EC0A89A92AC036F4140ACF97BD37B285EC0EC93D0358A6F4140944F7CD3F9285EC0E893D0358A70414080F9474C41295EC0B885DF0E937241401E50F713EB295EC0E0F8DE0F5A734140853EE5B9BA2A5EC0508E76740D73414009A2C2CC0F2B5EC0349A4DA829744140CCE78CF0A22A5EC08CC5313744774140DB6960AE1C295EC0F0F1DA9D1C8041403CBB267E8E285EC07871D0357E844140A8B67CD35D285EC040877AE0748941402FEA7CD3AF285EC0CC2CD035E68D4140EB717CD345295EC048D2258BD791414004D97CD3C9295EC060A3CF35769241406A166DC3252A5EC094DC07EB42934140FBB50549F42A5EC0286AD3993A934140735AD128752B5EC05CD2258B979341402B9FD128AD2C5EC0C82CD035A6954140715AD128352D5EC004CC7AE04C964140934F818C532E5EC0509280CE6D96414031B6AA94FA2F5EC06CE123F0B496414048A555E35B305EC000086F8E01964140BD53769757305EC00F89A93EE194414062A578AB9A305EC05701182561944140A6755981FE305EC04B959FD0829441409D28D2289D325EC00C81CF35EA9641403C270F0163365EC028898D0FF999414092B3CE901B385EC028179229A59C414062FB7CD3B5385EC018B979E0EC9D41406ED9882A73395EC0104CFF50F89F41409EA74E5B51395EC028B4367E02A341402D9D2BB7C5385EC02489A58899A4414003CDD38B8A375EC06C0F604A4AAA41401743FAFF2E375EC038AD85E752AE4140107822E6A4365EC028D5A0D77BAC4140F4704482DF365EC057C6DF6DD3A94140DB0A7CD3C1365EC0E048258B27A9414046C47FADF7355EC0503E1F3A84A94140C32BDD4BE4355EC038CE092874AA41400C3134BD35355EC074AC09EB04AB414034D1D1517E355EC053415792E4AB414098BB2116DC355EC0B84D1D5D45AC4140B9D00F6288365EC0D0EB7D87FBAE4140858E518F0E375EC044971CC3D8AF41408D0B59D378375EC02446ADAF7CAF41409ADD720CC0375EC038833C25E1B341403617D9DD42385EC04C12E59BC5B5414001D97CD3C9385EC00481CF356AB74140EC9967B01F3A5EC0F478AD0D60B941400DE5DA698E3C5EC0202B05DF1FB94140DDEABE6BA93D5EC0F0D8378D73BA414017AA95AEE53E5EC0B03B29E2E0BA4140FDC08BDA57405EC057F8B7CEF6BA4140A7B67CD35D425EC0985ECF359EBE4140B2E736375F445EC05874608A49C241407CCC2E1584465EC02823B07E5BC64140921B652D60485EC0A7A5AEC6E3CC41406239856C2B495EC0149E1D0B72CD4140F857DED42E4A5EC004B1E93E49D0414011E0A179D74A5EC0242F359386D141403C63FDD1FD4B5EC0C0E52B742AD2414076EF04355B4C5EC000E6E5EDDED1414034562CF5414C5EC0DC18A77A22D141409C90D7627B4C5EC0E872A365F0D0414099063712DB4D5EC008AB1365E9D24140A884B6E8F94E5EC0C78F0FF975D341400EB2DC9A20505EC02494738025D44140E75DB6AF39515EC0540047DA04D54140E2E689B773525EC06B51322219D54140CD1E8A5D76525EC048682B063AD7414092FFED3819535EC010B47E5147D941407ACF35EAC6535EC00001AD3896DA414022EE083F22545EC0D0C1C84C5BDB4140289FD128AD545EC090427AE0DCE141404448CE3695555EC03482B1F8ACE44140909C466C8D575EC0487947E9B9E74140B0131086C6585EC098C477AE24E9414005149AEC2B5A5EC09C3F0CDF08EC4140BE5B9D52745A5EC02C07054F68ED4140794580FE3B5B5EC0977398B8E0ED4140BDF742244A5C5EC0C4BC45A942EF414079794915A55D5EC03F86986980F141409D28D2289D5D5EC020B979E0ACF3414037519E4E395E5EC0283543D0EFF44140854B8CCD9D5E5EC0B840F2103EF74140742473CCDC5E5EC0B8D0980778F94140F1B6D66D295F5EC0CC830A41A0FB4140ABF97BD35B5F5EC090F7CE35BAFD4140F471D4676D605EC024E336D36A004240C1115AC571615EC0B89670FF49014240BD24CC1CA1625EC00C3C95F2EB01424080EE1A7345645EC0D455D53393024240FBDF547B43655EC0B8E6D4899C044240C9A8F729EE655EC0B0B3FF13790642402C9F4EA70C665EC078FD07CD38084240FD2DB1FACF665EC0A40B441227094240464569F090675EC0205CCF91CE0A4240A38A2C7654685EC0280C81A5780E424041C8415521695EC00857967BD00F4240C8EBECB7186A5EC0282F1B3F42124240B0F5C90D636B5EC05B5AC28BD2144240E9EC548E636C5EC050D7DCD6F8154240AC7BD85C0C6D5EC04011B8E052174240CADFBD36AA6E5EC017C8BCCD5C1942402807C2C740705EC04C04BFF4131B42407BB9FD2203725EC08797D83DF81C4240AD8B067C20735EC0D4E6E86D031E424046A0020CDD735EC0307D2F32BF1D42400B67277ECA745EC0A85ECF359E1E42409BDD267E7A755EC0BF107BE0E41F4240D3C77CD3C3755EC0344FD035322142403F1741541B765EC0FCB8CBFFDD2242400867277E8A765EC0D0FD79E0C4234240B144277E3E775EC0908D258B3F244240FC4AD228E9775EC0B47A248B1F254240C2AB277E62785EC03BB6D035562642405CF2BA0994795EC01CB14E90F62642406CBD89FB51795EC0482A0CD12E2842404EEC55826A795EC010DAB749FB294240BD61D5C532795EC038DAADDC802A424086A7B48430795EC0DF005836562B4240B1CE557976795EC0DCF3BFE0032C42400F14802BAB795EC0E0F4653E272D4240949C6053D5795EC0BC3DF8D2592E424015D6A35CF9795EC014951090952F4240EA6FE9FBFD795EC0FC75C62246304240B42E02E4DD795EC010BBE37F38314240F7E534EDFD795EC008B946A3B9314240FCF6242C217A5EC0F437DA4BBC324240081AB80B867A5EC0E83F33AE96334240DA874822BB7A5EC0142D8EB130354240E5D3A4C0947A5EC06C6E13352B3642409F195044C67A5EC0300542F714374240BFB855EF747B5EC048BC9D0D51394240C38857CE887B5EC018565971303A424034BEF8CD9D7B5EC0506D2F97443B42408BD84DDA087C5EC0D77C0018F03B424005D91AF3757C5EC09CED1A393A3E4240E989AB53907C5EC0CC666F4CF63E42404AE4C599517C5EC000FCDA07943F42406653B0845D7C5EC0109B7DCF5C404240BD1819636E7C5EC03C180F9BBA40424020A7E7244E7C5EC0F80886F785414240983C2ED5C57C5EC0B75E5AE1D14142400AC4BD553E7D5EC0C076514A41424240B9C3E4A8247D5EC000E5A3BDE8424240C3A68560AF7C5EC0586F8E5907434240921A8E052A7C5EC034B4829FEB424240C58503B45C7B5EC028D311950D43424059B4F342697B5EC0FCEB3145044442409C253136847B5EC01C797D20D84442406D55CA4CB87B5EC074BAF4C2EC44424096678468E17B5EC0C8CFE5F1A74542408AA30FE9997B5EC0CC8487F90A464240BC47FD88AE7B5EC010EF64770E4742402A983EC2D07B5EC0F3EB1D3BD6474240F0D5E2742E7C5EC0E057CC7F7D474240CD6C73D0567C5EC0982DE72C1548424087F8F513937C5EC048A6A3F34C4842405E659263DB7C5EC0506DB9650D484240B43DA88E0C7D5EC0DC28B7D69F4742400DAD16B7157E5EC0F873B438D0484240A54EC796977E5EC030DEDCFA914942409ACD7C97CA7E5EC09F450E3CB74A42402E463EF1547E5EC0D435090ECA4A4240E3D23FEEE67D5EC0E8FFF13FE84A424064C02E5DDD7D5EC09F365BFAC94B424064A7DC00B07D5EC0E8E85135DD4C42404A0152636E7D5EC0AF0C9DBD444E42403378C453357D5EC0D0AB3AF29A4E42409C293845D27C5EC0981B1376124E4240BA6408D2957C5EC0008CCED61A4F4240A2752546527C5EC02056A8702F5042409E19CC0B427C5EC0F4915822355142407B197E30037C5EC05CE815ECD25142404D633A5B7D7B5EC0F0543E4DAB514240DC0E0D1EF57A5EC0B005AF30195142403293BD45EA7A5EC094ABC2BA7F5042406F00CECF707A5EC0F8AE1ABBEC4F424081EDAAE4BC795EC0F73951CE744F424097237E0757795EC0E4E89E0D6A4E424009D1F682CB785EC058E7D1270E4D4240689867D93E785EC0D865FB74224D42402FCFCC24AE775EC04CD8B020B94D4240F8A26EE1A5765EC0D8240D824F4F4240985DF69FA0755EC040B085BB5B514240A976F690EE745EC0B89EBA5CFE5342403D579FCE1C745EC01CA762567457424061FB7CD3D5735EC0B0C5CF35025C42400E1735028B735EC067F9803B6E5E4240F52B4D12B7725EC020D38E138D5D4240CE7CD128E1705EC020B979E06C5C424047AC40B8B8705EC0E85FC7037A5D4240AF4F71630D715EC0B8D8A64B1B5E424037BAAB334B715EC05016FE469A5E4240F0AA2A6E9B715EC0E0EB7E64665E42403F5A6F4328725EC05C92883F765E4240AD329B7992725EC09CFF06B0F25E424052D71AAADF725EC060949972885F42406DCA60B567735EC0ECE6580E0F6042406BB2EB1615735EC0A83473FFD3634240236E9A468C725EC0CFAA1A87316742409C69F4C378735EC038FA4DA5026B4240F84AD22809775EC068BF248BB7764240F6FF267EC6785EC090F7CE353A7A42402D91B15EF5795EC0AC6CB5540C7C4240FC5EBFCAFB7B5EC04846C229397D4240CE10BA23FA7C5EC0603AA4FA497C4240EF845C11AB7D5EC0C0D1FD92D07A424063304FDF597E5EC0347F45F8437A4240A228D2289D7F5EC09B427AE0DC7A4240243AE6CA6D805EC0A8B78C362F7B424077BDC2825B815EC0A4543AB3387B4240F5084B289C815EC0B06A75EBD57A42404F3ABC738A815EC0888D6B83607A4240D844F1B39C815EC0E88E2784B9794240527C2B8E3A825EC06CB390DE027A42409DE299ACFE825EC08854C0335D794240D4A82C42E5835EC0589176B572794240D2CC107D2D855EC0844CBA86C97942405AB614C5C8865EC0786A2231567A4240266D3BE4BB875EC06041EEF74B7B4240DED9FFAFA3885EC0486E13E99C7B424019CC606B1A895EC0288D5202D57C42400CDD1E4AD5895EC044ACD1CE107D4240C5D344955D8B5EC02066E9965F7F424041BB267E4E8D5EC064BF248B778242403245A42C378E5EC0A8ACBE181C8342404D314EA9968E5EC014E6EFAB208542400A8F434B3E905EC0184B435A91874240241D9DD406915EC0B7BC6D4BC9894240698CAB64FC915EC0DB7D34D45C8C42404598A65E90925EC0B07A9F9B578D42400984FFD50C935EC0670729AD3C8E424070364814BC935EC080CFE734EF8E4240FC257B1466945EC09410BF8BCC8E424016D5604FF8945EC0C819CD7B708E42400DABA4EDB6955EC0AFA95CB02D8F424073BA0E639F955EC00C5F5E7B449142400581CB7F02975EC0ECD3251B43934240A1A958411B975EC0C80F7C16C89442400EAB9A7BA3975EC08864814946964240C455F2D289985EC0AC14E2A8549742401DA5F4DA59995EC048D68B2F479742408449859FE2995EC0806C263AE69842401D3727821A9A5EC0073E01B9A99B4240A93B04F8489A5EC0D48233190A9D4240C09189ECA79A5EC0E4B3F915F19D424057944D77C69A5EC0C3C853AF4BA04240787048E73F9A5EC0DC7BDC8469A242400BA12E0B139A5EC060CF8307C2A54240D013FAECC2995EC098558FA395AB424056EA82229F995EC0C0125FFF0BAE424002AF17BC289A5EC0F0E2BA2C9DAE4240622DDE25579A5EC0381F60BFFDAF424015CF47E9779B5EC0A880717321B442409F4D7DCF719C5EC0401247A200B84240E19A600ABF9C5EC05889C80903BD4240F1717CD3A59D5EC0403CCF3592BF42405C9BEE51AC9E5EC0385C45355BC0424058A2F6321C9F5EC0E8AF01C553C042409446062BA19F5EC0C81DC2811BC04240DB8A21BFB29F5EC0D4A2285168BF4240CDCF82EDF39F5EC067ABF1CA1CBF4240B9C74F9911A05EC0F813C38C2BC04240BE955506C5A05EC0689DF7C747C14240B84951694FA15EC0E08B4F9E05C44240950B98CA1FA15EC0FCBDCA44CBC542400DA1FCD0F1A05EC0189B145BCBC74240C1E2FC2248A15EC034D4FFEB7CC94240C364AAF337A15EC0B00E8BBB7BCB4240FD6140666FA15EC05067948CEECB4240E5D2E0321EA15EC0F85F4EAD17CC4240B59C5174D6A05EC080ABBE2586CC424038FEC5787CA05EC0C8493D5F81CC42406AB0B1F734A05EC0947661BAFCCC4240C7ECA6D31BA05EC050CF9959B0CD424072FC6798BD9F5EC090C14DCA4DD0424001D97CD3A99F5EC0D02CD03526D54240322760B51EA05EC0484367E80BDA4240EC5748268BA05EC0107F9AF5CADC4240D2C1B3FDDEA05EC0B8C89F174AE042403AEC7F92F8A05EC05C6ECDF0FBE34240A923F53B60A05EC04C22B894AAE44240629737D3D99F5EC0689D47C5BFE442402345B27A199F5EC0F0228E4739E542404F1655247E9E5EC0C8B3EC32C4E7424063F8B1AAA79D5EC0D816AD2F14E74240152231EBCC9A5EC07812B88CD3E742401CCF621A279A5EC074F656EABAE74240E27462077C995EC0485EDBEAD8E64240633E7CD3D3985EC08771D0353EE54240A1AB694EC6985EC0D0FCC8ECADE342401719D9056B985EC0E01BA1B806E3424041283EBD80985EC0473D2828C5E14240AE41868B45985EC0209C1026C4E0424022F744CFF4975EC010E8951DE8DF4240FB8078A474975EC0DC3F4D49B0DE4240B8E511D9B0965EC0C06A6CE970DD42401150648A32975EC0AC60CC5E82DB4240BF8D7B2315985EC0B0703FE5BADB42405C97E94349985EC084C155158FDA4240C68744FA1D995EC058AEC31AECDA424050EAD88FD4985EC0844D3D1CAED642400DBBE08054985EC0106831719ED642404C65FFD962985EC090ACF29A5DD542400027B58CFE975EC0ACD01D64DCD34240734E963468985EC010914775DCD24240944F7CD399985EC08871D0357ED14240AF294F078F985EC09C02C3ADD3D04240DDAAB13847975EC0A086A4C049D04240A8F4CD42AA965EC0808E516987CE424027A1B86CFF965EC0748F7064E2CD42405BD1772EC1975EC0D0E56AFE74CE42405E771A66F1975EC06C9E490056CD4240F00719B42F975EC0B8EAAF3BC3CC4240405D8AFCF1965EC068577809E1CB42405D9C552525955EC028DAD2A071CB4240470848F445945EC01813160D80CB424059DAC0E835945EC05CAD3335BECA4240B5E73DF123935EC098EA00CAD7C94240AD76251321925EC0E4F5AAB98FC94240D70A7CD381905EC0D448258B27C942402FEA7CD30F905EC050A3CF35B6C842406C7B30C6B38F5EC093FE0908CFC64240FD45EB36558F5EC0081EC96600C64240D27CD128C18E5EC070557BE0BCC542409584466E758D5EC050AC34451AC54240491AF04DC18C5EC03070B9A179C4424011CE9BAEBA8C5EC0585DDA8C6DC34240E4E3D128458D5EC068557BE03CC24240E63F321D5A8C5EC0F7565439F7C142406B21DD6FB78B5EC057B2A586F7C042409CE22757F68A5EC048EDD5A675C04240041C7CD3278A5EC030D5CE356EC0424079A57CD377895EC0403CCF3592BF42405FFB7CD395885EC068BF248BB7BF4240914F7CD3D9875EC0403CCF3512BE424000D97CD329875EC03CB6D035D6BB4240F94AD22869865EC0908D258B3FBA42402A9FD1282D855EC00817268B6FB94240E0E3D128C5835EC0D0FD79E044B9424085C1D12879825EC0EF35248BC7B9424004062E940E825EC0C03E0C844FBB4240AEF97BD39B825EC0B7107BE0E4BB424076A57CD317835EC0888D258BFFBB424076A57CD357835EC03BB6D03556BC42404D947CD351835EC090427AE01CBD4240A9F97BD33B835EC074557BE0FCBD424031EA7CD34F835EC0AC5ECF359EBE42405222277EB2835EC00817268BAFBF4240A8B67CD3FD835EC068BF248B37C042401A837CD36B845EC050877AE074C0424087C1D128F9855EC050877AE074C042409DDD267EFA865EC003CC7AE04CC24240E055F88E75875EC0485E4BAC72C542409AB638235D895EC0248B2BA31BCA4240A672F5F1BD895EC048BABC39DCCE424086B492F86A8A5EC06883E82A0CD54240E7F9E003DB8B5EC0B09E9F986BD8424051C5857D478C5EC0A8034BDBA3D94240B43FF8FF3A8D5EC0EF46B431F7DA424098186914B88D5EC0084FDB127BD94240AAAC58EF1C905EC080EFCEF883DC4240BCEA4459CA905EC08C8C21BC1ADF42404A7A7F86EE8F5EC0ACE4B750C8DF42407E8430D0988D5EC00859D6772ADF424029225420E88D5EC04B2CF11316E14240C46FD1C9328E5EC008A3AC683EE142404C9A65007C8E5EC06FC0A3D7B0E04240C55F6848518F5EC0508C437CAEE04240599F481661915EC0E0D835F9A4E142400D1EFA0F25925EC078382BC3B4E14240CD1C03F98C925EC058CDFB5831E24240AD7F284231935EC08878D9F3D8E242407FBC112208935EC0E00C3026CFE34240485A8203AF935EC0D0292966F3E342409E21369AD4935EC094A5251C5BE34240E4F3B47037955EC0245BB04A25E442404448BF0B08955EC078D3C856F3E54240FCF11DE3C7945EC0D8BD42E489E6424090155BF2CC945EC008F0274EE1E642408704CEDD04955EC01C38C38EF8E64240053128B7B3955EC0F8B44E2CD5E6424029E73751CD955EC01009EA914FE74240EE37392D6C955EC0A01D1D82E3E7424047B95F91A1945EC0077C30F6CCE742407C8B94B442945EC07497386496E84240AB6921D803955EC048C1B25D17E94240A55AFFD275945EC00CA2BAA29CE942406D30AFE449935EC018F09735C2E94240106B6982E9925EC0408E3FC867EA42405225279910935EC0E825998B6EEB4240A5C13E7E72935EC05CD8B99473EE4240AE0A4CBB39945EC0BB4EF9AA31EE4240957E08F855945EC0FC4E7E3216EF42408203584CBB935EC098ECFFF366EF4240DCD692F816945EC03CA234DB62F142406EDFEA660A955EC03C432E3B3BF44240EB22F2E142965EC0505C64FB03F442400EA3385E59975EC05476F81AABF34240B6B2599507995EC0174587AE2EF442403BE619E7CE985EC0782568B7C9F54240B22AC64F5C995EC0D0EAD950CAF642408EC9E147409A5EC098A7B33A49F74240F96214D6F69A5EC0D8F7E96B62F9424033A5AF2C809B5EC0FC95C4EF6CFB4240952D64D17B9A5EC090E7B28C25FB424053CA2C5474995EC050E5FA0C62FA4240C82C713348995EC0C4488DB531FC42402C6E19599A975EC0E83921027BFD4240B597831F03975EC0009568456BFE42402A299EB0AD975EC09C78298474004340277C8B8E71975EC00C5F67369401434004D97CD329965EC0F019CF35C6004340D17CD12881955EC07C557BE07C004340D0C77CD3A3945EC0F780CF35AA00434036F812F545945EC0A8DA9A264C014340A6A3087B23935EC0741945F06E0143403AAE56EBB9915EC02C02F8953103434017F16DF2A2915EC0883AEF43010543406EF0953EE9905EC0C00297C2E1054340AAF97BD3FB8F5EC03FB6D03516074340091C7CD3878E5EC094F7CE357A07434054140345088D5EC0189DC81AD506434056BC9E36EA8B5EC0040E2A16240643408DCCA492C98A5EC0DCF138E99603434079A57CD377895EC0E819CF35060343405CFB7CD3F5875EC074557BE0BC034340BF9D49D03C855EC0F84CC871210643404873DD8768835EC01B50382DCB064340B56BF65E41805EC0247B82732F074340D07CC9B7187C5EC0B8E4109CB30543405A291F10D5785EC06B39CF6642054340C44B34D132785EC07020CA756504434095745A6B93755EC090502AC3F30243402CFDA353DD715EC0434BE5A1FA0143407120BEBB11705EC02858F2DE7C024340E3E3D128456E5EC02CB979E06C01434040BB267EEE6C5EC028D5CE352E0143404D9AF7AC296C5EC054AE66CD2A0143405AA55AC29C6B5EC07C723FE73B0243405CB83E02786C5EC0A022D6A8280343402515539D796D5EC0B063835CD40243404D0150F5466E5EC0F404E7A545034340BFC65F671E6E5EC077E013671C04434049F4552C1D6D5EC0E029AE7B8204434087C1D128796C5EC008E8CF358E054340BC607CD3DF6B5EC09CF7CE35BA054340A4B67CD39D6B5EC0FF16268B2F0643400B67277E6A6B5EC0E893D0354A074340FD4AD228496B5EC040B6D035960843409F28D2283D6B5EC00881CF35AA094340623E7CD3F36A5EC078557BE0BC0A4340F8FF267E466A5EC0A85ECF351E0B434031EA7CD3CF685EC00CCC7AE00C0B4340F10B3E19F8675EC03C1DB1B86D0B4340C465E58FF0675EC0EF636E331F0C4340AE44277E7E675EC0B87A248B9F0C4340623E7CD3D3665EC068BF248BB70C4340FA4AD22829665EC06C7479E0140C4340C0620E6140655EC090FFFEABC60B4340F9C3751024655EC0E0081AC6AC0A43405C1570AEE5645EC0EF1B5FE8820943401A3C0D2A47655EC0FBBA08D7CC0843403132791770655EC01C1AD9F307084340206B20D259665EC0509B8FB7910743405F266CCD03675EC0A456BECCCF0743407CAF4849B8675EC0AC1782E4E9074340B2E5CC712C685EC0A4B8CDAF81064340527A5A9C76685EC07818514FA905434098D2E60ADF675EC04CA6ED80A70443406309987737675EC0BF86C03BC0024340EEC1915EB9665EC008515DBE4A024340D4C211A94B665EC0A82CE05ECC02434002157E3E64655EC064F77EC6AC0343401389CD5047655EC0480C7D8294044340C5CB4F1422655EC03CF8025A0A064340A087009112655EC0D0F83DA55B074340312A5A60FF645EC0785F7F00FC074340A11E8C7F6F645EC06C6E4C966D084340E9E1B23A94635EC06844F7605D0743409E9F06920B635EC0A84EC0B60B0743402DFDF7526B625EC0C875460D860643404224C09FB0615EC02006BAD03E054340D1E5B11FCF605EC0E08B9596260543403DBB267E0E605EC08CF7CE35FA034340E173DBDCBD5E5EC0387CC73AE60243405C2AE078605D5EC023E9A2A79C004340BC607CD37F5C5EC0F035248B87FF4240CC7CD128815C5EC09C8D258B7F004340AEF97BD35B5D5EC0E4B2CE35A20243405222277E725E5EC0B0C5CF35C2044340D3C77CD3235F5EC09CF7CE35BA054340BE607CD33F605EC0A85ECF355E064340CC641ADBD8605EC0749E8A65040743404C30A06DAE615EC078BDB8C4F906434043259559DF615EC050CE0227BA0743409AE6806447625EC0A0723CA142084340EDF8E113B7625EC0C8C7FF9B190843401B9358F41C635EC0BCF643E83708434089D6B6002B645EC08CA0AEEB600A434082C785D08F645EC0F8BEC8106F0C4340FE4AD22889655EC0770AD0351A0D4340F94AD228A9665EC0E893D0358A0D4340D1C77CD323685EC0DCFD79E0840D43403F06D22871685EC074BF248B370D43402D9FD128ED685EC058D2258B170C4340C2607CD33F695EC054D2258BD70B4340924F7CD3B9695EC04B3CCF35120C4340EE717CD3256A5EC08071D0357E0C43403FBB267E8E6A5EC0284FD035B20C4340F4DCD9BC896B5EC058936F49DD0B4340FA4AD228E96B5EC0607479E0940A43404C947CD3116C5EC09C427AE09C0943409D28D2281D6C5EC0E4B2CE35E2074340DE0A7CD3C16C5EC0C4C5CF35820643405BE0C8221E6E5EC064C0EEF527054340F12B61F67D6F5EC034D092FAC40343400EA36B4F1E715EC0503453C4E3034340A494565DD6715EC0D00027469C04434099CA8D1541725EC053322D1C8E05434091940C1731725EC0F0E7F71EAA06434024215D0EE9715EC0A391BD22DB0743402072E0263A715EC01C070003CB08434089B20EDF93705EC04CAC62573E09434019837CD3CB6F5EC097F7CE35BA094340DE0A7CD3216F5EC05CD2258B170A4340BD6799E2DD6D5EC090033B1AE10B4340A6B67CD3FD6C5EC0DCFD79E0840D434032929FB5046C5EC0F08C44AFD90F4340B3C560BEAF6B5EC09447F234D7124340E9F57982206C5EC0B00DF9D4E2124340E9DE05D51C6D5EC0985D894AA70F434052514F2E2C6E5EC04C11A747DE0D434040BB267ECE6F5EC088F7CE353A0B4340A6B67CD31D715EC05CD2258B170A4340F17431AA65735EC064AC37900C084340373881E4BB745EC0042D9669CE08434015C80DCE26765EC07FDE4A0C4809434055C0705328775EC0F842679704094340C1AB277E82775EC0EC19CF354608434008CE1F547B785EC0B85540834807434036E35A9E7B795EC020FD13EFCF0643400A80459FAB7A5EC0AC6A971DBF0643404D947CD3717B5EC094F7CE357A0743403E06D228F17A5EC07871D035FE074340D07CD128A17A5EC0403CCF3592084340D90A7CD3217A5EC05CD2258B170A43400E3193781E7D5EC02C1CC53C220A434075BB4647297E5EC0DC6FBFE6960943402132B99F537F5EC05043A64C8F0A434072EECD07F5805EC00047E6FE9B0C43409A98377F1A7F5EC0C4697A902B0E4340959CD0A7527F5EC01C45167D06104340F9C27DDA04805EC0004E4674931143408BAA808A09815EC043083CC8DC114340A84D70A56F825EC0144EACE980114340071C7CD387835EC0A45ECF351E11434032EA7CD32F845EC0FFCB7AE04C1043402BEAADC369845EC040B62780960F43405DCFD00536845EC0C0C01D367E0E434031397ED3D4845EC02850D06FDD0C4340D954C9D2F7855EC0981FAB7ACA0A4340BC607CD3BF875EC00C81CF35AA074340B4E76D2A1A885EC020BB8FA671064340F17D79AD56885EC038C159EC64054340B6368F81248A5EC0E89EA19E8F0543402C01899D9E8A5EC07C9FFB63FB064340A700EE98CB8B5EC04CED55034B084340A0078DDF228C5EC038AF315CDB074340CFD79F367D8C5EC08CB8B07DE7074340FFBBA9A11D8D5EC02CD3598E590843402C9D78FC4E8E5EC0F0CBD2BB6908434076A1CE7CB18F5EC024D4191A3A09434046A96463B2905EC088E9C82CE3084340D20A44965F915EC0D08D6085890943403A29E0F206925EC09826C7D2040B434072E2C24C3E935EC0885C395AD90D4340422BF39360995EC0831E49149D134340492532C2479A5EC0A06747DF211143402E149CCCC89B5EC0B0E78BC7C90F4340EBF1CC75C19C5EC048A79495EE0F4340D7E723E94D9D5EC028BDC3C2100F4340D8892DF825A05EC034710BDA870E4340E86DD2EB319F5EC057F79EF76A0D434076475817E19E5EC0809ED03CD7094340DC26E42F9F9F5EC0908E37A866064340805E7BA32CA05EC0188EA2A6140443404A2379235DA05EC0706F50F8F5024340440B6D1F63A05EC0F84EA9B23202434017AE0DC9949F5EC074A2DEDFA2014340FE3C4153109E5EC0987578D5B1004340A6DB664B129D5EC0C0926715B8FF42406B72AF61809C5EC02807268318FE42408927981DE19C5EC0B0B552AA72FD424037434121699D5EC0B89C03BF9EFD4240FE451AB9079E5EC04867129CCAFD4240DB1630D75B9E5EC0783FAB8FF1FC4240ED717CD3859F5EC0D0B2CE3522FC42406989277E969F5EC0204FD035B2FA4240705AD128F59E5EC0FC80CF356AF94240B18367FBBD9E5EC068B6F18F8DF842402066F87A779F5EC0B8BE780EBEF74240395264DD3AA05EC0808A7F2662F84240E4E3D12845A05EC00481CF35AAF742402D1BE25A38A05EC0E8F2173B60F6424089A1AF957A9E5EC004D070303FF54240180A144E3E9E5EC047E4B2B3A3F442407212E3C55A9E5EC03F78A8D8DEF342403E3859AF719D5EC0300E83AD9DF242405B872777BC9C5EC0A83E2BD862F24240569CB64E159C5EC0F0351215E8F0424009BE4936AB9C5EC0405F125FD4EF424049B28B581A9D5EC0C450EC87A9EF4240B495E6D5679D5EC0189987F380EF424070992D68609D5EC0483BF3E765EE4240FEAC359E0C9E5EC0403AEFF2F9EE4240C8F6A1384B9E5EC0100CEBD0EDEF42409209F97F399E5EC0F802E231A0F042401D06A4A4779E5EC09012A66282F142401BD601615E9F5EC09BF9ECFF6AF2424031713C16F09F5EC0D0FD782961F2424014D0F06BC69F5EC0E87418C136F14240680DB9DAA99F5EC0B49EB25852F04240205BC933F49F5EC0D4191199ADEF4240DE04AAD5509F5EC090CC52DB9BEE424042E90869989E5EC0A8491C050AEE42401AF54981B49E5EC0DBE01C7333ED4240C98E87D07E9E5EC024684D7FF8EB424017EFAEE31A9E5EC0E8D6617579EA4240E52AFE6B909E5EC0E02754059DE94240266583C6389F5EC000066C88A3E94240E9768C442BA05EC034DC988F05E942402B0C9F47C1A05EC0B88450E088E9424045AD2A0D72A15EC068A7425036E94240944C80BAD1A15EC0C8A846DD7EE8424040BAD0D66DA25EC0BC7625EDF9E94240ACDCDADB10A35EC0579E18EAD4EA424043633F8113A45EC09088191C90EC424087B2797AB7A45EC0D00A88678EED4240B1921862A7A55EC010C40C092FEE4240887293C57BA65EC0E83128ECC5EF4240C008BF0CBAA75EC0609106CE51F04240285622F04AA95EC0F08BCD660CF342407EBDA57608AB5EC090062A9C0AF442405A56DFFBE6AB5EC0708DBBEDB4F3424043DE754096AC5EC0C34146DD1AF34240DC858913D3AC5EC0A014335D30F24240698E2CC6A4AD5EC0D47C23013DF342401A8A7C4393AE5EC08CB556CD96F342405574EB35FDAE5EC0DCEA43A2C6F542400050DABBE9AF5EC00033937A5FF74240F199E377FBB05EC0906EFB9AFCF74240B166F183EFB15EC05CAC165C5CF94240306CD6A4F1B25EC028E0C7D3DDFC42403C29CC0EE0B35EC044C299D41AFE42408042905892B45EC0E85BAEA4B3FF4240F5239CAEB8B55EC04810550FD0004340E9881CB809BA5EC02813B57613044340ACEE837FF3BA5EC068A69DA976044340305BA248B1BB5EC07C9D50A6560643403A88FEE5A7BB5EC0EF1A50F0860743404C368B9BE3BA5EC00F9A27285C084340A5B67CD3DDBB5EC00FE8CF350E094340C1AB277E42BC5EC0E893D0354A084340633E7CD3B3BC5EC0EC19CF35C607434042B9B0459DBC5EC0E86F183202074340944F7CD399BC5EC00CCC7AE0CC0543404D947CD351BC5EC0EF35248B470543406F1B44D3E8BB5EC0C8909448F0034340C1AB277EC2BC5EC0D3FD79E0C4034340C975BCF7A7BD5EC0A446DB843D034340B26FD713A9BE5EC064509AA5DB014340D541424DFABE5EC0300D7ADE69004340563123BCBDBE5EC0F0B575BEBFFF42404DACD46531BE5EC0FC68569581FF42401B3B6AAA99BD5EC078C74B6CFBFE42400E580AC559BE5EC07C3B6D67C1FE42401AE6B5B901BF5EC0B407D890FDFE4240312CA6CFD7BF5EC058EA623836FF4240C4AFA2E323C15EC0A0E1EBB72BFF4240034957CAC1C15EC0F8013E684BFF4240650EC83F62C15EC0A88745D20F0043404D966F1D06C15EC09882D5C81600434027C65B0F68BF5EC01CE8B9503C064340CB1E6E08C7BC5EC02892594B6E124340EDAA9978D1BC5EC0ACBA661D0E154340FFAE8D1327BD5EC0A43D9314901643405CBC00AAC1BD5EC01C4E0E835F174340B224C016BFBD5EC084946CAA6B194340C9F2CA6253BE5EC008E2D4FFA01A4340F242094CEABE5EC0B872E6332D1C434053052A1691BF5EC0906813DE601D4340652A3153C3BF5EC018EC57C5111F43406D36B6670EBF5EC00BE7A19D701E43401053288CBFBD5EC080F3309BDD1B434008575E8A3CBB5EC0540A60026B164340033798D410BA5EC0BF1145048013434041BB267E0EB95EC08071D035BE104340934F7CD399B75EC08C427AE01C0E4340914F7CD3F9B55EC0F419CF35C60B434077A57CD3D7B45EC098F7CE353A094340D1C77CD343B55EC0F419CF35460C4340E5C3C3796DB65EC06B7B3E5B2B0E4340AAF97BD3DBB85EC0E893D035CA134340BE607CD3DFBB5EC0687479E0941B434055A629796ABC5EC098C92364121C43405B941E88D7BC5EC003319450D01B4340863977D713BD5EC0502B52969E1D4340C6940A88BBBD5EC0C06AE61CBE1D43401E3CD31101BE5EC0A7809415591E43405B3E5931FCBD5EC0E8F93F991C204340EF2AD4C85EBE5EC0B815FDA612224340224944E92CBF5EC08495586D8C23434062338A5C25C05EC0B0B933F2BD254340DC7562AEE3C15EC040ACE74606284340AEDEF034F9C25EC08F051534F1274340DD0531004FC35EC0F8F7288910274340C3AB277E62C35EC0B7107BE024264340093DD902FFC35EC08CBA2824E02543404094BDA5DCC45EC0BC4051CC4629434011D0B77760C45EC078D4043D532C4340E04385278AC45EC0E8A4A1FA122E4340BCE979110FC55EC0949DB440A02F4340D5820CE791C55EC0F0FAB8E214324340497A5DC121C65EC068D3699BAA3243404734C21A88C65EC09079A0CCC1344340ADC4E77437C75EC0144D08D9D6354340118EA718F9C75EC0B0514152FF37434050223C193DC85EC064F7AEFF82394340122E5E6BF0CA5EC04B04A10B563D4340124B608C2BD05EC0D422BD7D5D41434045C8CD9171D15EC078782AA8B443434078D2C9B27DD35EC0082FDF6C46464340FBDAA5332ED45EC0A0E205465B4743400986271291D55EC0602556F59B484340775332E2DDD55EC01C0818B6164B4340D42FD49EC8D65EC04CAA8F646F4C4340709354B06AD75EC08C328BFFE44C4340680AEAAFA5D75EC048A86FBF5A4E4340F5AEA88BABD95EC08880305548524340935D15AD7EDA5EC0F4A5300356554340E6DA3670ADDB5EC0347A17C4C7564340AD423836C0DB5EC0203641E3E8574340AF955A9957DE5EC0086E8BA9695C4340F882906B84DF5EC03888009B445E4340505BC1A17DE15EC02F81CDA6945F4340709445BF68E25EC0303478AEDB624340194B5E1EC4E35EC04C77F308396443409E28D2283DE45EC00036248BC7654340B0F2AAE506E65EC084D41A2225674340A0D6584874E75EC0604F5875E5694340DF7209DB7DE95EC08CA0DA8FBD6C4340C855FF8F6FEA5EC0E89BD876AC6F4340100C4AD8A4EC5EC0B081E44C3C734340B081420A8CED5EC078D17878087543403700B5C07AEE5EC01821B4E6937543405961591A8CEE5EC08C0B098A7277434073A541DE86EF5EC0B08262E2517A43401E62CC5B6AEE5EC00804597AED7A4340299FD1280DED5EC094F7CE35BA7E43404EC0F5AF8CEC5EC058AAEF69FF804340904F7CD319EC5EC0503CCF3592834340AC44277E3EEC5EC01417268BEF84434022DE60597DEC5EC0F4DE817691874340A6BD38B90BED5EC073D12A56B48A43406E0DBDDC9FED5EC0F00737BE9B8D43404162157E2FEE5EC028D01DC706914340B0460F0C38EF5EC00F4471FC4D9243402403A94213EF5EC0982CE43A5B9443401671CC7524F15EC03BB86E36D598434027E50F15C9F15EC028D9ED716E9C4340CCD06E4398F25EC000D82F0887A243409D7FCAAA68F35EC0A0FCC7C3B4A3434002D97CD309F35EC0680AD0351AA64340ACF97BD39BF35EC0B7C5CF3502A74340034B317795F35EC014F8356C7DA9434092B5128FCBF45EC0C8D7942E74AC4340FDCD7F3384F45EC0E0581590DFB34340607A87B041F45EC0904CA9EDD4B84340862016E31CF35EC0686CF7FEC8BE43402EEA7CD3AFF15EC09C8D258BBFC3434082E656E243F15EC00C7C2CF4B6C54340873C98933EF15EC0080AFB3E28C84340499420635BF25EC0E3E7233063CC4340D58CECAD55F25EC0D8D6BBBEDDD34340C817478795F25EC030BCB0144DD543406AD7F1E398F25EC0DCCABF2EB4D64340F81B3421F1F25EC0C82B1E1E8FD84340499FC04863F35EC014BA1BF0EBD94340644CBFACBFF35EC0D045EB311CDB43409C58C66AB9F45EC0C758EBA0DFDB4340021F680A1FF55EC09F4BA56AFEDC43400A1C7CD327F55EC050877AE0F4DE4340A23710839AF55EC0B082B52A7CE14340298619EA95F55EC0F0CBFA8337E44340AD24661410F65EC0881F5D5876E7434050567C3EA8F65EC0700D7798B0EA4340BD597CD054F85EC098F6051511EC4340C999BA1918FA5EC00CEE8DBCD4EE43404677158790FB5EC0681177ED39F44340B7FE72CD27FD5EC0A49C7B3856F6434065AF2112A7FE5EC0434A5F2E40FB4340F00CE45014005FC0F0880DD431FD4340E1622E0474015FC074274BF9450044400B202E2C24025FC05CCDA3578D014440B295F8B8E3025FC07833E1A66502444097BCEECBBE035FC0901C92C20B034440562AC4900D045FC008F84A74E402444091ADA08F70045FC05C0C640BBB02444040913A09DE045FC09CA21EDA7B034440ADFF4B6325055FC0804F71388D044440C33A4E9726055FC0741D092CA70744408AB424A598055FC088FC1306EC094440FB4AD22869075FC04FA3CF35B60D4440B431461CD9085FC00CE8D7A6D60E444099B16E3DDC0B5FC0E8DF942495104440B9B1D46B140E5FC0848519B523154440BA87DD3A69105FC0080149EA9A174440F431E8AF70145FC014DA541FC01C44400D06B718F0145FC09CA17155571E4440EFF0E9DAEC155FC0BC3B4614FB1E44403A5396BE43175FC0B07814357821444064DEFA7B0C175FC0048190640A244440B43B61454A165FC0647BFBF4D12844408E43C78558175FC0E4A467961E2C44401CECF6E76F175FC067134C4E50304440BD31CFA07A195FC06822EA1A3A354440D0B9765D301A5FC004486A04CF38444099F6C06657195FC0E85B8901913B444015B10774D5185FC014A94D9CDC3D4440F9B764E58F185FC00893D449034044401135CD78B1185FC04F01A0CC374144404CB74613AE175FC03C5298CCB8444440F84AD228E9165FC0543CCF3512484440F1717CD365165FC048877AE0F44944409B28D2289D145FC0E419CF35064F44405222277E72145FC070BF248B77504440352D7CD34D145FC0E048258BE750444086C1D12819145FC088F7CE353A51444085C1D128D9135FC054D2258B575144404E947CD391135FC03CB6D035965144403B06D228B1135FC0B77A248B1F5244404A947CD3F1135FC074BF248BB75244404DC86EFCAF135FC0802465C58F5344400F576AFDBA125FC0B89A9E1FA256444095F0082A87115FC0787153249B59444000D97CD329105FC00BCC7AE00C5E4440DA49AEDC570F5FC0ACAB49641D614440454F8BD3C60E5FC0CC808DA702604440E05FF6ABD30F5FC090EE983B2C5D444007D00BE48A105FC0C8FD14227B5A4440460A6E9C9B105FC0CC5D538065594440C0607CD3DF0F5FC07C557BE0BC584440E47C5FF9FF0E5FC0A091262A90584440B2697BDA720E5FC0D4D08EE1D257444088BF6361300E5FC0BC74FC8C55584440819B3A2C600E5FC074058361FC584440E7BC5523300E5FC0988B31B04E5944402591A4A1AF0D5FC0AF23618EC7594440F016C0A8A50D5FC028D3A743D15A4440197C8CB2310E5FC0C05536A4785C4440F96EA15BEA0D5FC0205DA528885D4440231705EF1B0E5FC0DC64B8D45D5E444078DDDAA3A60D5FC08FFE42FCF45E4440E06A454AFC0C5FC088F5453D625F4440B7636207B60C5FC0446DCFFE90604440547C838FDE0C5FC0441145D486614440F3195EE3AF0C5FC060671CED6F62444054BA24FC420C5FC040231563EC62444026DCEC21170C5FC080DF958A3165444073D00A11B20B5FC06367D03863664440A3FEE86B3B0B5FC0E039B71DDB6644403AF880DB7B0A5FC0B0F8204D3A6744405A69F9E455095FC08841F590A2674440589EC1EBC2085FC0BC6D290B52674440A2447CA1CC075FC0801423555867444098E8A60CFD065FC00F95FE1936684440DA0318EF97055FC02C1FA6B79E69444079641D6847055FC05873F9DCF76B4440051C7CD367055FC048D2258B976C4440D27CD12801065FC02004258B4F6D4440E2E2CDEC83065FC0FCEB0B7EE16D4440CFF3F91EF1065FC0A87F54536A6D44400D1AEE479D075FC0281F649B0C6D44405009359411085FC0140AE9EE4F6D444045FC996069085FC0F01C993AD46D4440533DB0AECD085FC0B07B91CE956E4440B260994CAF095FC07807EF4D816E444025B6A2FDEA095FC09C0904164D6E4440DC2A6D76060A5FC0E0AE4381F36C44407552A7B5A90A5FC0983050E2CB6B44403D346CF4E70A5FC074BDFB2AD3694440F822C63DC60B5FC0083E1FA2676844405068E6EA630C5FC04CC03713B46644400639609EC80C5FC048D0B80D766444405DDE585A4A0E5FC088997386E860444032D16FDEE60E5FC02054855A216244402035A9D8E00D5FC07432A677A964444098A4BE014D0B5FC06060D236836C4440A2B91C7C8F085FC0541312EADB7744405F557A29B9075FC0607380604E7D44402687230311075FC00846F8CDF3814440AD3EB76021075FC05CE333205585444008B1F76B7D075FC098C108F62C864440DD5FFA1A26085FC0708BB90B5786444068F244D89C085FC0CCDFBE34238644400ADDD6BD25095FC0B4F2F9DFCC864440E0C0A37466095FC013091780B38744403DC1902B8E095FC098F105F3B8894440B5875C27F0095FC0B09D9EA71C8B4440031C7CD3470A5FC06CBF248BB78C4440ED5DBDFC410A5FC058AA7F3B898E44403C2374D77F0A5FC058368196EC904440F7134AC96C0A5FC0A0FED461CD914440C1CE5656010A5FC04C3ABC9438924440D95190C373095FC080EE24990A9244406A39C3AC2E095FC01C82FE178F9244409CABD0E7F3075FC02C8F198245974440BF607CD33F075FC01804258B4F9C444049947CD3D1055FC000CC7AE00CA54440C2AB277E42055FC0948D258BBFAB444020CBE4FC56045FC0509935D40FB344406278775AFA035FC0C07DC8C8CAB74440B044277EDE045FC06CBF248BB7BE4440BB607CD33F055FC0888D258BBFC24440BF607CD35F045FC0E819CF3506C54440299FD1280D055FC0FCCB7AE08CC544402C9FD128AD055FC0E093D0354AC64440623E7CD333065FC0E019CF3546C7444087C1D12899065FC0E4FD79E084C84440EC717CD3A5065FC08C71D035BEC94440663E7CD393065FC0D8B2CE3522CD44403F06D228D1065FC044B6D035D6CD4440ACF97BD35B075FC03CB6D03516CF4440944F7CD319085FC038D5CE35EED14440613E7CD3F3085FC00436248B07D544409C28D228DD085FC0C0C5CF3502D74440C19B5E8A54095FC0885563B36ADA444010CCBD92340A5FC0B8F1F35B4BDE4440654445A9580B5FC0686936482EDF44408CD86CE7060C5FC000D8B5679DDF444037B19369900C5FC0208C42793CDF44403824D6F1DE0C5FC0F80D9B8EA1DE4440B0500200DF0E5FC09872AB1895E1444090635246D3105FC028E8F0FC61E3444034DB2971AB105FC0382257D8F6E44440FD861CFDDD0F5FC0501499A79DE54440CE705F41F90E5FC050268B2117E84440856B776D010E5FC0EF904002CDEC4440C4B91658800D5FC0F767F19C0CF244403D06D228F10C5FC028D5CE35EEFA4440F84AD228090D5FC02804258B4FFC4440372D7CD34D0D5FC0DCB2CE35A2FD44406AB0E7B7BA0D5FC050EA18EFF0FF4440C53E2E80E30B5FC0D8FB18EFF0FF4440143194E625FB5EC0D8FB18EFF0FF4440AA8BC71969EA5EC0D8FB18EFF0FF4440057E2D80ABD95EC0D8FB18EFF0FF4440567093E6EDC85EC0D8FB18EFF0FF44401551FB4C30B85EC0D8FB18EFF0FF444079B42D8073A75EC0D8FB18EFF0FF4440FF9D94E6B5965EC0D8FB18EFF0FF44405590FA4CF8855EC0D8FB18EFF0FF4440AC8260B33A755EC0D8FB18EFF0FF4440396CC7197D645EC0D8FB18EFF0FF4440C7C6FA4CC0535EC0D8FB18EFF0FF4440CE77FB4C02435EC0D8FB18EFF0FF4440256A61B344325EC0D8FB18EFF0FF444001952D8087215EC0D8FB18EFF0FF444010B7FA4CCA105EC0D8FB18EFF0FF4440DF70FA4C0C005EC0D8FB18EFF0FF4440583894E60B005EC06F4DE5BB7DE84440,-15.0%,"-1,699","9,612","5,600","4,012",California,true
10,0106000020E61000005500000001030000000100000009000000643E7CD3938954C0F04C4A16378D38404C947CD3918954C090C34916078D384014F5D1288B8954C0B027A16B148D3840EE717CD3858954C05F40F4C0A18C38409ADD267E9A8954C0E8AAF6C0798C3840D17CD128A18954C040084A169F8C3840C2AB277EA28954C020D09F6B9C8C3840663E7CD3B38954C0301B4B16FF8C3840643E7CD3938954C0F04C4A16378D3840010300000001000000050000002CEA7CD34F8A54C0F06B48160F8D38400867277E6A8A54C00098F5C0998C38405222277E928A54C0B0DCF5C0318D38408BC1D128798A54C058BD9E6BBC8D38402CEA7CD34F8A54C0F06B48160F8D3840010300000001000000060000009CDD267E9A8754C03785F4C0B98D3840A7B67CD33D8854C06F8B9F6B048D384060FB7CD3358854C078F54816BF8D3840663E7CD3938754C020EF9D6B748E3840071C7CD3478754C0606CA16BAC8E38409CDD267E9A8754C03785F4C0B98D384001030000000100000004000000D4C77CD3838A54C058E94B16C7903840DC0A7CD3818A54C0C0914A164F8F3840725AD128958A54C03085F4C0B98F3840D4C77CD3838A54C058E94B16C7903840010300000001000000040000002CEA7CD3CF8954C0C07E49166F923840663E7CD3F38954C0409EA06B6492384018837CD3EB8954C0D07E4916EF9238402CEA7CD3CF8954C0C07E49166F923840010300000001000000190000000A67277E6A6F54C050BD9E6BBC923840F2717CD3256F54C09059A06BCC913840725AD128F56E54C0A8469F6B6C9038408CC1D128D96E54C0609EA06B648E384060FB7CD3356F54C09759A06BCC8E38404A947CD3716F54C0A0FBF3C0898F38409CDD267E9A6F54C0C0339E6B8C903840C6AB277EC26F54C0509EA06BE49138405422277ED26F54C0A059A06B4C913840643E7CD3D36F54C0201B4B167F903840F0717CD3E56F54C0880EF5C069903840FA4AD228297054C0509EA06BE4913840AAB67CD35D7054C0F8E2A06BFC8F3840C2AB277EA27054C0609EA06B648E3840A6B67CD33D7154C05072F3C0D98C3840643E7CD3337254C0A0914A16CF8B3840DC0A7CD3217454C0579EA06BE48A3840AEF97BD3DB7354C0509EA06BE48E384048947CD3517354C0DF7E49166F8F3840D5C77CD3A37254C020D09F6B9C8E38404C947CD3F17154C0609EA06B648E384076A57CD3777154C07F21F6C0498F3840FA4AD228297054C018E3A06B7C933840C6AB277EC26F54C018E3A06B7C9338400A67277E6A6F54C050BD9E6BBC9238400103000000010000000F000000E8E3D128E56954C068AA9D6BDC9738409ADD267E9A6954C018E3A06B7C9338405222277E726E54C0609EA06B648E384042BB267E2E6E54C048BD9E6B3C8F3840F84AD228896D54C0509EA06BE4913840F84AD228896D54C018E3A06B7C933840C4AB277EE26D54C058F54816BF9438408AC1D128F96D54C0C027A16B1496384076A57CD3D76D54C010E3A06B7C973840F84AD228896D54C0A8FBF3C009993840D5C77CD3236D54C0A8FBF3C0099938400A1C7CD3876C54C0E014A06B34973840EAE3D128C56B54C010029F6B5497384004D97CD3096A54C0A8FBF3C009993840E8E3D128E56954C068AA9D6BDC9738400103000000010000000D000000D4C77CD3A38754C058BD9E6B3C983840D2C77CD3038754C0E0339E6B0C963840E4E3D128E58654C09F659D6B449338404E947CD3118754C0B0659D6BC4903840D4C77CD3238754C0E0E8F2C0299238400A1C7CD3A78754C06F21F6C0C995384032EA7CD32F8854C03072F3C0D9963840C2607CD39F8854C0A859A06BCC9738406F5AD128F58854C0609EA06BE4973840643E7CD3538954C030BD9E6BBC973840F0717CD3258954C0B0FBF3C08998384040BB267E6E8854C020D09F6B1C993840D4C77CD3A38754C058BD9E6B3C983840010300000001000000040000009CDD267E3AB754C088D64A1667A038406889277E56B754C0C0914A16CF9F384098DD267E5AB754C06053F5C081A038409CDD267E3AB754C088D64A1667A03840010300000001000000040000003CBB267EEEB754C0AFA44B162FA03840D2C77CD303B854C0C0914A16CF9F38407C33277EF8B754C097A44B162FA138403CBB267EEEB754C0AFA44B162FA03840010300000001000000040000000A67277E8AB754C0A0A44B16AFA1384002D97CD389B754C06821F6C0C9A03840A6B67CD39DB754C0F8AAF6C0F9A038400A67277E8AB754C0A0A44B16AFA13840010300000001000000040000004849D128EFBA54C0AFEFF6C011A2384068CC267E34BB54C0A80EF5C069A13840C2AB277E22BB54C018029F6BD4A238404849D128EFBA54C0AFEFF6C011A2384001030000000100000009000000C0607CD39FB654C0A02DF3C041A63840B044277E9EB654C0B027A16B14A6384078A57CD397B654C08840F4C021A638405222277E92B654C0606CA16BACA53840F5FF267EA6B654C0688B9F6B84A538402E9FD128ADB654C0C0E8F2C0A9A538404649D128AFB654C09FB04816A7A53840BC607CD3BFB654C0B0FBF3C009A63840C0607CD39FB654C0A02DF3C041A6384001030000000100000006000000081C7CD3475A54C07821F6C0C9A738401A837CD38B5A54C0A0914A16CFA53840A8B67CD3FD5A54C05072F3C0D9A638400C67277E2A5B54C0606CA16BACA73840924F7CD3B95A54C0B8914A16CFA83840081C7CD3475A54C07821F6C0C9A73840010300000001000000070000001C837CD30B5154C0086C48160FA938400867277EAA5154C010029F6BD4A73840C4AB277EC25154C03F72F3C059A838408EC1D128F95054C03072F3C0D9AB3840081C7CD3A75054C010EF9D6BF4AB3840FC4AD228895054C0900EF5C0E9AA38401C837CD30B5154C0086C48160FA938400103000000010000000D000000A4B67CD31D5C54C0086C48160FA93840C0607CD33F5C54C0A0FBF3C089A638408CC1D128995C54C00098F5C099A63840A8B67CD3BD5C54C050BD9E6BBCA73840AEF97BD37B5D54C0B027A16B14AA38404406D228915D54C0B0659D6BC4AB3840EF717CD3255D54C0C827A16B14AD38401C837CD30B5D54C018E3A06B7CAD3840ED717CD3455D54C0D8339E6B8CAD3840EF717CD3255D54C09F469F6B6CAE38402A9FD128AD5C54C02085F4C039AE38402E9FD1284D5C54C0900EF5C0E9AB3840A4B67CD31D5C54C0086C48160FA9384001030000000100000026000000E6E3D128856354C0806CA16B2CB03840081C7CD3676354C050AA9D6BDCAF38406889277E366354C0A00EF5C0E9AF3840DE0A7CD3016354C01098F5C099AF38404406D228916254C04FAA9D6BDCAC3840C6AB277E626054C0C0FBF3C089A33840C6AB277E626054C048084A169FA138408AC1D128F96154C0481B4B167F9D384000D97CD3296454C0606CA16B2C9A3840A8F97BD3BB6854C0409EA06B64953840A8F97BD3BB6854C040084A161F973840AAF97BD37B6754C0201B4B16FF9A3840D27CD128C16654C0C0339E6B0C9C3840A8F97BD31B6654C02F084A169F9A38405DFB7CD3B56454C038D09F6B1C9D384049947CD3516454C057084A161F9E3840081C7CD3276454C05F8B9F6B049F38405022277EF26354C0B0469F6B6C9F38409E28D2287D6354C048084A169FA138403EBB267E6E6454C05072F3C0D9A338405222277ED26454C0F897F5C019A538404D947CD3316554C070AA9D6BDCA638403CBB267E4E6354C030EF9D6BF4A43840904F7CD3796254C0C07E4916EFA23840C4AB277E226254C0FF2D4C16DF9F3840A028D228BD6154C0FF2D4C16DF9F38402BEA7CD36F6154C0B0914A164FA33840E4E3D128A56154C06FAA9D6BDCA538405EFB7CD3556254C0706CA16B2CA738409E28D2287D6354C070AA9D6BDCA638409E28D2287D6354C0B0659D6BC4A83840C2AB277E226354C02885F4C039AA3840AEF97BD33B6354C0E014A06B34AB384001D97CD3A96354C0B0914A16CFAB384049947CD3516454C027D09F6B1CAC3840DA0A7CD3E16354C0708B9F6B84B138409E28D2287D6354C0708B9F6B84B13840E6E3D128856354C0806CA16B2CB0384001030000000100000015000000663E7CD3B35E54C0E0E8F2C029AC3840B044277E9E5E54C020EF9D6B74A73840392D7CD3CD5E54C067AA9D6B5CA638404206D228115F54C0A8A44B162FA838403EBB267E6E5F54C0A0FBF3C089A93840725AD128D55F54C0D0AAF6C0F9A93840061C7CD3276054C098789E6BA4A9384004D97CD3696054C0F8E2A06BFCA838406489277EB66054C0A059A06B4CA93840CE7CD128E16054C09859A06BCCA93840081C7CD3076154C060AA9D6B5CAA38400867277E4A6154C0F86B48168FAC38407AA57CD3376154C020EF9D6BF4AF384062FB7CD3F56054C030084A169FB23840B244277EBE6054C0A859A06BCCB238405422277E726054C080789E6B24B2384040BB267E0E6054C008E3A06BFCB1384032EA7CD38F5F54C0B7A44B162FB138406889277E165F54C050F54816BFAF3840C0607CD3DF5E54C0A70EF5C0E9AE3840663E7CD3B35E54C0E0E8F2C029AC38400103000000010000000A0000004C947CD3315454C0F0E2A06BFCAD38406789277E565454C07021F6C0C9AC3840765AD128D55454C0806CA16B2CAF38401C837CD36B5554C01098F5C099B03840BB607CD39F5554C010E3A06B7CB138404306D228D15554C03885F4C039B338402EEA7CD38F5554C0606CA16B2CB438405EFB7CD3155554C0C0339E6B0CB43840F0717CD3855454C08721F6C0C9B138404C947CD3315454C0F0E2A06BFCAD38400103000000010000000D000000031C7CD3474554C0E06B48160FB33840A028D2289D4554C01098F5C099AF38402DEA7CD3EF4554C0B0469F6B6CB33840F6FF267EA64654C0E07E4916EFB4384062FB7CD3B54854C0201B4B16FFB43840ED717CD3654754C03085F4C039B7384040BB267EEE4354C01085F4C039BB3840352D7CD38D4254C0301B4B16FFBB3840944F7CD3994254C0D714A06B34BA38401E837CD3CB4254C0C8469F6B6CB938401B837CD34B4454C0B0659D6B44B73840C2607CD3DF4454C0888B9F6B84B53840031C7CD3474554C0E06B48160FB338400103000000010000000A0000001E837CD3CB5554C0E86B48168FA5384060FB7CD3355754C048084A169FA138402EEA7CD34F5754C0BF659D6B44A9384000D97CD3895B54C048BD9E6B3CC13840ACF97BD35B5B54C04072F3C059C038402B9FD1282D5B54C00FEF9D6BF4BF3840735AD128B55A54C0C0E8F2C0A9BF384031EA7CD3CF5854C038BD9E6B3CBA3840BE607CD3BF5654C0CFE8F2C0A9AF38401E837CD3CB5554C0E86B48168FA5384001030000000100000009000000AC44277E5E3D54C010029F6BD4BF3840A6B67CD31D4254C03F1B4B167FB838400A1C7CD3273D54C09059A06BCCC43840BE607CD31F3B54C017E3A06B7CC63840BE607CD31F3B54C04F9EA06BE4C43840C6AB277E623B54C0888B9F6B04C43840041C7CD3A73B54C0608B9F6B84C3384032EA7CD36F3C54C0F0E2A06BFCC23840AC44277E5E3D54C010029F6BD4BF38400103000000010000000E00000088C1D128593354C0A0A44B16AFD338403EBB267E2E3354C0C8659D6B44D33840FC4AD228C93254C040084A169FD43840D2C77CD3633254C040084A169FD43840C0607CD35F3254C028EF9D6B74D338405EFB7CD3753254C0806CA16BACD23840FC4AD228C93254C050084A161FD138406889277E563354C0F8019F6B54CF3840DE0A7CD3613454C07821F6C049CE384078A57CD3B73654C0A0789E6BA4CD3840765AD128153654C0D0AAF6C079D038408CC1D128393354C018EF9D6BF4D738406889277E563354C0BF469F6B6CD5384088C1D128593354C0A0A44B16AFD338400103000000010000000A00000074A57CD3F72D54C0888B9F6B04DC38405422277EF22E54C0AFA44B16AFD93840D07CD128412F54C07821F6C0C9D938409EDD267E1A2F54C000E3A06B7CDB3840643E7CD3B32E54C0102E4C16DFDC3840EE717CD3252E54C0102E4C16DFDD38409ADD267EDA2C54C0B0FBF3C089E13840DC0A7CD3C12C54C018029F6B54E03840AC44277E7E2D54C0A0659D6B44DD384074A57CD3F72D54C0888B9F6B04DC384001030000000100000004000000F4FF267E862C54C080C3491607E73840EC717CD3C52C54C048BD9E6BBCE6384059B0D128D32C54C0A0FBF3C009E83840F4FF267E862C54C080C3491607E7384001030000000100000004000000F8FF267E263254C030EF9D6BF4EF384030EA7CD32F3254C03785F4C0B9EF384030EA7CD36F3254C0982DF3C0C1F03840F8FF267E263254C030EF9D6BF4EF384001030000000100000008000000031C7CD3672954C00FD09F6B9CE738403EBB267E0E2A54C0A8A44B16AFE63840071C7CD3072854C0686CA16BACEF384060FB7CD3952754C0B0FBF3C009F13840EAE3D128852754C0E8E8F2C029F03840FA4AD228892754C040084A169FEF3840603E7CD3132854C0C827A16B94EC3840031C7CD3672954C00FD09F6B9CE73840010300000001000000040000004406D228712E54C098789E6B24003940CE7CD128E12E54C000029F6BD4FE38409EDD267EDA2E54C0481B4B167F0039404406D228712E54C098789E6B240039400103000000010000000400000006D97CD3493754C0D0E8F2C029083940BAD2D1285F3754C010B7F3C0F1073940E6E3D128853754C070AA9D6BDC08394006D97CD3493754C0D0E8F2C0290839400103000000010000000500000032EA7CD32F3054C080D64A16670839404A947CD3313054C0AFB0481627073940C4AB277EA23054C0F714A06BB4093940FA4AD228693054C040084A169F0A394032EA7CD32F3054C080D64A1667083940010300000001000000050000000867277E0A2954C020D09F6B1C143940663E7CD3532954C0A0469F6B6C133940D80A7CD3812954C040274816F71439408233277E382954C08740F4C0A11539400867277E0A2954C020D09F6B1C14394001030000000100000004000000745AD128D52A54C058084A161F1A39409C28D2289D2A54C0708B9F6B84183940A6B67CD37D2B54C0CF7E49166F1A3940745AD128D52A54C058084A161F1A39400103000000010000000B0000006ECC267E542954C0203A4916D71839408AC1D128792954C02FBD9E6BBC1739407E33277E982954C0B0FBF3C089183940008ED128C72954C04066F6C0E1183940AC44277EDE2954C0D8C9F4C0511A3940C3AB277E222A54C0F0019F6B541B3940DB55277E242A54C0C0339E6B0C1C3940663E7CD3D32954C0509EA06B641C3940D1C77CD3832954C0DFE8F2C0A91B39406ECC267E542954C0886CA16BAC1A39406ECC267E542954C0203A4916D718394001030000000100000006000000603E7CD3B32B54C0A80EF5C0691D3940D2C77CD3E32B54C0B0B04816271D39404449D128CF2B54C0806CA16BAC1F39400EAA267E882B54C02FD09F6B1C1F39406F17D228772B54C040BD9E6BBC1D3940603E7CD3B32B54C0A80EF5C0691D39400103000000010000000A0000000A67277EEA1E54C02F72F3C0591C3940ACF97BD3BB1F54C0D8E8F2C029193940AF44277EDE1F54C0489EA06BE41939409CDD267EBA1F54C060D64A16E71A3940623E7CD3931F54C0B8B04816271B3940964F7CD3791F54C0D0DCF5C0311C3940C6AB277E021F54C00898F5C0991D3940909A277EBC1E54C0AFFBF3C009203940332D7CD38D1E54C07F8B9F6B841C39400A67277EEA1E54C02F72F3C0591C39400103000000010000000800000018837CD3CB2854C04072F3C0D91C39406ECC267E142954C060E94B16C71C39404506D228512954C0006C48168F1F3940D80A7CD3412954C01085F4C039223940CA39D228032954C05053F5C00123394062FB7CD3F52854C0281B4B167F2239405CB0D128B32854C04866F6C0611F394018837CD3CB2854C04072F3C0D91C3940010300000001000000040000003EBB267E2E2D54C090A44B162F233940F94AD228492D54C090789E6B24213940C0AB277EA22D54C030084A161F2339403EBB267E2E2D54C090A44B162F23394001030000000100000007000000AAF97BD39B2554C0BFFBF3C0092B3940725AD128D52554C09F659D6B442939404206D228912654C060D64A16672A3940EAE3D128C52654C0B7FBF3C0892B3940CB39D228832654C0D014A06BB42C3940041C7CD3072654C03F1B4B16FF2B3940AAF97BD39B2554C0BFFBF3C0092B394001030000000100000008000000924F7CD3792254C0E07E4916EF2E39406989277EF62254C0B0FBF3C0892E3940008ED128072354C0A8789E6BA42E39406689277ED62254C090EFF6C0912F3940289FD1288D2254C0DF7E4916EF2F39405CB0D128732254C080D64A16E73039409ADD267E3A2254C0A0EFF6C011313940924F7CD3792254C0E07E4916EF2E39400103000000010000000D00000016F5D128CB3C54C030D09F6B1C383940B4D2D128DF3C54C030D09F6B1C38394098DD267E7A3D54C0E014A06BB43839406ACC267EF43C54C00098F5C0993B394016F5D128CB3C54C07F59A06BCC3C39406ACC267EF43C54C0E05F4B16973D39406D17D228973C54C03F53F5C0813D39400C67277E2A3C54C0AFFBF3C0093D39405222277E323C54C0F06B48160F3C39405EB0D128133C54C00098F5C0993B3940BE607CD35F3C54C050274816F73A39409CDD267EDA3C54C0B0EFF6C0113A394016F5D128CB3C54C030D09F6B1C3839400103000000010000000A000000DD55277E443E54C0A0789E6B244139400867277EAA3E54C0E7339E6B0C403940FC4AD228C93E54C0A8C3491607413940DC0A7CD3813E54C0A059A06B4C423940FC4AD228893E54C0B7FBF3C089423940924F7CD3993E54C0A8EFF6C0114339406A89277E963E54C0BF7E49166F43394078A57CD3373E54C02085F4C039433940745AD128D53D54C0A0469F6B6C413940DD55277E443E54C0A0789E6B244139400103000000010000000C000000AD44277E5E3B54C0A0469F6B6C423940F8FF267E063B54C010D09F6B1C3F3940FC4AD228293B54C0B0469F6BEC3C3940F6FF267E663B54C0283A4916573B3940081C7CD3873B54C0E8E8F2C0293B3940CE7CD128A13B54C0102E4C16DF3E39409CDD267EDA3B54C018B7F3C0714039406ECC267E143C54C0882DF3C0414039406A89277E363C54C0DF6B48168F403940C4AB277E223C54C05853F5C081423940D80A7CD3C13B54C09FC3491607443940AD44277E5E3B54C0A0469F6B6C4239400103000000010000000C0000002EEA7CD34F4354C078F548163F473940C5AB277EC24354C080789E6B24463940061C7CD3474454C04872F3C0D9463940F6FF267EC64454C0A00EF5C0E9493940D4C77CD3034554C050BD9E6B3C4D394002D97CD3A94454C0282E4C165F4F3940643E7CD3D34354C08859A06BCC4F394006D97CD3094354C0EF14A06B344F3940A028D228BD4254C0E014A06BB44E394018837CD38B4254C038EF9D6BF44B39409BDD267E1A4354C020EF9D6BF44839402EEA7CD34F4354C078F548163F473940010300000001000000090000004206D228314354C06053F5C081503940CA39D228E34354C03F9EA06BE44F39405022277E324454C030EF9D6BF4503940A26BD1285B4454C0E07E49166F5239409E28D2283D4454C0303A4916D7533940A228D228DD4354C030BD9E6B3C543940D0C77CD3C34254C050084A161F5339409E28D2289D4254C0706CA16B2C5239404206D228314354C06053F5C0815039400103000000010000000E0000006489277E364754C0C027A16B94563940735AD128F54654C0E07E49166F563940934F7CD3394654C0F06B48160F5739405622277EB24554C070F54816BF563940EC717CD3854554C08059A06BCC543940ACF97BD37B4554C0B8A44B16AF533940D2C77CD3A34554C0C0FBF3C08952394042BB267ECE4554C0D027A16B145039401D837CD36B4654C028EF9D6B74513940643E7CD3F34654C0D77E4916EF5239405022277ED24754C0E8E8F2C029563940745AD128754754C0A0FBF3C0895739404006D228114754C030084A161F5739406489277E364754C0C027A16B945639400103000000010000003F000000C4AB277E221754C0F0019F6BD42839406689277E561C54C040084A161F163940081C7CD3071D54C030BD9E6BBC14394098DD267EBA1D54C02FEF9D6B74153940FA4AD228291E54C090A44B16AF123940A5B67CD3BD1E54C070F54816BF0C3940A6B67CD33D1F54C0F097F5C0190A3940944F7CD3392154C0C0914A16CF033940765AD128952354C0F86B48168FF83840061C7CD3072554C0C0659D6B44F33840EC717CD3452654C02885F4C039F33840C0607CD39F2654C0E8339E6B0CF63840D4C77CD3032654C030EF9D6B74F738401C837CD30B2554C06721F6C049F83840643E7CD3532454C018029F6B54F938402EEA7CD38F2354C0B0914A164F02394062FB7CD3352354C0C0914A16CF0339403CBB267E2E2254C070F548163F0439404C947CD3B12154C0E0339E6B8C05394002D97CD3C92054C0F0AAF6C0F90A3940705AD128351F54C0E0339E6B0C113940F6FF267EC61E54C0BF27A16B14143940CE7CD128011F54C070AA9D6B5C173940C4AB277EA21D54C0DF6B48160F183940623E7CD3F31C54C0509EA06B64193940CD7CD128611C54C00FEF9D6B741C39402CEA7CD3AF1C54C03072F3C0591E394061FB7CD3B51C54C0C8659D6B441F39407AA57CD3771C54C050F548163F1F3940AAF97BD3FB1B54C050AA9D6B5C1E3940A9B67CD3BD1B54C04772F3C0592139408EC1D128191C54C06021F6C0C9233940663E7CD3D31C54C070F54816BF24394098DD267EBA1D54C0E07E49166F2339408CC1D128591D54C0F0E2A06BFC273940745AD128751A54C050BD9E6BBC253940AEF97BD33B1954C0202E4C16DF303940AE44277EDE1654C0CF14A06B343A3940C2AB277E421654C0DF6B48168F3F39400C67277E6A1654C06721F6C049433940D4C77CD3E31654C028EF9D6BF4443940D90A7CD3611754C05072F3C0594639409B28D2289D1754C078F548163F49394060FB7CD3351754C0A059A06BCC4A3940FC4AD228291554C0A8A44B16AF4C39404206D228511454C0C827A16B944E39408AC1D128991254C070F54816BF573940BF607CD37F1154C0A0659D6B445A39409CDD267E1A1054C0A8A44B162F58394030EA7CD34F1054C07821F6C0C9563940E8E3D128851054C08059A06BCC553940C0607CD3BF1054C0F097F5C019553940E5E3D128051154C0A7FBF3C089543940623E7CD3731154C06FAA9D6BDC523940D27CD128E11154C0C07E4916EF4F3940603E7CD3331254C07F0EF5C0E94C3940745AD128551254C0C0469F6BEC4A3940E8E3D128A51254C05072F3C059483940D4C77CD3831454C0DF6B48168F3F39409E28D2289D1654C030084A169F34394002D97CD3691754C0589EA06B642E3940C4AB277E221754C0A0469F6B6C2A3940C4AB277E221754C0F0019F6BD428394001030000000100000008000000A66BD128BB4454C038EF9D6B745839401C837CD3CB4454C02F85F4C0B95739403778277E104754C068F548163F583940008ED128874754C0B8914A16CF583940603E7CD3534754C0C8FBF3C0095A39404406D228F14654C070F54816BF5A3940969A277EBC4554C0B027A16B14593940A66BD128BB4454C038EF9D6B7458394001030000000100000010000000DE0A7CD3E10D54C050AA9D6B5C6A394019837CD3CB0E54C0B0659D6B44673940DD0A7CD3E10E54C028D09F6B9C6739401A837CD30B0F54C0A0789E6BA4673940AAF97BD33B0F54C09F469F6BEC673940A8F97BD35B0E54C0808B9F6B846A394042BB267ECE0D54C00098F5C0996E39401C837CD3CB0C54C04F9EA06B647D3940AAF97BD39B0C54C0A0789E6BA47E39401C837CD30B0C54C0B027A16B947F39404006D228F10B54C07821F6C0497E39402EEA7CD30F0C54C0B0659D6B447C39401A837CD32B0C54C080789E6B247B3940FA4AD228690C54C0F86B48168F753940EC717CD3050D54C0B0659D6BC46F3940DE0A7CD3E10D54C050AA9D6B5C6A394001030000000100000011000000DB0A7CD3210A54C0609EA06BE4AD39402C9FD1286D0A54C078F548163FAC3940A028D2283D0B54C0589EA06B64AC3940C1AB277EA20B54C0900EF5C069AE39400E67277E8A0B54C058084A161FB139409C28D228DD0A54C0689EA06B64B33940ABF97BD31B0B54C0C07E4916EFB33940EE717CD3450B54C0E77E49166FB439405222277E720B54C077AA9D6BDCB43940AEF97BD3BB0B54C090789E6B24B53940AEF97BD3BB0B54C040BD9E6BBCB63940B044277E3E0B54C0589EA06BE4B73940C4AB277EE20A54C0D0339E6B0CB93940BB607CD39F0A54C0A00EF5C069BA39402C9FD1286D0A54C0A0789E6B24BC3940A028D228FD0954C0A0789E6B24BC3940DB0A7CD3210A54C0609EA06BE4AD39400103000000010000000C0000006A89277E165854C03072F3C059CD394010F5D128EB5754C0AFA44B162FCC3940071C7CD3A75754C0004D4A16B7CC39401C837CD34B5754C0F05F4B1617CD39402E9FD1288D5654C0006C48168FCC39402EEA7CD34F5654C02085F4C0B9CA394004D97CD3C95654C000E3A06BFCC83940D5C77CD3435754C0B027A16B94C83940643E7CD3F35854C0A0FBF3C009CB3940A46BD128FB5854C070F548163FCC3940B6D2D1283F5854C0B8FBF3C009CE39406A89277E165854C03072F3C059CD394001030000000100000017000000C2AB277EE25754C0B8469F6BECD03940964F7CD3B95754C0609EA06B64CF3940081C7CD3275854C0FF97F5C099CE39403A2D7CD3CD5854C050AA9D6B5CCE39400D67277E2A5954C04FAA9D6B5CCD394006D97CD3695954C0AFA44B162FCC394077A57CD3975954C0EFE2A06B7CCB3940725AD128955954C0E014A06BB4CA394040BB267ECE5954C090789E6B24CB3940FA4AD228095A54C030EF9D6BF4CB3940AAF97BD3BB5A54C0D0339E6B0CCF394062FB7CD3355B54C03FBD9E6BBCCF3940AAF97BD3BB5B54C0788B9F6B04CE3940DA0A7CD3215C54C08059A06BCCCD3940FAFF267E265C54C0C027A16B94D33940A028D2283D5C54C030084A161FD539404206D228315C54C0D0E8F2C0A9D73940A028D2287D5B54C0F0019F6BD4D93940DC0A7CD3615A54C0102E4C16DFD739403CBB267EEE5954C0A7659D6B44D63940F2717CD3C55854C0F0AAF6C0F9D23940924F7CD3595854C0E8E8F2C029D23940C2AB277EE25754C0B8469F6BECD039400103000000010000001C000000E6E3D128C55D54C018D09F6B9CDD39402EEA7CD34F5D54C0D814A06BB4D939403F06D228315D54C05F8B9F6B84D73940E6E3D128055D54C050BD9E6BBCD63940745AD128D55C54C0B027A16B14D53940D6C77CD3035D54C000029F6B54D339400A67277E6A5D54C080789E6BA4D23940C2AB277EE25D54C0C0914A164FD43940F0717CD3255E54C0F8019F6BD4D53940613E7CD3535E54C0A0789E6B24D739404606D228B15E54C0F0E2A06BFCD839405422277EB25F54C0A0659D6B44D93940C0607CD3DF5F54C088789E6B24DA39403CBB267E2E6054C0401B4B16FFDA3940D17CD128816054C048084A161FDA3940FA4AD228896054C0A80EF5C0E9D83940705AD128956054C0D07E4916EFD73940643E7CD3B36054C048BD9E6B3CD63940E7E3D128C56054C0E7339E6B0CD63940F8FF267EC66054C010D09F6B1CD73940745AD128F56054C0B0914A16CFD73940D2C77CD3436154C0A0659D6B44D93940765AD128156154C00098F5C019DC39404C947CD3316054C0E8E8F2C0A9DD3940E6E3D128A55F54C020D09F6B1CDE394088C1D128595F54C0706CA16BACDE3940AAF97BD35B5E54C04F72F3C059DF3940E6E3D128C55D54C018D09F6B9CDD39400103000000010000000800000018837CD36B6454C08FC3491687E0394075A57CD3B76454C0B0DCF5C0B1DF3940AAF97BD3DB6454C0DFE8F2C0A9E03940969A277EBC6454C0A8659D6BC4E23940BE607CD37F6454C0D0C9F4C051E33940AEF97BD33B6454C08021F6C0C9E239400B67277E4A6454C0A0789E6BA4E1394018837CD36B6454C08FC3491687E0394001030000000100000010000000EC717CD3456B54C02085F4C0B9E63940755AD128756A54C028D09F6B9CE53940A6B67CD33D6A54C038EF9D6BF4E23940C4AB277E026B54C0688B9F6B04DE39409ADD267E5A6B54C0B0FBF3C089DC39402E9FD1282D6C54C020EF9D6BF4DC3940372D7CD38D6C54C0A7789E6BA4DD39408AC1D128B96C54C04F9EA06B64DF3940F6FF267EE66C54C0A0789E6BA4E03940745AD128356D54C0E0E8F2C0A9E139408DC1D128596D54C070F548163FE23940A228D2287D6D54C0A0659D6BC4E339406889277E566D54C0F76B48160FE63940AAF97BD3BB6C54C050AA9D6B5CE639406889277E166C54C01885F4C039E63940EC717CD3456B54C02085F4C0B9E63940010300000001000000110000005EFB7CD3556254C020EF9D6BF4DE3940382D7CD3ED6254C0B8FBF3C089DA39409CDD267E1A6354C0708B9F6B84DB394088C1D128F96254C0B0469F6B6CDF39402EEA7CD30F6354C0E814A06BB4E13940705AD128756354C0D07E49166FE23940DC0A7CD3C16354C0F097F5C099E33940081C7CD3E76354C0D027A16B14E53940AEF97BD3BB6354C0C8659D6B44E7394032EA7CD3EF6254C0778B9F6B04E73940C0AB277E826254C0EF14A06B34E53940613E7CD3B36254C000029F6BD4E43940BFAB277EC26254C027D09F6B9CE43940BC607CD39F6254C0FF2D4C16DFE339403EBB267E4E6254C0086C48168FE23940F2717CD3256254C0E07E4916EFE039405EFB7CD3556254C020EF9D6BF4DE394001030000000100000017000000E6E3D128458854C0C0339E6B0C763A40FC4AD228298654C070AA9D6B5C743A400E67277EEA8454C08821F6C0C9743A40D07CD128618454C0A059A06BCC773A4078A57CD3B78154C0CF339E6B8C723A4001D97CD3E98254C01098F5C099713A4001D97CD3898454C0F014A06BB46C3A40EE717CD3A58554C0489EA06B646B3A40CE7CD128A18654C0886CA16B2C6C3A40A6B67CD37D8A54C07F59A06B4C743A40643E7CD3338B54C0509EA06B64763A400A1C7CD3C78B54C0606CA16B2C793A40B244277E3E8C54C0B8FBF3C0097D3A4076A57CD3D78C54C0888B9F6B04853A40A6B67CD31D8D54C0BF469F6BEC8C3A4030EA7CD38F8C54C0589EA06B648B3A405CFB7CD3358C54C05872F3C059893A409ADD267EFA8B54C04F9EA06BE4863A40372D7CD3CD8B54C0C8FBF3C009843A40DA0A7CD3418B54C0E014A06BB47E3A40CE7CD128818A54C0A0659D6BC47A3A40EE717CD3858954C038EF9D6BF4773A40E6E3D128458854C0C0339E6B0C763A400103000000010000000A0000002A9FD128AD8E54C060F548163FA23A40382D7CD36D8E54C000E3A06B7C9C3A402C9FD1284D8F54C05772F3C059A23A40924F7CD3D98F54C0708B9F6B84A73A40F8FF267EA69054C0A0FBF3C089B33A40924F7CD3599054C0608B9F6B84B33A40F8FF267E269054C0F097F5C019B33A40A6B67CD3BD8F54C08059A06BCCB13A40F7FF267EA68F54C02085F4C0B9AB3A402A9FD128AD8E54C060F548163FA23A40010300000001000000130000003EBB267E2E8554C0BF914A164F823A40BB607CD33F8554C017029F6BD47D3A4060FB7CD3158654C0D77E4916EF7E3A404A947CD3F18654C0886CA16B2C843A4002D97CD3E98754C048BD9E6BBC903A40BE607CD3BF8854C0806CA16BAC953A40904F7CD3798854C010D09F6B1C9C3A40643E7CD3538954C0202E4C16DFA33A4004D97CD3898A54C05F8B9F6B04AC3A40B044277E5E8B54C0A0FBF3C089B33A40AE44277E7E8A54C0A0FBF3C089B33A4060FB7CD3358954C00F029F6BD4B13A4078A57CD3F78754C0786CA16B2CAD3A40EF717CD3458754C0708B9F6B84A73A40C4AB277EE28754C03F9EA06B649E3A40D4C77CD3238754C0686CA16BAC983A40E5E3D128258654C0B0A44B162F933A40EE717CD3A58554C0EFAAF6C0798F3A403EBB267E2E8554C0BF914A164F823A400103000000010000000B000000725AD128959054C02FBD9E6BBCBC3A402A9FD1280D9154C0C8FBF3C009B73A40623E7CD3939154C030EF9D6B74BC3A400A1C7CD3C79154C0F0AAF6C0F9C83A40F6FF267E669254C00098F5C099CD3A40D2C77CD3039254C02785F4C039CF3A404A947CD3D19154C0072E4C165FCF3A40FAFF267E869154C00098F5C099CD3A40623E7CD3D39054C0DF14A06BB4C73A40C3AB277E829054C0B0A44B162FC23A40725AD128959054C02FBD9E6BBCBC3A400103000000010000000C000000725AD128F5A554C01F1B4B16FF563B40735AD128B5A554C0006C48160F533B40653E7CD3D3A654C0B8A44B162F563B4004D97CD389A954C040084A169F613B40623E7CD313AA54C0D727A16B94653B40F2717CD385AA54C0C0339E6B8C673B40382D7CD34DAB54C0E7AAF6C0F96B3B40705AD12895AB54C040084A161F6F3B40C4AB277E82AA54C06021F6C0496D3B40C0607CD3DFA954C0C07E49166F6B3B40643E7CD353A854C0D014A06B34613B40725AD128F5A554C01F1B4B16FF563B4001030000000100000026000000623E7CD3B30A54C0DF7E49166F323B402C9FD1286D0A54C028EF9D6B742C3B408CC1D128590B54C0B0659D6BC4333B40EF717CD3A50C54C018029F6B54393B405222277E520D54C0B0914A164F433B406889277E361154C0182E4C16DF613B40715AD128751154C0D727A16B94653B400A1C7CD3A71154C03872F3C0D9663B40061C7CD3871254C09F469F6B6C693B40964F7CD3B91254C0F0019F6BD46A3B404C947CD3D11254C0FF6B48160F6E3B40D1C77CD3A31354C0B0A44B162F763B40C2AB277E421654C09059A06BCC9C3B40765AD128D51654C01FD09F6B1CA13B4002D97CD3691754C0900EF5C069A43B40A4B67CD3DD1754C0D027A16B14A83B40382D7CD32D1854C050BD9E6BBCAF3B40CE7CD128C11854C0C8469F6BECB43B40DA0A7CD3E11854C0E8AAF6C0F9B73B40061C7CD3071954C03885F4C039BA3B40ACF97BD33B1A54C0E0E8F2C0A9C13B4030EA7CD30F1C54C0F097F5C099D43B40ACF97BD3DB1C54C050084A161FDA3B40C4AB277EA21C54C0B8FBF3C009DB3B40623E7CD3731C54C0808B9F6B84DB3B40AAF97BD3FB1B54C0D8339E6B0CDC3B40AAF97BD3FB1B54C0A0659D6BC4DA3B40BE607CD3DF1B54C0B7FBF3C009DA3B404C947CD3B11B54C0E77E49166FD93B40DA0A7CD3811B54C0E8339E6B8CD83B40EAE3D128051B54C0C727A16B14CE3B408CC1D128B91954C040084A169FC33B40C4AB277E221754C0788B9F6B84B33B408AC1D128391654C0788B9F6B04AA3B402CEA7CD3EF1554C0886CA16BACA43B40603E7CD3D31554C05072F3C0599F3B40AEF97BD39B1554C0A059A06B4C9B3B40623E7CD3B30A54C0DF7E49166F323B4001030000000100000007000000DA0A7CD3412854C04072F3C0592E3C40A9F97BD3BB2854C04072F3C0592E3C40765AD128D52854C0788B9F6B84313C40D07CD128012954C09F659D6B44343C40C2AB277E822954C0608B9F6B04393C405422277E722854C06FF54816BF303C40DA0A7CD3412854C04072F3C0592E3C4001030000000100000009000000AE44277EBEA954C008E3A06B7C8B3C404506D228F1A954C090789E6B248B3C40C4EE267E00AA54C04866F6C0618B3C40BC607CD3FFA954C0383A4916D78B3C40643E7CD333AA54C010B7F3C0F18C3C400A1C7CD387AA54C0F714A06BB48D3C406E17D228F7A954C010029F6BD48D3C40663E7CD3B3A954C0B0EFF6C0118C3C40AE44277EBEA954C008E3A06B7C8B3C400103000000010000001B000000352D7CD32D2754C058084A169F913C40725AD128952754C0A0789E6BA4893C404E947CD3912954C0D8E8F2C0A9793C40BC607CD31F2A54C0381B4B16FF6F3C40C0AB277E822A54C0E8E8F2C0A9503C402EEA7CD3CF2A54C0E0339E6B0C4C3C40D17CD128E12A54C00F98F5C099493C40C0607CD3BF2A54C098789E6BA4463C402A9FD1282D2A54C020D09F6B9C413C404A947CD3B12954C0E87E49166F3D3C405DFB7CD3952954C0A0789E6BA4393C403EBB267E8E2A54C0C0E8F2C0A9403C4032EA7CD3CF2C54C02FD09F6B1C593C40A4B67CD3BD2D54C0D8E8F2C0A95E3C4040BB267E0E2E54C07F0EF5C069633C409E28D2289D2E54C0B027A16B14783C4049947CD3312F54C048084A161F7C3C409CDD267E5A2F54C0F0AAF6C079843C40A6B67CD3DD2E54C0C8469F6B6C8B3C40BC607CD37F2D54C09059A06B4C8B3C40904F7CD3192D54C0608B9F6B848F3C406689277EB62C54C04072F3C059913C40AAF97BD35B2B54C0E014A06B34943C40623E7CD3F32954C0679EA06BE4973C40EC717CD3252954C040084A161F993C40DA0A7CD3412854C06021F6C049993C40352D7CD32D2754C058084A169F913C400103000000010000000A000000F0717CD3E5A954C01098F5C019A13C405EFB7CD3F5A954C03027481677A03C40C739D22823AA54C0DF14A06BB4A03C4098DD267E5AAA54C03085F4C039A13C40CC39D228C3AA54C0004D4A16B7A23C4040BB267E0EAB54C0B8FBF3C009A33C40745AD128F5AA54C0A80EF5C069A33C405DB0D128F3A954C0B0EFF6C011A33C40AF44277EDEA954C098C3491607A23C40F0717CD3E5A954C01098F5C019A13C4001030000000100000004000000F6FF267EA6AB54C0102E4C16DFAA3C40FA4AD22889AB54C00FD09F6B1CA93C402A9FD128CDAB54C0C0914A164FAA3C40F6FF267EA6AB54C0102E4C16DFAA3C40010300000001000000050000004206D228D1AA54C0A0EFF6C011B33C403678277EF0AA54C090C3491687B23C40AE44277E1EAB54C050F54816BFB23C403878277E10AB54C0271B4B16FFB33C404206D228D1AA54C0A0EFF6C011B33C4001030000000100000007000000BFAB277E42AD54C0F0B6F3C071B83C40FE4AD22889AD54C0F114A06B34B83C405EFB7CD395AD54C0C07E4916EFB83C40E6E3D12845AD54C060E94B16C7B93C404106D228F1AC54C0CFAAF6C079B93C40D07CD12801AD54C0FFE2A06BFCB83C40BFAB277E42AD54C0F0B6F3C071B83C4001030000000100000012000000924F7CD3B9AB54C078AA9D6BDCBC3C40A6B67CD35DAB54C0E77E49166FBC3C40382D7CD30DAB54C0A0A44B16AFBC3C40C0607CD39FAA54C0778B9F6B04BC3C404406D228B1AA54C0A0469F6BECB83C40FAFF267E06AB54C01898F5C019B73C40AE44277E1EAB54C0609EA06BE4B63C40061C7CD367AB54C04072F3C0D9B63C40D6C77CD3A3AB54C0C8FBF3C089B73C40D6C77CD3A3AB54C0C8FBF3C089B83C4018837CD38BAC54C05FF54816BFB93C40F84AD22889AC54C028D09F6B9CBA3C4000D97CD349AC54C0E0E8F2C0A9BA3C400867277E0AAC54C048084A169FBA3C40CE7CD128E1AB54C03F9EA06BE4BA3C409E28D2281DAC54C0EF019F6B54BB3C4076A57CD317AC54C038BD9E6B3CBC3C40924F7CD3B9AB54C078AA9D6BDCBC3C40010300000001000000060000006689277E76A954C097EFF6C011C03C40B044277E9EAA54C050084A161FBF3C40FAFF267EC6AA54C0A12DF3C041C03C40B4D2D1283FAA54C00FE3A06BFCC03C40DC0A7CD3C1A954C0E86B48168FC03C406689277E76A954C097EFF6C011C03C400103000000010000000E000000FB4AD228A9AB54C098789E6BA4C23C405622277E52AC54C057084A169FC23C40DC0A7CD3A1AC54C0D07E4916EFC23C404E947CD391AC54C0D827A16B94C33C405EFB7CD355AC54C011EF9D6BF4C43C40D2C77CD343AC54C0900EF5C0E9C53C40C2AB277E82AC54C0B0659D6BC4C63C40E4E3D128A5AC54C09F659D6B44C83C40924F7CD379AC54C04F084A169FC93C40FFD87CD309AC54C0C8659D6BC4C93C40D2C77CD383AB54C0282E4C16DFC83C409EDD267E1AAB54C0E87E4916EFC63C40BE607CD31FAB54C0C0659D6B44C43C40FB4AD228A9AB54C098789E6BA4C23C40010300000001000000050000007AA57CD397AF54C08F59A06BCCC93C40392D7CD3CDAF54C0F7AAF6C079C93C40A6B67CD3BDAF54C09F659D6B44CA3C40E4E3D12885AF54C0AFDCF5C0B1CA3C407AA57CD397AF54C08F59A06BCCC93C400103000000010000000B000000AB44277E5EAD54C0D8E8F2C029D23C402A9FD1282DAD54C0876CA16BACD13C40B4D2D1285FAD54C097789E6B24D13C400A1C7CD3A7AD54C010EF9D6B74D13C4076A57CD3D7AD54C0203A4916D7D13C406C17D22817AE54C060E94B16C7D13C40C2AB277EA2AE54C0C0659D6BC4D03C40D6C77CD3C3AE54C0CFAAF6C079D13C40AE44277E7EAE54C0EF019F6B54D23C404A947CD3F1AD54C0FF4C4A16B7D23C40AB44277E5EAD54C0D8E8F2C029D23C40010300000001000000050000006489277E96AE54C0E814A06B34DB3C404406D22891AE54C0C0339E6B8CDA3C40A128D228DDAE54C0C8B0481627DB3C40E6E3D128C5AE54C037EF9D6B74DC3C406489277E96AE54C0E814A06B34DB3C400103000000010000000C000000061C7CD347AD54C07F40F4C021DF3C4098DD267EBAAD54C0C87E49166FDD3C40C839D228C3AD54C0F0E2A06BFCDD3C40382D7CD3EDAD54C080C3491687DE3C4030EA7CD32FAE54C0F85F4B1697DD3C4001D97CD329AE54C0B0659D6BC4DE3C40725AD128F5AD54C0878B9F6B04DF3C406ACC267EB4AD54C0B0914A16CFDE3C40F2717CD3A5AD54C028D09F6B1CDF3C403678277ED0AD54C070F54816BFDF3C402611277E8CAD54C0679EA06BE4DF3C40061C7CD347AD54C07F40F4C021DF3C400103000000010000000B0000008033277E98AA54C0B0A44B16AFDE3C40C8EE267EA0AA54C0A0789E6B24DE3C40E6E3D128E5AA54C0C8FBF3C009DE3C40AAF97BD37BAB54C0BF914A164FDE3C40DA55277E44AC54C057E94B16C7DD3C402011277E4CAC54C050BD9E6BBCDE3C40CE39D228E3AB54C04F084A169FDF3C409ADD267E7AAB54C048274816F7DF3C402C9FD1282DAB54C028EF9D6BF4DF3C4097DD267EDAAA54C05727481677DF3C408033277E98AA54C0B0A44B16AFDE3C400103000000010000000E0000003A2D7CD30DA954C0E814A06B34DB3C40663E7CD333A954C07FD64A1667DA3C400867277EAAA954C0D827A16B94DB3C403A78277ED0A954C0102E4C16DFDC3C4004D97CD3C9A954C0A0789E6B24DE3C40D07CD128E1A954C060AA9D6B5CDF3C404206D228D1A954C0D027A16B94E03C404406D22871AA54C0C0DCF5C031E23C402211277E0CAA54C050F54816BFE23C404649D1286FA954C03072F3C0D9E13C403EBB267E2EA954C0808B9F6B04E03C40765AD12835A954C0608B9F6B84DC3C407217D22817A954C0EFB6F3C0F1DB3C403A2D7CD30DA954C0E814A06B34DB3C400103000000010000000C000000FC4AD22829AB54C098EFF6C091E53C403678277EF0AA54C0FFB6F3C0F1E43C407E33277EB8AA54C068E94B16C7E43C40061C7CD3A7AA54C0982DF3C041E43C40C6AB277EE2AA54C090A44B16AFE33C40705AD12855AB54C041084A161FE43C40D90A7CD3C1AB54C09FB0481627E53C40745AD128F5AB54C0DF5F4B1617E53C40765AD12815AC54C010E3A06B7CE53C409EDD267EDAAB54C0688B9F6B04E63C40A26BD1287BAB54C0E76B48160FE63C40FC4AD22829AB54C098EFF6C091E53C40010300000001000000090000004C947CD3D1B354C0B8659D6B44183D40A028D2283DB454C08821F6C0C9173D4077A57CD377B454C030BD9E6BBC183D409CDD267E5AB454C0B027A16B941A3D40C0AB277E02B454C03085F4C0391B3D406889277EB6B354C0F014A06B341B3D400A67277E6AB354C0A8C34916871A3D402211277E6CB354C07821F6C049193D404C947CD3D1B354C0B8659D6B44183D400103000000010000000A0000009ADD267E5AC254C0CF14A06B34233D405422277E32C354C05F21F6C0C9213D408CC1D128B9C354C070AA9D6BDC223D403EBB267EAEC354C0BF469F6B6C263D4076A57CD337C354C06FAA9D6BDC273D40BE607CD3BFC254C02F85F4C0B9263D404E947CD371C254C06F6CA16B2C253D40AAF97BD31BC254C0E8E8F2C029243D40EF717CD3E5C154C05F21F6C0C9233D409ADD267E5AC254C0CF14A06B34233D4001030000000100000017000000C4AB277E824555C0CF339E6B8CAF3D409ADD267E5A4555C0C7914A16CFAC3D406689277EB64555C0F06B48168FAB3D40D80A7CD3214655C0CF27A16B94A93D40ACF97BD37B4655C040BD9E6B3CA73D40CF7CD128A14655C06FAA9D6BDCA43D40745AD128F54655C0C8914A164FA23D40643E7CD3B34755C0A759A06B4CA23D405522277E124955C0086C48160FA43D40CB7CD128A14955C0F7E2A06BFCA43D40A4B67CD31D4A55C0C827A16B14A73D404406D228914A55C030EF9D6B74A93D40BE607CD3FF4A55C01F85F4C039AB3D400867277EAA4B55C0AFFBF3C089AC3D405422277EF24C55C010029F6B54AE3D40AE44277E9E4D55C0B8914A164FB03D409EDD267EFA4A55C0A00EF5C0E9AE3D401E837CD3CB4955C0B8659D6B44AF3D40944F7CD3D94855C0C0339E6B0CB23D40FAFF267E464755C098789E6B24B13D40362D7CD36D4655C098789E6B24B03D40A8B67CD39D4555C0FF019F6BD4AF3D40C4AB277E824555C0CF339E6B8CAF3D400103000000010000001E0000001C837CD30B3E55C027D09F6B9C9C3D400867277E6A3F55C0776CA16B2C9B3D40F2717CD3254355C01098F5C0199B3D402EEA7CD38F4455C027D09F6B9C9C3D409CDD267E3A4655C0BF27A16B94A03D405622277E324555C059BD9E6BBC9F3D40715AD128754355C0788B9F6B049C3D40E8E3D128054255C0689EA06B649C3D405522277E323F55C017029F6BD49E3D405422277E923155C0DF14A06BB4B53D40A228D2285D3155C03FBD9E6BBCB63D406489277E563155C0589EA06BE4B73D4002D97CD3293155C0A0914A16CFB83D40D07CD128813055C0CF14A06B34B93D40C0607CD3FF2F55C03885F4C0B9B93D407AA57CD3B72F55C0182E4C16DFBA3D40D07CD128812F55C0708B9F6B04BC3D404406D228312F55C0A0FBF3C089BC3D4078A57CD3572E55C05F8B9F6B84BD3D40C0AB277E222D55C0816CA16B2CC23D40725AD128552C55C08FA44B16AFC33D40725AD128552C55C06F21F6C0C9C13D404E947CD3B12C55C0806CA16B2CC13D408CC1D128392D55C01F1B4B167FBF3D40765AD128352D55C038EF9D6B74BE3D40F6FF267EA62E55C0202E4C165FBC3D405622277E723255C0C0339E6B0CB23D405222277ED23855C0C07E49166FA83D40FE4AD228293A55C0E0AAF6C079A43D401C837CD30B3E55C027D09F6B9C9C3D4001030000000100000009000000765AD128F52655C0C0339E6B0CCA3D400E67277E8A2A55C05172F3C059C73D4006D97CD3092A55C010E3A06B7CC93D409C28D2287D2755C0786CA16B2CCE3D409EDD267EFA2555C0DF339E6B8CD13D40924F7CD3592555C0619EA06B64D23D40D2C77CD3E32455C06FAA9D6BDCD13D40F6FF267E862555C07F21F6C0C9CC3D40765AD128F52655C0C0339E6B0CCA3D400103000000010000001D000000B044277E7EA755C0E7AAF6C079693E40F2717CD365A155C02185F4C0B9663E40382D7CD3EDA155C00798F5C099653E40643E7CD393A255C01885F4C039653E4003D97CD349A355C0C827A16B94653E40AC44277EFEA355C0A0A44B16AF663E40DC0A7CD301A455C0E014A06BB4663E40EAE3D12805A455C02185F4C0B9663E40D4C77CD303A455C0E014A06BB4663E40DC0A7CD301A455C0BFDCF5C0B1663E40BC607CD3FFA355C0A0A44B16AF663E407AA57CD3B7B955C0D043F6C0155D3E402FEA7CD36FCF55C000E3A06B7C533E40924F7CD3F9D255C0AF27A16B14553E4040BB267ECED155C0F86B48168F563E40A6B67CD39DCC55C0EFE2A06BFC563E404C947CD331C555C08059A06B4C5B3E40705AD12875C155C0609EA06BE45F3E40FE4AD228E9BC55C02885F4C0B95F3E405CFB7CD355BB55C0D0AAF6C079613E40D6C77CD3C3BA55C08F59A06B4C623E40CF7CD12801B955C09F789E6BA4643E40E7E3D12805B855C050084A161F653E4060FB7CD335B555C0A0659D6BC4643E406489277E56AE55C0301B4B16FF673E406589277ED6AC55C01085F4C0396A3E40F4FF267E66AC55C0E7AAF6C079683E404506D22831AA55C01FEF9D6B746A3E40B044277E7EA755C0E7AAF6C079693E40010300000001000000510600005E3DC819E93A55C02F79641195C23E401CB760B30C3855C070632EDE19B83E4076B9C7197D3755C0582B31DE69B83E400CFFC719753555C070FF2CDEF1B73E4024D6FA4C0C3555C0E0479344D8B73E4030732E80DB3355C0D96231DE91B73E40B24061B3EC3155C0F0D762111DB73E4040BB93E64D2F55C0C81FCC777BB63E405C7D2D800B2C55C0DFCCFAAAB6B53E4020C2C719312855C020946111CDB43E402CDFFA4CCC2355C0387A9544C0B33E4006662D80E71E55C0AFC6964498B23E40E291FA4C901955C087BAC87753B13E40BE17C719D31355C091979644F8AF3E40805994E6BB0D55C06063954488AE3E40CCCA61B3560755C089FAC87703AD3E40822094E6AF0055C05003FCAA6EAB3E401C8DC719D5F954C0C81E6411CDA93E4060E3C719D1F254C027F8601125A83E400E792D80B1EB54C02785C87773A63E4034362E8081E454C00F8F6111BDA43E40CA40FB4C4EDD54C0187B934408A33E40629BC71923D654C0E043C97753A13E40028A2D800DCF54C007956211A59F3E40FA3EC71919C854C0472DFCAAFE9D3E40D69E60B352C154C0D8ADCB77639C3E40E8DB93E6C5BA54C0DF20FBAAD69A3E40FED12D807FB454C0211D964458993E40342D94E68BAE54C010309544F0973E4011F9FA4CF8A854C0895463119D963E4062082E80CFA354C07830CB7763953E4086FE93E61D9F54C03088FEAA46943E40304F2E80F19A54C0CF3D964448933E408C9D61B3549754C070B6F9AA6E923E409E2DC819559454C0BFEC9344B8913E404643FA4CFE9154C05FAA2BDE29913E40A27F2D80598F54C03F985F118D903E408AB0FA4C388F54C0A196FCAA26903E40027894E6378F54C0B7A3FDAA668F3E40F89360B3668F54C0305F9344C08D3E4025CAFA4CAA8F54C0376FC977138C3E4020CCFA4CC68F54C0F00C9744208B3E402DB794E6C98F54C04F3ACB771B8A3E406CFC94E6B58F54C0601A621105893E40A2882E805B8F54C047335F11F5863E40DA01FB4CD88D54C0E8BA954420803E405881FA4C928D54C01FF464117D7E3E40E921C719458D54C0CFC6C777437C3E409AB493E62D8D54C01849FAAA0E7B3E40D15294E6238D54C0B0DCFBAAEE793E40B6C0FA4C2A8D54C0F0B9C97793783E40602895E63B8D54C01814C97733773E40741394E68B8D54C0E8A163117D733E408C3BC719B78D54C06917CB777B703E404C2CFA4CC08D54C0C8D79744006F3E40BE82C719BF8D54C06084C977B36D3E40D29893E6998D54C098C39644686B3E40CAB394E6A38C54C0509E9344F0613E4006372D80478C54C0BF0C9744B85F3E405E4BFB4C088C54C0CFD3FDAACE5E3E40464EFA4CB48B54C018BDFAAA065E3E405C5B60B3408B54C0809E9644805D3E40D29F61B3A28A54C080B7C677535D3E40B20294E6AD8754C040172DDE895E3E401D6361B33E8754C070F05F113D5E3E40246860B30C8654C0EF3DC777F35C3E4088D32E80BB8554C060862DDED95C3E40064A2D80738554C06768C677DB5C3E4098D7C719B18354C0088FC977835E3E40EABFC7195B8354C06029F9AA265F3E4010DD94E61B8354C050682FDE19603E40FA752D80F98254C04F8563111D623E401C8294E6F58254C0F8876211BD633E409E36C819158354C070F6FEAA166B3E403387FA4C0C8354C0DF939644B06C3E4054C794E6E18254C07F6E954408703E4084B52D80978154C01F03FCAA06803E402AF093E6B98054C020C4631105913E403E822D80B38054C088015F11F5933E408004C719C78054C0E060FBAA86963E4023BC60B3E08054C0CFC06111BD973E406E4E61B3288154C077F0CA77B3993E40727BFA4C648254C098C92DDEB99F3E409290C719AF8254C04749FDAA06A23E408094C719E78254C098B6974460A43E40D8C2C619078354C0D05B2FDE69A63E402CE0FA4C168354C0185E641165A93E40DE3C94E6098354C03F2DFEAACEAA3E4001C4C719998254C041FC9444A8B03E407A6894E6838254C0B0992CDE41B23E400051FB4C7C8254C06FA32EDEC9B33E4060A2C719B18254C02FF8FEAA16BA3E409737C719A58254C070EC964498BC3E40F47F2D808B8254C01005FDAAC6BD3E4096512E806B8254C01F486211DDBE3E40683E61B33C8254C0A0F19444D8BF3E40C81BFB4C7C8154C06F9DC67773C23E40542F94E64B8154C080E56211B5C33E40622D94E62F8154C0D05AC77723C53E4018E12D80118154C0EFEE2EDEC9C73E4013DAC719DF8054C038516111BDC83E4044B660B38C8054C07700924410C93E40F18F61B3E27F54C067EA964450C83E40C21A2E805B7F54C0F015FCAA16C83E4016A3C719C97E54C07F12CA777BC83E40037994E6817E54C070EDFEAA46C93E40F9712E804F7E54C00F00C8776BCA3E40A404FB4C387E54C02906F9AAA6CB3E40F03495E6277E54C0FF5B32DE61CD3E4086DEC719297E54C0AF5C2FDEE9CD3E40E0262E800F7E54C0585F2EDE89CF3E40334CC719E17D54C0D76DC8778BD03E40F069C719917D54C00053C97783D13E4019EFFA4C047D54C09877CA7713D23E4038A360B3867C54C060F3954430D23E40236761B3A27B54C020846211FDD13E40105094E63B7B54C0CF1D954418D23E406B6CC719BF7A54C0D0BF30DEF9D13E40429E93E62D7A54C057DB2CDE89D13E406086C7193D7954C0C88FCA777BCF3E406E5894E6BD7854C02890944420CE3E400C222E80DF7754C00F3B63116DCC3E40F61FC819097254C067ED621125C43E404C192E80777154C030AFC8776BC43E40B6AD2E80E17054C0E1212EDE39C43E40B84AC719FD6F54C0B0BE954468C33E40A0D393E6596F54C0A04F2CDED9C13E40804BFA4CF26E54C0171530DE89C03E40D12A94E64D6E54C060922BDE29BF3E40B0AAFA4C5C6D54C09F76FCAAB6BD3E40E223FB4C446A54C0C73530DE79BA3E403439C819956954C0371A954438BA3E40EEEB60B3EA6854C008815F11A5BA3E40FC87FA4C766854C06F5231DE99BA3E408CE0C719976754C020E7F9AAA6B83E403601C719F36654C0801ACB77ABB73E40C42BFA4C4C6454C0511561119DB53E40902B2E80B16354C09F3EFAAAA6B53E40E63E94E69D6154C0E0479344D8B73E40249494E6756054C05735CA77B3B63E40EA9D0876006054C038F0187750B63E40643E7CD3F35F54C0C8914A164FB43E404506D228715E54C08FA44B162FB23E4003D97CD3095E54C0E8AAF6C079B23E40FA4AD228295D54C0BFE8F2C0A9B33E400A1C7CD3A75C54C0D77E4916EFB33E402A9FD1282D5C54C0609EA06B64B33E401E837CD30B5C54C08FA44B162FB23E40DE0A7CD3015C54C018E3A06BFCB03E40081C7CD3C75B54C0E77E49166FB03E403A2D7CD36D5B54C07F8B9F6B84AE3E40362D7CD38D5B54C0616CA16B2CAA3E40E5E3D128055C54C09F659D6B44A33E40DE0A7CD3415C54C0D027A16B948D3E40E5E3D128055C54C0886CA16B2C863E401C837CD30B5D54C0F0019F6BD4883E402EEA7CD38F5D54C0B8469F6B6C8C3E40A5B67CD3BD5D54C037D09F6B1C913E40D6C77CD3C35D54C0778B9F6B04973E40C2AB277EE25D54C0FF97F5C099993E405EFB7CD3355E54C0706CA16B2C9C3E405622277EB25E54C0886CA16B2C9E3E4019837CD34B5F54C0D7AAF6C0F99E3E40B044277EDE5F54C02F084A161F9E3E40C2607CD3FF5F54C0301B4B16FF9B3E40643E7CD3F35F54C03085F4C039963E408EC1D128196054C048BD9E6BBC913E40EAE3D128056054C040084A161F8D3E40FAFF267E865F54C0B8FBF3C089893E404506D228715E54C0C727A16B14883E40E8E3D128655E54C0B027A16B14873E400A1C7CD3A75C54C0D0339E6B0C823E40D0C77CD3435C54C0AFFBF3C009803E408CC1D128D95B54C050084A161F7C3E4000D97CD3895B54C037D09F6B1C7A3E400C67277E2A5B54C02785F4C0B9783E40954F7CD3D95A54C098789E6B24783E4040BB267E8E5A54C03885F4C039773E4099DD267E3A5A54C068AA9D6BDC743E40DA0A7CD3015A54C0F76B48168F713E4099DD267E3A5A54C007029F6B54693E40F0717CD3055A54C0589EA06BE4673E405122277E925954C0C0FBF3C089663E40C0607CD31F5954C018029F6BD4643E401E837CD3EB5854C051AA9D6B5C623E4098DD267E5A5954C0EFE2A06BFC563E40FAFF267E465954C0E87E49166F4C3E4060FB7CD3355754C0102E4C165F303E400A1C7CD3A75654C01085F4C0B92B3E4020B48CA4025554C0C01A2246860D3E40FE4AD228695254C0F097F5C019ED3D40382D7CD3CD5254C0419EA06BE4E43D403EBB267E6E5254C011D09F6B9CE43D4075B52B73E15154C0D06CA0DF48E63D40A0A0DD4C855154C0905270C2CEE33D403C9ACC06665154C0779A17714BE03D40342D7CD30D5154C0A0469F6B6CDA3D40AD44277EBE5054C07721F6C0C9D63D40C2607CD35F5054C01798F5C019CA3D40F6D7BC21025054C078FB7CF403C53D406DECFBCB494F54C07891EFC4BFBC3D4042BB267E6E4E54C0DF14A06BB4B53D40E6C69E17704D54C05FB07AFFA0AA3D40924F7CD3194C54C06121F6C0C99F3D404206D228D14B54C0086C48168F9A3D40F84AD228694B54C05F9EA06BE4953D40660D385AD44854C00F0121224D813D40282FC03E9A4454C0D84A4FA2EF5C3D4012240703674054C0AF99B5A23A3C3D401C547C589C3D54C00824C229ED263D40AE6B88E5A73B54C021D5A2D8E6193D40B0391AFC873A54C058AFB52763163D40D1C77CD3033B54C017E3A06B7C113D405322277E323A54C0D727A16B940E3D405222277E123954C0C0E8F2C0A90B3D40CE7CD128813854C0D027A16B14073D401A837CD32B3854C05F6CA16B2C023D403878AAFF902F54C04034BCA591CE3C40EE717CD3852B54C0086C48168FB73C40DC0A7CD3212854C03F084A169FA63C40643E7CD3532454C08059A06BCC8E3C40D80A7CD3C12254C0C827A16B147E3C4040BB267ECE2154C0F8E2A06BFC783C406689277E962254C020D09F6B9C733C40A028D228BD2354C0C07E4916EF6E3C40643E7CD3532454C0E8339E6B8C6E3C4060FB7CD3752454C0D7E8F2C0296D3C404406D228D12454C0201B4B16FF6A3C401C837CD34B2554C0A8FBF3C009693C404206D228D12554C0686CA16B2C683C40E4E3D128052654C0C7914A16CF663C402CEA7CD30F2654C08721F6C0C94D3C40C4AB277E822654C0F8AAF6C0794A3C40FB4AD228092654C03085F4C0B9483C405622277E322654C030BD9E6B3C433C40F8FF267EE62554C03885F4C039353C402E9FD1288D2454C07F6CA16B2C1B3C40BC607CD39F2354C04F72F3C0D9133C40FC4AD228692354C0B8659D6BC40F3C4048947CD3112254C0C7914A16CF043C401B837CD3EB1C54C0AF914A16CFE83B40ACF97BD3DB1C54C06021F6C0C9DD3B40FAFF267E661E54C09F469F6B6CE83B409ADD267E9A1E54C0C8914A16CFEA3B40B244277EDE1E54C00FD09F6B9CEC3B4002D97CD3C92054C07F8B9F6B84F43B40DE0A7CD3612154C000E3A06B7CFD3B40FA4AD228292554C0102E4C16DF153C40725AD128152754C00F85F4C0392A3C402E9FD128AD2754C008E3A06BFC343C401A837CD38B2754C010D09F6B1C613C40C1607CD39F2554C0F0AAF6C079813C405422277E922554C020D09F6B9C8B3C40FB4AD228092654C07021F6C0C9953C40289FD1286D2654C0706CA16BAC993C40CC7CD128012754C0F814A06B349C3C40BE607CD3DF2754C010029F6B549D3C40DC0A7CD3212954C0DF7E4916EF9C3C408CC1D128592954C07821F6C0499D3C40041C7CD3A72954C0606CA16B2C9E3C40F5FF267E062A54C0880EF5C0E99E3C404206D228712A54C04072F3C0D99E3C40A8F97BD37B2A54C0A00EF5C0E99D3C40FAFF267E662A54C0F714A06B349A3C404206D228712A54C06021F6C049993C40603E7CD3332B54C0F0AAF6C079983C40EE717CD3C52B54C0182E4C165F983C40ACF97BD3DB2F54C068AA9D6BDC9A3C40E6E3D128053154C068F54816BF9C3C40FA4AD228E93154C0AF469F6B6CA03C404606D228313254C0C8659D6B44A43C404606D228313254C07F21F6C049A93C4048947CD3F13154C0A0659D6B44AE3C408EC1D128793154C0A00EF5C0E9B13C40C0607CD3FF3054C09F914A164FB03C40725AD128753054C0606CA16B2CB43C40623E7CD3F32F54C00F2E4C165FB93C40FAFF267E263054C0D87E4916EFBD3C40F0717CD3E53254C0E17E49166FC13C402A9FD1280D3554C030EF9D6B74C83C40071C7CD3473654C0589EA06B64CA3C40B244277E3E3554C0BFFBF3C009B33C40081C7CD3873454C0F0019F6BD4AC3C40081C7CD3873454C0B0469F6BECAA3C40DA0A7CD3013554C000029F6B54A93C4004D97CD3093354C01085F4C0B99B3C40FC4AD228C93254C058F54816BF963C4004D97CD3893254C050F548163F8C3C40061C7CD3073154C0E8AAF6C079733C4032EA7CD36F3054C09059A06B4C6E3C40C0607CD33F2F54C038D09F6B9C5F3C40A028D2285D2D54C0A0FBF3C009523C40D07CD128E12C54C0E77E4916EF4B3C40D7C3267EA12254C02785F4C039FB3B40DA0A7CD3611854C0808B9F6B84AA3B409DDD267E1A1654C038BD9E6BBC833B40F84AD228A90C54C0886CA16B2C323B40AAF97BD39B0C54C0D014A06B342E3B4018837CD32B0D54C07F21F6C049333B40ED717CD3E50D54C038D09F6B9C353B406A89277E761054C028EF9D6BF4373B40EAE3D128E51154C01098F5C0993A3B405CFB7CD3551254C04872F3C0D93B3B40AEF97BD3BB1254C0A0914A164F3D3B40D4C77CD3431354C09859A06B4C3E3B40A8B67CD31D1454C00098F5C0193E3B409E28D228BD1354C007E3A06BFC3B3B40A228D2281D1254C0E714A06B34353B40FA4AD228A91154C0EF14A06BB4343B40F4FF267EA61054C0C0469F6B6C323B409CDD267E1A1054C0F814A06BB4313B40061C7CD3A70E54C0A059A06B4C333B40FE4AD228290E54C038D09F6B9C333B40AEF97BD3BB0B54C09F469F6BEC293B40643E7CD3530B54C0B027A16B94263B40F0717CD3850954C0589EA06B64233B409E28D2281D0954C09F659D6B441F3B4004D97CD3E90854C0E06B48168F1B3B40A8B67CD35D0754C0EF019F6B54103B40342D7CD30D0654C0201B4B167F023B405EFB7CD3D50454C08F789E6B24F93A40B044277EBE0454C038D09F6B1CF63A40623E7CD3330554C0B8914A164FF33A40AAF97BD3DB0554C0301B4B167FF23A40A8B67CD39D0654C0B7A44B162FF23A40A8B67CD35D0754C01F2E4C16DFF03A40A8B67CD35D0754C05F21F6C049EF3A403A2D7CD38D0654C028EF9D6BF4ED3A40D4C77CD3230554C0C07E49166FEC3A40F6FF267E860454C070F54816BFEA3A40A6B67CD31D0454C010D09F6B1CE83A405422277E720254C0D8E8F2C0A9CF3A40745AD128750254C09F659D6BC4C83A4042BB267E6E0354C0608B9F6B04C53A4042BB267E6E0354C038D09F6B1CC33A4077A57CD3970254C0BF27A16B14BF3A405CFB7CD3350254C030084A161FB73A405222277E120254C050AA9D6B5C963A402EEA7CD36F0254C0FFE2A06BFC8E3A4042BB267E6E0354C06F8B9F6B848E3A408AC1D128F90354C070F54816BF6B3A40944F7CD3990454C02FEF9D6BF4633A40B044277EBE0454C057084A161F603A4040BB267EAE0454C07F59A06B4C573A40362D7CD3CD0454C0481B4B16FF523A40382D7CD32D0554C0C0659D6B444F3A4088C1D128F90454C048084A169F493A404A947CD3910654C0EF019F6BD4233A40289FD1282D0754C0D014A06B341C3A40A4B67CD33D0854C050F548163F193A40A4B67CD33D0854C03072F3C059173A4076A57CD3370754C02F084A169F113A40A4B67CD33D0854C0EFAAF6C079C639402C9FD128AD0854C0EFAAF6C079C639402C9FD128AD0854C018D09F6B1CD13940A4B67CD33D0854C0D014A06BB4DC3940F2717CD3450854C08F59A06B4CE33940944F7CD3790854C02085F4C0B9E63940C2607CD3FF0854C028D09F6B9CE639402E9FD1284D0B54C050F54816BFDB394048947CD3B10B54C020EF9D6B74D23940C6AB277E820C54C040BD9E6BBCCB39403CBB267E8E0C54C0D0AAF6C0F9C03940ACF97BD37B0D54C0A0789E6B24BC3940FE4AD228290E54C0E0E8F2C029BB39400A1C7CD3C70E54C0A7A44B162FBB3940061C7CD3670F54C0B0659D6BC4BA39409CDD267E1A1054C0E8AAF6C079B83940765AD128551054C0AFFBF3C009B639404206D228711054C000029F6BD4AF3940D5C77CD3C31154C0B0469F6BECA43940D1C77CD3A31354C0C0659D6B449E3940A8B67CD3DD1354C0EF019F6B549939402E9FD128ED1354C070F54816BF8C39404206D228511454C0BF469F6B6C883940BE607CD35F1554C0D8339E6B0C8339400C67277EEA1554C0102E4C165F7E3940F84AD228091654C0E8E8F2C0A9793940603E7CD3D31554C0E0E8F2C029743940FA4AD228891554C070F54816BF72394060FB7CD3151554C0606CA16BAC71394078A57CD3D71454C0A059A06B4C703940ADF97BD35B1554C078F54816BF6C3940603E7CD3D31554C09F469F6BEC67394040BB267E4E1554C0409EA06BE4653940DA0A7CD3811454C050BD9E6B3C64394002D97CD3091454C05F6CA16B2C623940A8B67CD31D1454C0808B9F6B045F39405222277E721654C038D09F6B9C57394062FB7CD3551954C030084A169F4B3940D1C77CD3A31954C0D014A06BB4493940C4AB277EC21954C0708B9F6B844739409CDD267EFA1954C0C0E8F2C0294539405222277E121B54C038D09F6B9C403940EE717CD3251B54C0B8914A16CF3D39405022277E521B54C0A0659D6BC43839401A837CD38B1A54C038EF9D6BF4343940944F7CD3B91954C0E06B48160F323940C4AB277EC21954C0706CA16BAC2F39408CC1D128B91A54C0C8FBF3C089323940924F7CD3F91B54C090A44B162F393940ACF97BD3DB1C54C0C8914A164F3A3940944F7CD3D91C54C0E714A06B343E3940944F7CD3D91D54C04F9EA06BE43D3940AAB67CD31D1F54C058BD9E6BBC3B3940FFD87CD3E91F54C0A80EF5C069383940EE717CD3851E54C02FEF9D6BF4373940ACF97BD35B1D54C0E0339E6B8C3539405EFB7CD3951C54C0F06B48168F313940CD7CD128611C54C018029F6B542C3940ACF97BD3DB1C54C018029F6B542C39403EBB267E0E1D54C000E3A06BFC313940F6FF267E061E54C0B0659D6B443539400B67277E4A1F54C04072F3C0D9353940E8E3D128652054C0F8019F6B5433394078A57CD3972054C0C0339E6B0C353940C0607CD3DF2054C0F0E2A06B7C3639409CDD267E3A2154C00898F5C09937394004D97CD3A92154C0A80EF5C0693839403EBB267E6E2154C0EF6B48160F3A3940CC7CD128412154C0B827A16B143B39405EFB7CD3F52054C0C0E8F2C0A93B3940E8E3D128652054C0F06B48160F3C3940765AD128752054C0E8E8F2C0293D3940FA4AD228892054C04F9EA06BE43D394002D97CD3C92054C0DF6B48168F3F3940A6B67CD39D2154C010D09F6B1C3F39404206D228312454C0D8AAF6C0F93E3940FA4AD228292554C0B8914A16CF3D394004D97CD3C92554C0A0A44B16AF3939409D28D2283D2654C0D827A16B143439404106D228D12654C08059A06B4C3039405022277ED22754C0AF27A16B94313940B044277E9E2754C038D09F6B1C323940F2717CD3852754C0E06B48160F323940745AD128752754C0B0A44B162F32394078A57CD3572754C0F8019F6B5433394032EA7CD3AF2954C0B0469F6B6C3139401E837CD30B2A54C02F084A169F3039400A67277EEA2954C03885F4C0392E3940623E7CD3B32954C0D0339E6B8C2C394004D97CD3A92954C0D0AAF6C0F92A39401E837CD30B2A54C0F0019F6BD42839404206D228712A54C0F0019F6BD4283940F8FF267E662B54C0D0AAF6C0F92A3940ACF97BD33B2C54C0D0E8F2C0A9293940BC607CD37F2D54C0A7A44B162F253940F7FF267E462E54C080789E6BA42439408CC1D128592F54C0B8914A16CF243940BB607CD35F3054C0AF27A16B14263940C0607CD3FF3054C0F0019F6BD4283940D2C77CD3233154C09059A06BCC273940F6FF267E463154C00FD09F6B1C273940D2C77CD3633154C060AA9D6B5C2639408EC1D128793154C0A7A44B162F253940061C7CD3C73154C010EF9D6BF4253940A9F97BD31B3254C0E06B48168F2639405522277E723254C0800EF5C069273940FC4AD228C93254C0F0019F6BD4283940C4AB277E023354C050BD9E6BBC26394076A57CD3373354C0F8E2A06BFC253940FA4AD228893354C0886CA16B2C26394088C1D128193454C0D07E4916EF26394088C1D128193454C0F0019F6BD4283940C0607CD3DF3354C028EF9D6BF42A3940F8FF267EC63554C0409EA06B642C394078A57CD3B73654C0706CA16BAC2F3940CE7CD128813854C0409EA06B642B3940041C7CD3C73854C00898F5C0192B3940CC7CD128413A54C0A7A44B162F2539404406D228713B54C0609EA06B64243940F0717CD3E53D54C030BD9E6B3C2439408BC1D128F93F54C0C027A16B94223940352D7CD38D4254C0B8A44B16AF21394004D97CD3894554C0CF27A16B141F3940FAFF267E864654C0C07E4916EF1F39401E837CD38B4954C0A0469F6B6C2A394073A57CD3974A54C0481B4B167F32394062FB7CD3554B54C0C8914A164F3A3940BE607CD33F4B54C0C0914A164F4239402C9FD1288D4A54C0B8914A164F4C3940AF44277E7E4954C06021F6C0C95439404606D228514854C0A8A44B162F58394062FB7CD3B54854C0A7FBF3C0895439402CEA7CD3EF4754C030EF9D6BF45339402C9FD1282D4754C030D09F6B1C523940F2717CD3854654C08859A06BCC4F39406789277E164654C0E014A06BB44D3940ADF97BD3FB4454C03072F3C0D9453940061C7CD3C74454C050F54816BF453940603E7CD3F34354C090789E6BA443394042BB267E0E3F54C0F06B48160F3C394042BB267E0E3F54C0C8914A164F3A394000D97CD3693F54C0589EA06BE4393940DA0A7CD3014054C05872F3C0D9383940B044277E5E4054C0A80EF5C069383940B044277E5E4054C018029F6BD4363940ACF97BD33B3F54C04F084A161F35394074A57CD3D73D54C038EF9D6BF4343940725AD128753C54C03072F3C05936394078A57CD3573B54C050AA9D6B5C393940643E7CD3B33A54C0900EF5C0E93E3940E5E3D128253B54C0F8AAF6C079433940E4E3D128C53E54C0F0E2A06B7C5139404C947CD3F13F54C03885F4C0B95339404A947CD3314254C00FD09F6B1C5539403DBB267E4E4354C038D09F6B9C5739400A67277EAA4354C0A8A44B162F5839406789277E164654C0CF7E4916EF5939401E837CD30B4954C0301B4B167F6239401E837CD38B4954C03085F4C039653940BC607CD39F4954C09F469F6BEC6739405222277EF24954C0D014A06B346D3940EE717CD3054A54C0F014A06BB46F394030EA7CD3EF4A54C0F06B48168F793940EAE3D128054D54C0D8339E6B0C823940A228D228BD4D54C0F06B48160F8739400A67277E8A4C54C00FEF9D6BF4893940071C7CD3274C54C038D09F6B9C8B3940F84AD228E94B54C02FD09F6B9C8D3940C4AB277E024C54C0800EF5C0698F3940BF607CD39F4C54C030EF9D6B74903940705AD128154E54C07F6CA16B2C8F3940663E7CD3D34E54C06021F6C0499039404506D228114F54C00F85F4C0B9923940A8B67CD3BD4F54C0C0659D6B449E39404B947CD3115154C048084A161FA73940342D7CD30D5154C0D0E8F2C0A9AA3940725AD128955154C01085F4C0B9AC39404A947CD3D15154C010D09F6B9CAF3940D2C77CD3E35154C0C8659D6B44B439400A67277E0A5454C06021F6C0C9B439406689277E965454C090789E6B24B53940D2C77CD3035554C0C8914A164FB73940F5FF267EC65554C0806CA16B2CBE39402EEA7CD30F5654C04F084A169FBF3940A228D228DD5654C0679EA06BE4C03940E6E3D128455654C04FF54816BFC339406689277E965454C0102E4C165FC83940663E7CD3135554C050AA9D6B5CCA39402E9FD1284D5654C018D09F6B1CD139404206D228D15754C0E7339E6B0CD6394098DD267E5A5954C0808B9F6B04DA3940342D7CD32D5A54C02085F4C039DB3940362D7CD30D5C54C0301B4B167FDC3940944F7CD3D95C54C0E8E8F2C0A9DD3940643E7CD3935D54C0202E4C16DFDF394000D97CD3695E54C01098F5C019E43940623E7CD3135F54C057F548163FE639401E837CD3EB5F54C0201B4B16FFE23940AEF97BD39B6054C0C0339E6B0CE439408CC1D128596154C0806CA16BACE63940FA4AD228A96254C0A0A44B16AFE8394003D97CD3896354C0F097F5C019EB3940924F7CD3196454C080789E6BA4EB3940A8B67CD35D6454C0706CA16B2CEB3940A028D2281D6554C0B8469F6BECE83940DE0A7CD3A16554C0D0E8F2C029E83940A028D2285D6554C0B727A16B14EA3940C0607CD35F6554C010029F6BD4EA3940D4C77CD3836554C0E0AAF6C079EB3940DE0A7CD3A16554C0B027A16B14ED39401D837CD32B6654C000E3A06B7CEC3940BE607CD3DF6654C0A00EF5C069ED3940D2C77CD3836754C0201B4B167FEF39409CDD267EDA6754C0F8AAF6C079F23940BF607CD37F6854C090789E6BA4F03940A8F97BD3FB6854C030084A161FED39409ADD267E9A6954C080789E6BA4EB3940E8E3D128656A54C0F06B48160FEB3940081C7CD3276B54C01F1B4B167FEB39401A837CD3CB6B54C010029F6BD4EC3940944F7CD3396C54C0F0E2A06BFCEE39404B947CD3716C54C0C0339E6B8CED394004D97CD3A96C54C080789E6BA4EB394048947CD3D16C54C030084A161FEB39401C837CD32B6D54C0B8469F6BECE93940D5C77CD3236D54C0D0E8F2C029E83940F84AD228896D54C0D0E8F2C029E83940AAF97BD3FB6D54C0E8AAF6C079E839408AC1D128396E54C0EFAAF6C0F9E839408CC1D128D96E54C080789E6BA4EB394075A57CD3176F54C0D8E8F2C0A9ED3940EE717CD3856F54C020D09F6B1CF53940CB7CD128A16E54C02FEF9D6B74F63940A6B67CD3DD6D54C00F85F4C0B9F4394004D97CD3296D54C00898F5C019F239404B947CD3716C54C050BD9E6BBCF0394078A57CD3D76B54C0C8469F6BECF13940944F7CD3396B54C08F59A06BCCF439409E28D228BD6A54C078F548163FF83940E4E3D128856A54C03085F4C039FB394076A57CD3776B54C03872F3C059FB39402C9FD128ED6C54C0A7A44B16AFFA3940F84AD228896D54C03085F4C039FB3940A028D2283D6E54C0EF14A06B34FD3940643E7CD3D36E54C0D0E8F2C029003A40C0607CD3FF6E54C0BF659D6B44033A405222277E726E54C0F014A06BB4053A40061C7CD3477054C0B0659D6BC40A3A40FC4AD228497154C05072F3C059113A40DE0A7CD3617254C050BD9E6BBC233A40061C7CD3A77254C000029F6B54213A401A837CD3CB7254C0B0659D6BC41E3A40603E7CD3D37254C0F06B48160F1C3A400A1C7CD3C77254C050F548163F193A40DA0A7CD3417354C050F548163F193A400C67277E6A7454C0F097F5C0992B3A406889277EF67454C0D014A06BB43F3A404606D228917454C0D07E49166F483A404E947CD3917454C090789E6B244A3A40A6B67CD39D7454C0F7AAF6C0F94A3A40D6C77CD3837654C0D8339E6B8C573A40CE7CD128C17654C007029F6BD45B3A404406D228517654C007029F6BD45B3A404406D228517654C0C027A16B145A3A40D17CD128E17554C0C027A16B145A3A40DE0A7CD3017654C0B0FBF3C0096A3A404406D228517654C0E0339E6B0C6F3A40061C7CD3C77654C0A00EF5C0E9723A403A2D7CD30D7854C02FEF9D6BF47A3A40BC607CD37F7854C0D77E4916EF7E3A40944F7CD3797854C0B0A44B162F7B3A408CC1D128397854C0A859A06BCC743A40BC607CD37F7854C0CF339E6B8C723A4002D97CD3C97854C050AA9D6BDC713A4074A57CD3377954C0F06B48168F723A40D2C77CD3837954C030BD9E6BBC733A402FEA7CD3CF7954C018EF9D6B74743A40AC44277E1E7B54C018EF9D6B74743A40A8B67CD39D7E54C0E87E49166F7B3A405CFB7CD3757F54C05FAA9D6BDC793A40FC4AD228A97F54C0786CA16B2C7A3A40DA0A7CD3018054C0E87E49166F7B3A40031C7CD3678054C0E8339E6B8C793A40362D7CD38D8054C0B8FBF3C0097C3A404606D228918054C010029F6BD47F3A40E4E3D128658054C01898F5C099833A40DA0A7CD3018054C0CF7E4916EF853A40AAB67CD3BD7F54C0EF019F6BD4853A402FEA7CD34F7F54C0301B4B16FF823A4098DD267EDA7E54C08021F6C049823A40A8B67CD35D7E54C05F6CA16BAC823A40725AD128157E54C057084A169F833A4042BB267ECE7D54C0F7019F6BD4843A402EEA7CD30F7C54C0C827A16B14893A409BDD267E5A7A54C0608B9F6B048F3A40051C7CD3277954C0D8339E6B0C963A4003D97CD3697954C000E3A06B7C9C3A402E9FD128AD7854C07021F6C0C99F3A40D17CD128E17554C0C0659D6BC4A93A40D4C77CD3A37554C090789E6B24AC3A404406D228117554C0E87E49166FAE3A40944F7CD3597454C0D0AAF6C079AF3A404C947CD3B17354C08F789E6B24AE3A402A9FD1280D7354C0A0914A16CFAF3A404206D228917254C0B8A44B16AFB13A405EFB7CD3357254C010E3A06BFCB33A404C947CD3F17154C0C8FBF3C009B73A40F6FF267EE67254C0B0A44B16AFB53A403A2D7CD36D7454C0E07E49166FB23A40D4C77CD3A37554C08059A06BCCB13A4048947CD3B17654C030BD9E6B3CB03A40362D7CD3ED7754C0006C48168FAC3A40081C7CD3077A54C0708B9F6B84A43A40924F7CD3B97A54C0A0469F6B6CA03A40081C7CD3A77C54C0708B9F6B848C3A40FA4AD228E97C54C0806CA16B2C8B3A40289FD1286D7D54C0E014A06B348A3A402E9FD128ED7E54C090789E6BA4883A40081C7CD3877F54C0788B9F6B84873A40081C7CD3877F54C0806CA16B2C8B3A404606D228D18054C0E014A06B34893A40715AD128B58154C07F6CA16B2C873A40BE607CD37F8254C0A0789E6B24873A40CE7CD128818354C0806CA16B2C8B3A4004D97CD3098454C010D09F6B9C8F3A4018837CD3EB8354C0A059A06BCC923A407AA57CD3978354C0401B4B167F963A40CE7CD128818354C000E3A06B7C9C3A404A947CD3D18354C0A0789E6B24A13A404C947CD3F18454C04FBD9E6B3CAA3A40CC7CD128418554C08F789E6B24AE3A40643E7CD3338554C0509EA06BE4B33A40D2C77CD3A38354C090789E6BA4D13A40CE7CD128818354C070AA9D6B5CD73A40F7FF267EA68354C0A0789E6BA4DD3A40D80A7CD3218454C018E3A06BFCDF3A40BC607CD3FF8454C0006C48168FE13A40372D7CD34D8654C0608B9F6B84E53A40745AD128358654C09859A06BCCE83A405EFB7CD3F58454C0A0659D6B44EC3A40CFC77CD3C38154C040084A161FF33A40A6B67CD35D8054C0606CA16B2CF43A40E8E3D128C57F54C0B8914A164FF53A4004D97CD3697F54C0B0A44B162FF73A40A8B67CD39D7E54C0708B9F6B04FF3A402EEA7CD3AF7F54C010029F6BD4FD3A40653E7CD3138154C0D027A16B14F93A40289FD128AD8354C04F084A161FF73A40F2717CD3C58454C0F0E2A06B7CF53A403CBB267EEE8554C0A0789E6BA4F43A40EC717CD3658754C038D09F6B1CF63A402A9FD128AD8754C0A0FBF3C009F23A405222277E728854C020D09F6B1CF13A40BE607CD33F8954C050F54816BFF03A40B244277E9E8954C018029F6B54EE3A403DBB267EEE8954C0F8AAF6C079ED3A40D07CD128A18A54C0CFE8F2C0A9EF3A40372D7CD3CD8B54C0888B9F6B84F43A404106D228918B54C0A0469F6BECF83A4089C1D128398C54C0D0E8F2C029F83A40F0717CD3458D54C03085F4C039F63A4098DD267E3A8E54C0D027A16B14F73A409E28D2287D8F54C05072F3C0D9FE3A405EFB7CD3359054C070F54816BF013B40FAFF267E869154C00898F5C019043B406889277E569154C0D0AAF6C0F9013B4062FB7CD3959054C050F548163FFD3A40A7F97BD3BB8E54C038EF9D6BF4F43A40061C7CD3078E54C02F084A169FF23A40352D7CD38D8D54C0888B9F6B84F43A40DC0A7CD3E18C54C0D014A06BB4F13A40A228D228FD8B54C0B0659D6BC4E93A4060FB7CD3958B54C0A0789E6B24E83A40AC44277E3E8B54C0D014A06B34E63A40ACF97BD33B8A54C048BD9E6BBCDC3A40F84AD228A98954C0800EF5C069D13A40AAB67CD39D8954C020D09F6B9CCD3A40E4E3D128058A54C050F548163FCA3A4089C1D128998A54C0D0E8F2C029C93A404206D228D18A54C0800EF5C069D03A40B044277E5E8B54C0DFE8F2C029D33A40362D7CD36D8B54C05FF548163FD23A401A837CD3CB8B54C038EF9D6B74D03A40081C7CD3478C54C038D09F6B9CCE3A40342D7CD3AD8C54C00098F5C099CD3A40AE44277EDE8C54C0B027A16B14CE3A40A028D2287D8D54C0D8E8F2C0A9D03A400E67277ECA8D54C060F548163FD13A40A8B67CD3FD8D54C0CFAAF6C0F9D03A40ACF97BD31B8E54C0FF2D4C165FD03A40FE4AD228498E54C07821F6C0C9CF3A400A67277EAA8E54C0201B4B167FCF3A40A9F97BD31B8F54C0509EA06BE4CF3A406889277EB68F54C0E0339E6B0CD23A4076A57CD3379054C0DFE8F2C029D33A40D07CD128219154C0002E4C165FD43A405222277E929154C0D0E8F2C0A9D43A4004D97CD3299254C02FBD9E6BBCD43A405EFB7CD3159454C0D07E49166FD93A404F22277EF29554C010029F6B54EF3A403EBB267EAE9754C038D09F6B1CF63A40ACF97BD37B9754C0C027A16B14F23A40D80A7CD3A19654C0006C48160FEC3A40725AD128559654C0A0789E6B24E83A409ADD267E1A9754C09059A06BCCE93A401D837CD36B9754C0F014A06BB4EA3A403EBB267EAE9754C04F084A169FEB3A4098DD267E1A9854C01085F4C0B9F03A40ED717CD3E59D54C030084A161F1A3B400A67277E8A9E54C0F714A06B34233B403EBB267E0EA054C018029F6BD42D3B401C837CD36BA054C038D09F6B9C333B40A6B67CD31DA054C03785F4C0B9303B40C4AB277EE29F54C0C0469F6B6C2F3B40289FD1288D9F54C0D014A06B342E3B40289FD1288D9F54C000E3A06B7C323B40D1C77CD3C39F54C0A0789E6B24363B40623E7CD333A054C0C7469F6BEC383B40ACF97BD3DBA054C01098F5C0993A3B40ACF97BD3DBA054C028D09F6B1C373B405EFB7CD355A154C028D09F6B1C373B406489277E16A254C0A8789E6BA43C3B40F0717CD325A354C0A8A44B16AF413B40745AD128F5A354C02085F4C0B9463B405EFB7CD3F5A354C047BD9E6B3C4C3B402EEA7CD3AFA354C060AA9D6B5C4B3B405EFB7CD375A354C070AA9D6BDC4A3B40DC0A7CD341A354C010D09F6B1C4A3B401B837CD30BA354C0C027A16B94483B40AAF97BD39BA254C0C027A16B94483B4040BB267EAEA254C0F0E2A06BFC4E3B40D3C77CD303A454C08021F6C0C9583B406489277EB6A454C0A0789E6B24653B40BE607CD39FA554C0381B4B167F683B40765AD128D5A654C0C8659D6BC46A3B4042BB267E4EA954C0509EA06B64713B404C947CD3B1AB54C0082E4C16DF723B405222277EB2AC54C0D07E49166F743B40382D7CD36DAD54C0D0E8F2C029783B400A67277EAAAE54C0C8659D6BC4833B40DA0A7CD3E1AE54C007029F6BD4873B4048947CD371AE54C007029F6BD4873B4088C1D12879AD54C060AA9D6B5C7F3B40C4AB277E22AD54C0FF019F6B547D3B407AA57CD377AC54C040084A169F7B3B40FAFF267EC6AA54C040BD9E6BBC783B40623E7CD313AA54C0B0A44B162F763B40AAF97BD39BA954C0F8AAF6C0F9773B402CEA7CD34FA954C0708B9F6B047A3B404E947CD331A954C04872F3C0597C3B40A5B67CD33DA954C0D07E4916EF7E3B40D1C77CD3A3A954C0D07E4916EF7E3B4077A57CD317AA54C010029F6BD47D3B40382D7CD38DAA54C0086C48160F7E3B40B244277EFEAA54C0E714A06B347F3B40C6AB277E62AB54C0F0019F6BD4803B4001D97CD349AA54C0DF14A06B34853B408EC1D128B9A854C0F86B48168F833B405422277E12A754C0A0FBF3C089803B40735AD128B5A554C0F0019F6BD4803B40A6B67CD35DA654C050AA9D6BDC823B404406D22811A754C0409EA06B64843B4074A57CD3D7A754C030EF9D6B74853B40D6C77CD3C3A854C0C027A16B14863B40E6E3D128C5A754C008E3A06BFC873B40D4C77CD3E3A554C04072F3C0D9893B40081C7CD307A554C038D09F6B1C8C3B40C5AB277EA2A454C050BD9E6B3C8F3B40E6E3D128A5A554C09F789E6BA48E3B406A89277E76A654C0900EF5C0698D3B4013F5D128ABA654C0D727A16B148D3B40944F7CD3D9A754C0B8914A164F8B3B4006D97CD389A754C010EF9D6B748D3B40AB44277E5EA754C07021F6C0498E3B40BC607CD31FA754C0B8FBF3C0098E3B40D0C77CD3C3A654C0C7FBF3C0898D3B40AE44277E9EA654C0E8339E6B8C8D3B40924F7CD379A654C09F59A06BCC8D3B40735AD128B5A554C0FF6B48168F903B40CE7CD128E1A554C0401B4B167F913B40E4E3D12825A654C0589EA06BE4933B40F2717CD3C5A454C02885F4C039973B40C0AB277E22A454C0689EA06BE49B3B402E9FD128ADA354C0B8A44B162FA13B40623E7CD3D3A254C0900EF5C069A63B404406D22811A154C0401B4B167FAB3B40ACF97BD3DBA054C008E3A06B7CAD3B40F2717CD3A5A054C000E3A06B7CB03B40D4C77CD323A054C0B0659D6BC4B13B4040BB267E8E9F54C037EF9D6B74B23B409E28D2281D9F54C0788B9F6B84B33B4098DD267E1A9E54C0CF14A06BB4BA3B402A9FD128CD9D54C0B0469F6B6CBC3B40D6C77CD3039C54C078AA9D6BDCC03B402C9FD1288D9B54C0808B9F6B84C33B40AAF97BD37B9954C07021F6C0C9CB3B40745AD128F59854C090789E6BA4CF3B40DC0A7CD3219954C0888B9F6B84D53B40F2717CD3659A54C08FA44B162FE03B40A8B67CD3FD9A54C0A859A06BCCEA3B40C6AB277EC29B54C060AA9D6BDCED3B40C0607CD3DF9C54C0AF659D6B44EE3B405422277E329E54C017D09F6B9CEB3B40D2C77CD3C39E54C0F86B48168FE83B40081C7CD3079F54C0201B4B167FE43B409E28D2281D9F54C0D027A16B14DB3B40745AD128B59E54C0B0469F6B6CD73B408DC1D128999E54C0C0914A16CFD43B40E6E3D128E59E54C0B8659D6B44D23B401A837CD32BA154C0F897F5C099D23B40AEF97BD3BBA154C080789E6B24D33B40FC4AD22889A254C0DF6B48160FD83B40B144277E9EA254C0A00EF5C069DE3B4060FB7CD335A254C0C8914A16CFEA3B40DA0A7CD3A1A254C03072F3C059F13B40D4C77CD3C3A354C0A0A44B16AFF43B402EEA7CD36FA554C0B8469F6BECF53B40623E7CD373A754C01098F5C019F63B40623E7CD373A754C02F1B4B16FFF73B40E4E3D12825A654C078F54816BFF93B40E4E3D12825A654C0D8E8F2C0A9FB3B400A1C7CD3E7A754C028D09F6B1CFF3B4078A57CD3B7A854C018E3A06B7C013C40A5B67CD33DA954C057BD9E6B3C043C40D1C77CD3A3A954C057BD9E6B3C043C40F74AD228A9A954C0579EA06B64033C40D1C77CD3A3A954C058F54816BF003C408AC1D12839AC54C0A0789E6BA4093C40372D7CD30DAC54C0B0469F6B6C073C40DA0A7CD381AB54C0579EA06B64033C40C6AB277E62AB54C02FD09F6B9C013C406489277E76AB54C01098F5C099FF3B40F94AD228C9AB54C06FF54816BFFC3B404F22277ED2AB54C0D8E8F2C0A9FB3B404A947CD331AC54C058BD9E6BBCF93B4042BB267E2EAC54C0A8FBF3C089F83B409EDD267E9AAB54C02F1B4B16FFF73B40A5B67CD33DA954C02F1B4B16FFF73B4002D97CD309AA54C08059A06BCCF43B40924F7CD3F9AC54C04072F3C0D9F13B40DE0A7CD301AE54C0708B9F6B84ED3B40FA4AD22889AB54C0808B9F6B04EA3B400867277E2AA954C0086C48160FE53B40623E7CD3B3A654C0D7E8F2C0A9E13B405EFB7CD3F5A354C070AA9D6BDCE23B400A1C7CD387A454C048BD9E6B3CE13B40765AD12895A654C0B8469F6BECDC3B40AAF97BD37BA654C0409EA06BE4D93B40DB0A7CD321A654C0F0AAF6C079D43B40E4E3D12825A654C0589EA06B64D13B40FC4AD22869A654C0EF019F6BD4CE3B40EE717CD345A754C0D07E4916EFCA3B40623E7CD373A754C01798F5C099C93B401E837CD38BA754C0D07E4916EFC73B40643E7CD353A854C0D027A16B14C03B40D27CD128E1A754C0A00EF5C0E9BB3B40924F7CD319A854C060F548163FB73B404406D228D1A854C018E3A06B7CB33B40AAF97BD3DBA954C0CF7E4916EFB13B4002D97CD309AB54C0CF7E4916EFB13B408AC1D12879AB54C0409EA06B64B23B404F22277ED2AB54C0788B9F6B84B33B4089C1D128F9AB54C01885F4C0B9B53B40061C7CD3E7AB54C09859A06B4CBB3B40F0717CD305AC54C0B0469F6B6CBC3B40D4C77CD363AD54C0A0FBF3C009BD3B402A9FD1282DAE54C068F54816BFBE3B4049947CD351AF54C0301B4B16FFC43B405EFB7CD375B054C098789E6BA4C93B404206D228F1B254C01085F4C0B9D03B400A67277E2AB454C0C0339E6B0CD53B400A1C7CD367B454C030EF9D6B74D13B40C4AB277EE2B354C0E77E4916EFCD3B4062FB7CD315B054C058084A161FBF3B4049947CD351AF54C06F8B9F6B84BA3B40D27CD12861AE54C0B0A44B16AFB13B40623E7CD3F3AD54C0D0339E6B0CAC3B40DE0A7CD301AE54C0002E4C16DFA83B40342D7CD3CDAE54C0F0E2A06B7CA93B40EB717CD385AF54C0708B9F6B04AE3B40FB4AD22809B054C04FBD9E6BBCB33B40ACF97BD33BB054C0E8AAF6C0F9B73B40B044277E1EB154C0689EA06B64C03B40F5FF267E06B554C0C727A16B14CE3B40FFD87CD3E9B554C00098F5C019D43B402B9FD1280DB654C0888B9F6B84D73B40F5FF267EA6B654C0A0914A16CFDE3B4002D97CD3C9B654C0F8019F6BD4E33B401A837CD38BB654C0381B4B167FE83B406689277EF6B554C0A00EF5C0E9EC3B40BE607CD33FB554C0F0E2A06B7CF03B40924F7CD399B454C0A0659D6BC4F23B40705AD12835B554C0509EA06B64EF3B4000D97CD3A9B554C0006C48160FEB3B4042BB267ECEB554C0D027A16B94E63B40964F7CD379B554C070AA9D6BDCE23B4076A57CD357B354C020EF9D6B74F73B404406D228F1B154C0579EA06BE40E3C40AEF97BD3DBB154C0B0A44B16AF153C40342D7CD3ADB154C07021F6C0C9183C40A8F97BD31BB154C020D09F6B1C1B3C40735AD128B5B154C0A859A06BCC1E3C40603E7CD313B254C0886CA16BAC223C400C67277E6AB254C01098F5C019293C406A89277E76B254C0C0339E6B8C2C3C40D4C77CD363B254C00F98F5C099313C40964F7CD319B254C0401B4B16FF343C40D27CD12881B154C01098F5C099333C40C0AB277EA2B054C020EF9D6BF4363C40AC44277E3EB054C070AA9D6B5C3A3C40DC0A7CD3C1AF54C0BF27A16B94413C40E8E3D12865AE54C06FF54816BF483C40BC607CD3DFAD54C0FF2D4C165F4C3C40DE0A7CD301AE54C01085F4C0B94F3C40BE607CD33FAE54C0A00EF5C0E94E3C403FBB267E6EAE54C0708B9F6B844E3C40DA0A7CD3E1AE54C0E8AAF6C0F94D3C406589277E96AC54C0D8339E6B8C633C404F22277ED2AB54C01098F5C099663C404F22277ED2AB54C0686CA16B2C683C40EE717CD3E5AB54C0E06B48160F6A3C40C4AB277E82AA54C0806CA16BAC723C402EEA7CD36FAA54C010E3A06B7C803C400A67277E4AAA54C0708B9F6B84833C40D70A7CD3A1A954C0706CA16B2C8B3C400867277E6AA954C0786CA16B2CA13C40D6C77CD3C3A854C07F6CA16BACA53C40C4AB277E02A954C0202E4C165FA73C40663E7CD333A954C01898F5C099A93C409E28D2283DA954C059AA9D6BDCAB3C40CE7CD12801A954C0F014A06BB4AD3C40964F7CD379A854C03FBD9E6B3CB03C4048947CD371A854C0401B4B16FFB13C40D2C77CD3A3A854C050F54816BFB33C40D6C77CD3C3A854C07821F6C049B63C40D6C77CD3C3A854C01098F5C019BF3C408DC1D128F9A854C0C0659D6B44C13C4018837CD36BA954C080789E6BA4C13C40AF44277EDEA954C0FF97F5C099C13C40623E7CD313AA54C01898F5C099C23C40DD0A7CD361AA54C00FEF9D6BF4C53C40F6FF267EA6AB54C031BD9E6BBCCB3C404F22277ED2AB54C0A0FBF3C009CE3C404C947CD3F1AA54C0E0AAF6C0F9D13C401E837CD3EBA954C060AA9D6BDCCF3C40643E7CD353A854C08F59A06BCCC83C402C9FD128CDA854C0B0469F6B6CD03C40AAB67CD3DDA854C050084A161FD33C40D2C77CD363A854C018E3A06B7CDF3C402C9FD1288DA854C040BD9E6B3CE33C40A5B67CD33DA954C0301B4B167FE63C40362D7CD3ADA954C0C0E8F2C029E73C40EE717CD3E5AA54C07F21F6C0C9E73C40C6AB277E62AB54C0B0469F6B6CE83C40964F7CD3D9AB54C068F54816BFE93C4003D97CD389AE54C0C1339E6B8CF53C40AAB67CD3DDAE54C0CFAAF6C0F9F93C4048947CD371AE54C080789E6B24FF3C4076A57CD337AF54C0579EA06B64FF3C40755AD128F5AF54C0AF27A16B94003D40623E7CD353B054C0F097F5C099023D40AD44277EFEAF54C06FF548163F053D404A947CD3D1AF54C06021F6C0C9073D402CEA7CD3CFAF54C05F8B9F6B840F3D40DC0A7CD3C1AF54C037D09F6B9C103D40C6AB277E22B254C06021F6C049173D409E28D228DDB254C0DFE8F2C0A91B3D40D27CD12881B154C00898F5C0991E3D4076A57CD397B254C047084A169F203D409CDD267E1AB354C00098F5C099233D40D07CD12841B354C01898F5C099273D40D07CD12841B354C038BD9E6BBC2C3D40F5FF267E86B454C0F8AAF6C0792A3D4004D97CD309B554C068F548163F293D4062FB7CD355B554C0CFE8F2C0A92A3D4042BB267E0EB654C0A0A44B162F2D3D40924F7CD359B654C08F789E6BA42E3D40AEF97BD39BB754C09F469F6B6C2B3D405EFB7CD315B954C02FD09F6B9C2B3D40D6C77CD383BA54C030BD9E6BBC2D3D40D90A7CD3A1BB54C058BD9E6B3C303D40C2AB277E62BC54C0579EA06B642F3D405322277E32BE54C058BD9E6B3C2F3D40CE7CD12821BF54C08F789E6BA42E3D40E6E3D12845C054C00898F5C0192D3D406789277EB6C054C0B0914A16CF2C3D40061C7CD387C154C038BD9E6BBC2C3D409ADD267E9AC254C020D09F6B1C2E3D40F0717CD3E5C254C01FD09F6B1C313D405522277EF2C254C038D09F6B1C343D40299FD1284DC354C0F0E2A06B7C353D406489277E36C454C0D7E8F2C029363D4074A57CD3B7C454C0002E4C16DF373D401C837CD3ABC454C0CF14A06B343A3D402EEA7CD3EFC354C03F084A169F3C3D4003D97CD369C454C0910EF5C0E93E3D4078A57CD3D7C454C0C17E49166F423D402C9FD1286DC554C098A44B16AF453D406589277E56C654C020D09F6B1C473D405422277E52C754C0C7914A16CF473D4076A57CD377C854C0B0FBF3C089493D409B28D2287DC954C0A059A06BCC4B3D4078A57CD317CA54C037D09F6B1C4E3D4047947CD351CA54C0A0659D6BC44F3D4074A57CD377CA54C03072F3C059523D4048947CD391CA54C03785F4C0B9573D40B244277EBECA54C0A9789E6B24583D4076A57CD3D7CB54C030BD9E6BBC5F3D40342D7CD3CDCD54C030D09F6B1C693D40F8FF267EE6CE54C008029F6B546D3D405EFB7CD335D054C02885F4C039713D40362D7CD3CDD154C0C0659D6B44703D404406D22891D354C03FBD9E6B3C753D40372D7CD3CDD654C0E014A06BB4823D406389277E76D754C0272E4C165F823D4000D97CD349D854C078AA9D6BDC833D400A1C7CD3E7D954C017D09F6B1C883D4076A57CD397D954C0DFAAF6C0798A3D4002D97CD3A9D954C028D09F6B1C8E3D4060FB7CD3F5D954C09059A06BCC913D406489277E56DA54C05072F3C059943D401A837CD3ABD954C0B1A44B162F973D40DE0A7CD341D954C09059A06B4C9C3D40FAFF267E26D954C02FBD9E6B3CA23D402A9FD1286DD954C0F86B48168FA73D401A837CD32BDA54C0F0019F6BD4AA3D40C4AB277E42DB54C0C0FBF3C009AC3D4002D97CD389DC54C030BD9E6BBCAC3D4060FB7CD3D5DD54C0CF339E6B8CAE3D40D4C77CD363DE54C0608B9F6B04B03D40E9E3D12825DF54C010D09F6B9CB23D405EFB7CD395DF54C0A059A06BCCB33D40E4E3D128C5E154C08F59A06B4CB73D40372D7CD3CDE254C0609EA06B64BA3D4074A57CD3F7E354C08F0EF5C0E9BE3D4004D97CD3E9E454C0F0019F6BD4C33D40362D7CD34DE554C07F789E6B24C83D40A4B67CD35DE554C067F54816BFCA3D40623E7CD3B3E554C0182E4C16DFD03D40904F7CD3F9E554C0281B4B167FD33D40643E7CD393E654C030084A161FD53D402A9FD1282DE754C03F72F3C059D63D405622277E72E754C0EF14A06BB4D73D40AE44277EFEE754C09F659D6B44DD3D40EE717CD365EA54C0F86B48160FE63D404A947CD3F1EA54C050AA9D6B5CE93D403EBB267E8EEB54C05072F3C0D9EB3D40A8B67CD35DEE54C03FBD9E6B3CF33D40061C7CD327EF54C07021F6C0C9F43D40D1C77CD343F054C00F85F4C0B9F53D40362D7CD30DF154C07F8B9F6B04F83D4002D97CD369F254C058AA9D6B5CFD3D404606D228F1F354C070F548163FFC3D4030EA7CD3CFF654C027D09F6B9C003E406889277ED6FC54C0E87E4916EF0D3E4002D97CD3890155C06F21F6C0491B3E4002D97CD3C90255C0A0469F6BEC1A3E408CC1D128D90455C0409EA06BE4173E405422277E720955C0101B4B167F163E40D0C77CD3C30A55C0D0339E6B8C133E4002D97CD3690B55C0A8789E6BA4123E40D07CD128C10B55C05F9EA06BE4143E400C67277E0A0C55C037EF9D6BF4173E40061C7CD3870C55C0EFE2A06B7C193E408EC1D128B90C55C08859A06BCC193E40633E7CD3D30C55C028EF9D6B741A3E40CE7CD128010D55C02FD09F6B1C1B3E40C2AB277E620D55C0A70EF5C0691B3E401B837CD3CB0D55C0FF2D4C16DF1A3E40FE4AD228290E55C07F8B9F6B84183E4002D97CD3890E55C0409EA06BE4173E40964F7CD3D90F55C0409EA06BE4173E405022277ED20F55C09059A06B4C183E40F8FF267E061055C018E3A06BFC183E4076A57CD3571055C0808B9F6B84193E4042BB267EAE1055C0EFE2A06B7C193E40DD0A7CD3411155C01F85F4C0B9173E4006D97CD3C91155C0C0914A16CF143E400A1C7CD3271255C020D09F6B1C123E40CE7CD128411255C09F0EF5C0E9103E400A1C7CD3471455C06FAA9D6B5C113E40FAFF267E061555C0609EA06BE4103E404E947CD3511755C0A0469F6B6C0C3E40904F7CD3B91755C060AA9D6B5C0A3E406889277EB61755C0C0659D6B44063E40D90A7CD3211855C00FE3A06BFC063E403EBB267E4E1855C0A00EF5C069073E402B9FD1288D1855C0886CA16B2C083E40F6FF267E061955C0C0659D6B44063E40FC4AD228C91855C0D014A06B34043E40BE607CD3BF1855C040084A169F033E408AC1D128D91855C0D0339E6B0C033E40F6FF267E061955C0B8FBF3C009013E405422277ED21855C01F85F4C0B9FF3D402B9FD1288D1855C058AA9D6B5CFD3D40AAB67CD35D1855C04FAA9D6B5CFE3D40FA4AD228E91755C00F98F5C019003E406889277EB61755C0B8FBF3C009013E40362D7CD34D1755C02185F4C0B9FE3D40DA0A7CD3011655C04F72F3C059F93D4004D97CD3291655C05F21F6C049F83D40362D7CD30D1755C009029F6BD4F83D40F0717CD3A51855C050BD9E6B3CFB3D404A947CD3D11A55C0CF7E49166FFD3D402A9FD1280D1C55C0AF914A164F003E40F8FF267E061D55C0F0019F6B54013E40745AD128D51D55C058AA9D6B5CFD3D4017837CD3CB1C55C097789E6B24FD3D405622277E921C55C0E814A06BB4FA3D40A9B67CD37D1C55C0609EA06BE4F73D40C6AB277EE21B55C0B0FBF3C089F63D4040BB267EEE1755C07021F6C0C9F43D40643E7CD3F31555C0FF2D4C165FF23D40C2AB277E821555C0579EA06BE4EC3D405EFB7CD3551655C09F469F6BECE63D40FAFF267E261855C0D7E8F2C029E33D400E67277E8A1755C07F0EF5C0E9E53D40F8FF267E461755C0A059A06BCCE63D40F8FF267E461755C0689EA06B64E83D402FEA7CD3AF1955C0E7E8F2C029EB3D405022277E521C55C0D0339E6B0CEC3D405622277E921D55C0706CA16B2CEB3D4003D97CD3C91E55C0E014A06BB4E93D404A947CD3D11F55C0C8469F6B6CE93D40FC4AD228892055C0D0339E6B0CEC3D40061C7CD3072455C0419EA06BE4E43D40362D7CD3AD2655C077AA9D6B5CDD3D40362D7CD3CD2955C0C1914A164FDA3D40964F7CD3B92B55C000E3A06B7CD53D40643E7CD3F32E55C0886CA16BACCA3D40D07CD128C12F55C0606CA16B2CC93D4078A57CD3773155C04F9EA06B64C83D405622277E723255C05172F3C059C73D406689277EF63355C0A0659D6B44C33D40A9F97BD3FB3455C048084A161FC13D408AC1D128393655C0E014A06B34C03D409CDD267E1A3755C0A0FBF3C089BE3D40EE717CD3053855C0F814A06BB4BB3D40AE44277EBE3855C0589EA06BE4BA3D400C67277E0A3955C001029F6B54BF3D40D4C77CD3C33855C0C17E49166FC13D40ACF97BD3DB3655C0B0659D6B44CC3D40D2C77CD3E33755C018E3A06BFCCD3D40AEF97BD3BB3855C0C827A16B94CC3D4032EA7CD38F3955C0B0A44B162FCA3D402A9FD1288D3A55C0DF7E4916EFC83D40F6FF267E663B55C06021F6C049C73D40071C7CD3873C55C03085F4C0B9C03D40D2C77CD3233E55C0509EA06BE4BF3D40362D7CD36D3F55C0D0339E6B0CB93D40F2717CD3454055C08F59A06B4CB73D409ADD267E5A4555C0CF14A06B34B93D40633E7CD3F34755C05F21F6C0C9B83D40041C7CD3674F55C0B8914A164FB03D4004D97CD3C95055C0F0AAF6C079B03D40041C7CD3475255C070AA9D6B5CB13D40643E7CD3B35355C0898B9F6B84B13D40FAFF267E265655C0E7E8F2C0A9AD3D4002D97CD3695755C0E714A06BB4AF3D40765AD128755855C00898F5C099B33D4031EA7CD30F5955C08F59A06B4CB73D40081C7CD3475A55C000029F6BD4CC3D406489277E765A55C028EF9D6BF4D93D40BC607CD37F5955C0A7789E6BA4DF3D40623E7CD3535955C020D09F6B1CDD3D40BC607CD37F5955C0D0AAF6C079CB3D4060FB7CD3555955C01098F5C099C53D40D70A7CD3E15855C09059A06BCCBF3D40362D7CD32D5855C09F0EF5C069BA3D40B044277E7E5655C0898B9F6B84B13D40D0C77CD3035655C08F0EF5C069B03D40CE7CD128215555C0B8914A164FB03D40D2C77CD3835455C0F8E2A06B7CB13D40F2717CD3C55355C0409EA06BE4B33D404A947CD3515355C037BD9E6B3CB63D4040BB267E8E5355C08F59A06B4CB73D40B044277E9E5355C0A759A06B4CBA3D406889277E565355C0B0659D6B44CC3D405422277EF25355C08159A06BCCD13D40A8B67CD3FD5555C0C727A16B14DB3D4032EA7CD36F5655C0C0659D6BC4DE3D404406D228D15655C0878B9F6B84E33D40AEF97BD3BB5755C098A44B162FE83D40D07CD128E15855C04872F3C059EC3D403DBB267EEE5955C0609EA06B64EF3D40D2C77CD3436155C00F029F6B54FB3D40F2717CD3256355C0B8FBF3C009013E408EC1D128796355C020D09F6B9C023E40603E7CD3B36355C0D027A16B14043E40C2607CD3DF6355C09F914A16CF053E40ED717CD3056455C0886CA16B2C083E402B9FD1288D6355C0886CA16B2C083E404406D228D16255C0B7469F6BEC033E40C0607CD37F6155C0EF14A06B34FF3D40C3AB277E026055C060AA9D6BDCFB3D40A6B67CD3BD5E55C07F21F6C0C9FB3D40061C7CD3E76655C0E06B48160F133E40D80A7CD3C16755C0910EF5C069143E4030EA7CD3EF6A55C0DFAAF6C0791F3E40A6B67CD37D6B55C0479EA06B64223E409CDD267EFA6A55C0900EF5C0E9223E40705AD128156755C001E3A06B7C203E40DC0A7CD3216755C09F659D6BC41B3E404A947CD3F16255C09059A06B4C173E406589277ED66155C0D0339E6B8C133E402FEA7CD3CF6055C0C9E8F2C0290E3E402CEA7CD38F5E55C0A10EF5C069083E402EEA7CD34F5C55C0E7E8F2C029053E40F84AD228495B55C02885F4C039073E40F0717CD3C55A55C0DFE8F2C029093E40AC44277EBE5955C0DFE8F2C0290A3E40A4B67CD3FD5855C038EF9D6B740B3E400A1C7CD3475955C02085F4C0390E3E409BDD267EBA5955C0E1339E6B0C0F3E40F7FF267EC65A55C0B1914A16CF0E3E40F84AD228495B55C07F8B9F6B040F3E40362D7CD38D5B55C07F789E6B24103E40E7E3D128855B55C0EFAAF6C079113E40765AD128955B55C0C8339E6B0C123E40FA4AD228295C55C09F0EF5C0E9103E402A9FD128ED5C55C0DFE8F2C0290B3E405422277E925D55C0D07E4916EF083E40EC717CD3855E55C098789E6BA40A3E408AC1D128195F55C0679EA06BE40E3E4076A57CD3F75E55C0C727A16B94173E4076A57CD3375F55C0A70EF5C0691B3E40AEF97BD35B6055C0A90EF5C069193E402FEA7CD3CF6055C03FBD9E6BBC1B3E405022277E926055C07F789E6BA41F3E40051C7CD3A75F55C0479EA06B64223E40051C7CD3A75F55C0F0E2A06BFC233E409E28D228DD6055C0786CA16BAC233E408CC1D128D96155C04F9EA06BE4213E40745AD128D56255C07821F6C0C9203E40ED717CD3056455C0479EA06B64223E402C9FD1280D6455C0D7E8F2C0A9203E401A837CD32B6455C0201B4B167F1F3E40643E7CD3536455C007E3A06B7C1E3E405EFB7CD3756455C0E7E8F2C0291D3E40725AD128556555C09759A06BCC1F3E40AAF97BD3BB6655C0C8FBF3C009233E4062FB7CD3356855C0818B9F6B04253E403EBB267E4E6955C0F0E2A06BFC233E401B837CD3CB6955C027EF9D6BF4263E40081C7CD3676A55C091789E6BA4283E40DE0A7CD3A16C55C010EF9D6B742C3E40EE717CD3256D55C0FF019F6BD42D3E409D28D2289D6D55C0F097F5C0992F3E409D28D2281D6E55C051084A161F323E40C2607CD3BF6C55C0172E4C16DF343E404406D228116A55C0B8FBF3C089403E406689277E166955C0016C48160F413E4040BB267E8E6755C0E77E4916EF3E3E4049947CD3116555C06FF548163F493E402B9FD1288D6355C0201B4B16FF483E408AC1D128596455C0CF14A06B344F3E40279FD128ED6455C02785F4C039523E40392D7CD38D6555C000E3A06B7C533E402D9FD1282D6655C0E0AAF6C079513E409ADD267EBA6755C0F014A06B34483E40AC44277EDE6855C0301B4B167F453E40299FD1282D6955C001E3A06BFC483E4001D97CD3E96955C0EF97F5C099483E407AA57CD3D76A55C0886CA16BAC463E409CDD267EBA6B55C0301B4B167F453E406689277E766C55C0FF97F5C019443E40FB4AD228E96C55C06021F6C049413E409DDD267E5A6D55C040BD9E6B3C3F3E409D28D2281D6E55C027D09F6B1C403E40944F7CD3196E55C0301B4B167F443E4042BB267EAE6E55C09759A06B4C483E40ED717CD3856F55C0679EA06B644C3E402C9FD1284D7055C058BD9E6BBC513E40EC717CD3057155C0D014A06B344D3E40D4C77CD3C37155C0282E4C165F4B3E400A67277ECA7355C00898F5C0994A3E405EFB7CD3D57455C0878B9F6B84493E40C6AB277E027655C03085F4C039473E40372D7CD3AD7655C0A859A06BCC433E4078A57CD3377655C0A7914A164F3F3E40A8F97BD33B7555C03F9EA06B643C3E40C2AB277E827455C0A1469F6B6C3C3E40FC4AD228A97355C03085F4C0B93D3E40FA4AD228497255C0778B9F6B843E3E409ADD267E1A7155C0D027A16B943D3E40DA0A7CD3617055C07F21F6C0493B3E4006D97CD3C96F55C0609EA06B64383E40A028D228FD6E55C01FD09F6B9C353E4048947CD3F16F55C0A0659D6BC4303E405222277E726F55C0E0E8F2C0A92D3E40F0717CD3456E55C0C8339E6B0C2B3E40643E7CD3336D55C090789E6BA4273E40342D7CD3AD6D55C0F0E2A06BFC233E40A028D2287D6E55C027EF9D6BF4263E40D07CD128016F55C02FEF9D6B74263E409E28D2289D6E55C0EF019F6BD4243E409D28D2281D6E55C0479EA06B64223E40DA0A7CD3A16F55C0F014A06BB4233E40623E7CD3537755C068AA9D6B5C373E40342D7CD3CD7C55C06F21F6C0C9403E408CC1D128398455C04772F3C0594E3E4078A57CD3578C55C0EFE2A06BFC563E4089C1D128599755C0D0AAF6C079613E4001D97CD3099F55C0E0339E6B8C643E405222277EB2A055C04872F3C059683E40BE607CD39FA055C058BD9E6BBC683E40DC0A7CD3A1A055C0BF469F6B6C693E4030EA7CD38FA055C01085F4C0396A3E40382D7CD38D9F55C0B827A16B14693E40FC4AD228699A55C0E7AAF6C079683E4078A57CD3379655C050084A161F653E40382D7CD36D9555C0C7469F6B6C663E404206D228F19455C0E7AAF6C079693E40944F7CD3999455C010EF9D6BF46C3E40C0607CD33F9455C02FD09F6B9C6F3E405222277EF29355C050BD9E6BBC6F3E40A6B67CD3DD9355C04072F3C0596F3E4030EA7CD3CF9355C02FD09F6B9C6F3E40289FD1288D9355C0D8E8F2C0A96C3E40705AD128159355C06021F6C0C9693E40CE7CD128619255C00098F5C099673E40AEF97BD37B8F55C050084A161F653E406489277E168F55C090789E6B24663E401A837CD3AB8E55C06FAA9D6BDC673E40A8F97BD37B8E55C008E3A06B7C693E4006D97CD3C98E55C01085F4C0396A3E40F6FF267EC68F55C010029F6BD46A3E400C67277E8A9055C0A159A06B4C6C3E405622277EB29055C0B027A16B146E3E40DA0A7CD3E18F55C02FD09F6B9C6F3E40D07CD128018F55C01F85F4C0396F3E405EFB7CD3158E55C068F548163F6D3E4078A57CD3578C55C0E7AAF6C079683E400C67277E4A8955C0679EA06B64653E40F2717CD3A58855C0786CA16B2C643E40D2C77CD3838755C039D09F6B1C613E40EC717CD3E58655C0381B4B16FF623E405622277ED28655C0DF339E6B8C663E404D947CD3518755C0E7AAF6C079683E40CE7CD128618755C0A0914A16CF693E405422277E528955C0DF14A06B34713E4048947CD3B18955C0006C48160F753E40A228D2285D8955C0F714A06B34763E40EAE3D128E58855C010E3A06B7C773E408CC1D128D98855C09FA44B16AF7B3E40EB717CD3858A55C04072F3C0D9783E40F5FF267EA68B55C0618B9F6B04783E40924F7CD3798C55C0B0469F6B6C7A3E40D80A7CD3418D55C051F548163F813E4005D97CD3498E55C0778B9F6B047E3E405422277E928F55C09FA44B16AF7D3E40382D7CD34D9255C03072F3C0597F3E4000D97CD3899355C0A0659D6BC47E3E403BBB267E4E9655C0B1659D6B447C3E401A837CD38B9755C09FA44B16AF7B3E405CFB7CD3759855C0CFAAF6C0797A3E40C2AB277E429955C0618B9F6B04783E40C4AB277E229A55C040084A161F763E40061C7CD3479B55C010D09F6B9C763E40F0717CD3259C55C0489EA06BE4793E409ADD267EDA9B55C0806CA16BAC7D3E40FC4AD228699A55C01898F5C099843E4047947CD3F19B55C05F6CA16BAC843E404C947CD3919C55C0A9A44B162F843E40041C7CD3079D55C05072F3C0D9823E4076A57CD3779D55C0EF6B48160F803E404A947CD3119E55C0E07E49166F803E40745AD128B59E55C05072F3C0D9823E40D27CD128419F55C0886CA16B2C863E40745AD128359F55C0E7E8F2C029833E40DE0A7CD3E19E55C0A059A06BCC7C3E40D2C77CD3039F55C0419EA06BE47A3E40342D7CD3AD9F55C037D09F6B1C793E404206D22871A055C067F54816BF773E40D0C77CD343A155C09F0EF5C0E9763E4074A57CD317A255C010D09F6B9C763E400A67277EAAA255C0C1659D6BC4753E405EFB7CD375A355C0E0339E6B0C723E40D90A7CD341A455C0DF14A06B34713E40D17CD128C1A555C0D0AAF6C0F9713E4060FB7CD3D5A555C02F72F3C0D9703E4040BB267ECEA555C0B0469F6BEC6C3E4018837CD38BA655C0AF27A16B146B3E40F8FF267E86AB55C00FD09F6B1C6C3E409CDD267EBAB055C0706CA16B2C6A3E40705AD12815B255C00FD09F6B1C6C3E40B044277E7EB355C020D09F6B9C693E403CBB267E4EB555C0C027A16B94683E40E4E3D128E5B855C0E7AAF6C079683E408AC1D128D9C255C03FBD9E6BBC633E406689277E36C955C02F084A169F5D3E401C837CD36BCC55C058BD9E6B3C5C3E4004D97CD329CC55C0E06B48160F5F3E40C2607CD3BFCB55C0B0A44B162F603E4099DD267E3ACB55C030084A169F603E406A89277ED6C855C0818B9F6B84643E40914F7CD3F9C455C0E8E8F2C029683E409EDD267E7AC155C08821F6C049683E405DFB7CD355C055C0708B9F6B04693E4017837CD32BBC55C068AA9D6BDC743E40643E7CD353BB55C090789E6BA4733E40C4AB277E22BA55C05772F3C059713E40623E7CD333B955C078AA9D6B5C703E409D28D2281DB955C020D09F6B1C733E40D4C77CD3E3B955C0606CA16B2C763E406889277E36BB55C071AA9D6B5C783E40E8E3D128A5BC55C0DFE8F2C0A9793E408CC1D128B9BD55C037D09F6B1C7A3E401A837CD34BBE55C02F85F4C0397B3E40041C7CD327BF55C08F789E6B24803E405222277E72BF55C051F548163F813E40663E7CD313C055C08821F6C049813E403EBB267E8EC055C0B7A44B16AF813E40A4B67CD3DDC055C0579EA06BE4823E4098DD267EFAC055C0609EA06B64853E408CC1D12899C055C0FF6B48160F893E4004D97CD3A9BF55C0B0914A16CF8B3E40ACF97BD37BBD55C057BD9E6B3C8F3E40FA4AD22889BD55C0AF469F6B6C903E40A028D2289DBD55C0D7E8F2C029913E405CFB7CD3F5BD55C049BD9E6BBC923E4042BB267E2EBF55C05F8B9F6B04903E4076A57CD3D7BF55C0B0469F6B6C933E400E67277E8AC055C0A0A44B16AF983E40E7E3D128E5C155C0E8AAF6C0799B3E4004D97CD349C155C030EF9D6BF4963E40AAF97BD35BC155C0509EA06B64943E404006D228B1C155C0E8339E6B8C923E4032EA7CD30FC355C098789E6BA4843E40B044277EDEC355C0A0A44B16AF7E3E405022277E52C455C0A10EF5C0E9753E40643E7CD3F3C455C020D09F6B1C733E405222277EF2C555C0C8469F6BEC723E401E837CD34BC655C0609EA06BE4753E404206D22831C655C0D727A16B147A3E405622277ED2C555C00798F5C0997D3E40D07CD12841C655C0301B4B16FF803E40904F7CD379C655C0DF6B48168F853E40CFC77CD303C755C0DF14A06B34893E40081C7CD367C855C0F1019F6BD4893E4004D97CD349C855C0FF6B48160F8B3E40D27CD12821C855C07F8B9F6B048E3E40DC0A7CD301C855C057BD9E6B3C8F3E409ADD267E1AC955C007029F6BD48F3E403A2D7CD38DC955C0E06B48160F923E40DE0A7CD3E1C955C048084A169F943E40DE0A7CD3A1CA55C03085F4C039963E4040BB267E8ECB55C0806CA16BAC953E4000D97CD3C9CB55C0E0AAF6C0F9923E401A837CD38BCB55C07021F6C0C98A3E40F0717CD345CB55C0D7E8F2C0A9873E404A947CD311CA55C0706CA16B2C813E401A837CD3CBC955C09F789E6BA47C3E40F94AD22809CA55C0D8AAF6C079793E401A837CD38BCB55C02FD09F6B9C6F3E404A947CD3F1CB55C02FD09F6B9C6F3E40755AD12815CC55C041BD9E6B3C703E40F4FF267E26CC55C0F8AAF6C079703E401C837CD36BCC55C0DF14A06B34713E40623E7CD3F3CC55C068F548163F6B3E40382D7CD32DCE55C0606CA16BAC693E40BF607CD39FCF55C02FBD9E6B3C693E40623E7CD3D3D055C02185F4C0B9663E40ACF97BD3FBD055C070F548163F643E400A67277ECAD055C020EF9D6BF45D3E40FAFF267E06D155C0D87E49166F5B3E4060FB7CD395D155C0192E4C165F5A3E404A947CD331D355C0788B9F6B84593E408CC1D128D9D355C038BD9E6BBC583E40AC44277E9ED355C00FD09F6B1C543E401B837CD30BD555C05072F3C0D9513E40ED717CD325DE55C0B0A44B162F4B3E40C0607CD33FDF55C0201B4B16FF483E40E6E3D128C5DF55C00898F5C099493E4040BB267E2EE155C050BD9E6B3C483E40AF44277EDEE155C01798F5C019473E40AF44277EDEE155C0201B4B16FF483E40D27CD12821E155C0B8FBF3C0094A3E4030EA7CD3AFE055C0679EA06B644B3E40362D7CD34DE055C077AA9D6BDC4C3E40904F7CD3B9DF55C050F548163F4E3E40A7B67CD3FDDE55C0708B9F6B044F3E40CF7CD128A1DC55C0E8E8F2C029503E408AC1D128B9DD55C0A8789E6B24523E40944F7CD3D9DE55C000E3A06B7C533E4048947CD311DE55C0A0FBF3C089543E40ACF97BD37BDC55C0890EF5C069543E406689277EB6DB55C0AF27A16B14553E408DC1D128F9DA55C0DF339E6B0C573E40A6B67CD37DDA55C08F789E6BA4593E40061C7CD387DA55C03785F4C0395C3E404406D22851DB55C07F789E6B245E3E404406D22851DB55C0609EA06BE45F3E4042BB267E6ED955C0B7659D6BC4673E40A9B67CD33DD855C00F2E4C16DF6A3E405EFB7CD3B5D655C00FD09F6B1C6C3E40B044277E1ED655C000E3A06B7C6D3E404A947CD311D655C02FD09F6B9C703E40061C7CD367D655C040084A161F743E404C947CD3F1D655C010D09F6B9C763E40B244277E7ED755C01FD09F6B1C773E40F0717CD3C5D855C0EF97F5C099763E40663E7CD353D955C04F9EA06B64773E40ED717CD3C5D955C0DFE8F2C0A9783E40369437E8DADA55C0402A61C4C77A3E408723A30ADBDA55C097A8F72CC97A3E4036D8FA4CDCDA55C0686FCA77D37A3E40F0C82D80E5DA55C087D7FAAA1E7B3E40FAA5C71919DC55C0A06BFBAA56873E403C422D803FDC55C0309E6011758B3E40B4EFFA4C2CDC55C0572331DE918C3E40AA8693E6EDDB55C0980E6311C58E3E40CCA2FA4CD6DA55C0CFFEC87793953E40F7772D8051DA55C080E3FCAA569C3E4040CC93E6E5D955C018DE611135A53E40E24694E6D7D955C047D932DEF9A83E40AA7B61B3EED955C05825924490AB3E404FA6C71925DA55C009FACB777BAC3E40663061B3A8DA55C0AF3D2EDE19AE3E40B35CFA4CCCDF55C020146411FDB83E40DCFD60B3B6E055C02880984478BB3E40767BC7199DE155C0A0F19444D8BF3E40C0A4C719EFE255C067EA964450C83E405C9BFA4C4CE355C0F0722DDE39CA3E400CCF94E661E655C0F8939544C0D43E40404B2E801BE755C070822FDEE9D73E40FCDC60B3C0E755C0F8F660115DDB3E403084C71905E855C0874EFDAA7EDD3E40DDAC2D801FE855C0A0AC944480DF3E40BA86FA4C10E855C0D062FEAA16E13E404BC661B3F6E755C0AFAD63119DE23E40ECA1C719B5E755C0D8A0954440E53E40F0C22D8065E655C0E8A9944420EF3E403629FB4C4AE655C0C06E62115DF03E4054F82D806BE655C0B7932FDE61FC3E405573FA4CFEE555C0B0DD6111EDFF3E405A0561B31AE355C0E7A19344F0FF3E4038E794E6EFD855C0E7A19344F0FF3E40DFD1C719C5CE55C0D0832CDEF1FF3E40CF8C93E699C455C0E8246211F5FF3E40E065C8196FBA55C0E8246211F5FF3E405259FA4C44B055C0E8246211F5FF3E40780BC71919A655C0D006FBAAF6FF3E4052EDFA4CEE9B55C0E8A730DEF9FF3E40FAD72D80C39155C0E8A730DEF9FF3E40228AFA4C988755C0E8A730DEF9FF3E40CA742D806D7D55C0086C6211FDFF3E40A25661B3427355C0FF0C984400003F40C4082E80176955C0FF0C984400003F406CF360B3EC5E55C01FEF30DE01003F404AD594E6C15455C03FB3621105003F406C8761B3964A55C03FB3621105003F40137294E66B4055C03F95FBAA06003F40B8822E808F4055C0A708CA772BFF3E40DC2C94E67F4055C0D08B2FDEF1FB3E40FCF060B3364055C0A1609444D0FA3E408AE0C619193F55C0B074651115F83E4043E4FA4CB63E55C0E00FC877B3F63E40F12E2D80593E55C0D059CA77EBF33E4094D4FA4CD63D55C0F8F4FCAA36EC3E405C742D804B3D55C0708F62114DEA3E40AC642D806B3C55C06FF7621145E43E4010FB2D80F13B55C079A0C6773BDE3E4040CF61B3DC3B55C050B863116DD33E405E3DC819E93A55C02F79641195C23E40,-26.1%,"-1,024","2,902","1,077","1,825",Florida,true
2,0106000020E6100000EC00000001030000000100000011000000B90B69949B6266C0F880CF35AAA44940264ABEE9386266C0B0107BE0A4A149401F036994F86166C0607479E094A049401F036994F86166C040877AE0B49F49402ED86894B96266C050D2258B179F4940C6E068944C6366C077557BE0FC9C4940525BBEE9CE6366C0543CCF35929B49405BE968945F6466C044B6D035169D494095CF6894266466C03CD5CE352E9F4940D1B568944D6466C077557BE0BCA04940B90B69948B6466C08371D035FEA14940A05D133F976466C048877AE034A34940A3A46894976466C048877AE034A34940AE7DBEE94A6466C0503CCF3552A44940B60B6994CB6366C0B8107BE024A54940F638BEE9D26266C0C32CD035E6A54940B90B69949B6266C0F880CF35AAA44940010300000001000000100000001875BEE9275F66C08871D035FEA749407E256994945F66C09C427AE05CA74940040EBEE9C35F66C0B0C5CF35C2A94940EA63BEE9B15F66C0E019CF35C6AA4940535BBEE94E5F66C0E893D0354AAD49404E1469945E5F66C0304FD03572AE49407E256994945F66C0C3C5CF3542B04940BC52BEE98B5F66C028D5CE352EB14940C5E068941C5F66C0C0C5CF35C2B2494038AD68948A5E66C03CB6D03596B24940C4E068945C5D66C01804258B4FB049405BE96894EF5C66C0E893D0354AAD4940501469943E5D66C0BCC5CF3542AC4940B70B6994DB5D66C013E8CF350EAC49401F036994585E66C0888D258B7FAB49401875BEE9275F66C08871D035FEA74940010300000001000000060000009F5D133F674966C0109D248BEBBD4940F97F133F234966C014337BE0F0BC4940FEC66894734966C0780AD0359ABC494084B3133FC54966C07871D0353EBD49403766133FEA4966C07871D0353EBD49409F5D133F674966C0109D248BEBBD4940010300000001000000130000005CE968947F5A66C0B0C5CF3582C9494056A2133F2F5A66C02C04258B8FC84940E61C6994115A66C02C04258B8FC84940A2A46894575966C07BDB79E0B8C7494057A2133F4F5866C0DBB2CE35A2C749404BCD133FFE5766C0D8FD79E044C749404D146994AE5766C00481CF356AC649402ED86894E95766C00B81CF35AAC549404E1469945E5866C087427AE0DCC549409288133FB65966C0BCC5CF3542C54940FB7F133F835A66C01417268BEFC54940B80B69949B5A66C05058248B93C649401BBC133FA85A66C01B337BE030C749401775BEE9D75A66C0740AD0355AC84940321FBEE9395B66C007E8CF354EC949405BE968945F5B66C0740AD0355AC9494020036994585B66C0B87A248B9FC949408E41BEE9055B66C0B4A97AE0C0C949405CE968947F5A66C0B0C5CF3582C949400103000000010000000A0000002FD86894596166C04F3CCF3552C949403BAD68943A6166C0E0B2CE35E2C84940F838BEE9B26166C04F3CCF3552C94940A3A46894F76166C067557BE0BCC94940A3A46894F76166C02404258B4FCA49401DBC133FE86166C0D8777BE008CB4940EEAA133FC26166C0FB647AE068CB494068BE6894B06166C098427AE01CCB494056A2133F4F6166C018E8CF358ECA49402FD86894596166C04F3CCF3552C949400103000000010000000C000000F2F16894825266C024337BE030CB4940C927BEE99C5266C07871D035BECA4940E3D5133FD15266C098427AE01CCB4940F738BEE9F25266C03CD5CE35EECA4940B07DBEE90A5366C04FA3CF35F6CA4940E2D5133F715366C0403CCF3552CC4940D6FCBDE94D5366C043207AE010CD4940321FBEE9F95266C00F17268BAFCD49409C16BEE9C65266C0F0AF258BCBCD494039AD68948A5266C0747479E094CD494095CF6894665266C0D048258BE7CC4940F2F16894825266C024337BE030CB4940010300000001000000110000009288133F465466C008CC7AE08CCB4940A4A46894775466C0EF19CF3546CB4940C4E06894AC5566C017E8CF358ECB49409188133FC65566C0436B258BB3CB4940D6FCBDE9DD5566C0E8647AE028CC4940030EBEE9F35566C0AC5ECF35DECC49402CD86894E95566C0FBCB7AE08CCD4940F97F133FC35566C0CF48258BE7CD4940BD52BEE92B5566C0C4107BE024CE494097CF6894F65466C0D893D0358ACE49406477133F605466C0B8C5CF3582CE4940EEAA133F325466C048D2258B17CE494067BE6894005466C0CB9679E0E0CD49401975BEE9D75366C00CE8CF358ECD49405CE96894DF5366C0A05ECF355ECC4940CD6E133F0D5466C0687479E094CB49409288133F465466C008CC7AE08CCB49400103000000010000005A000000160E976B9D586640E4B2CE35E2D14940AACF411630596640780AD035DACF494003F241169C5966403CB6D03556D149403A91ECC0125A6640C72CD03566D149406D30976B895A664058A3CF3576D04940A8CF4116F05A664088F7CE35FACE49402F034216525B6640274FD03572CF4940D4E04116D65B664054D2258B97CF4940CC52976B655C664038D5CE356ECF494032034216725D66402004258B4FCE4940B6EB966BB15D664070BF248BB7CD494006F24116CC5D66403FB6D035D6CC4940CCE04116E65D664050D2258B57CB49404EAD4116245E6640B07A248BDFCA4940CC52976B755E664094F7CE35BACA4940D6E04116C65E664058A3CF3536CA4940202AECC0EE5E6640770AD0351ACA4940A0CF4116905F66404FA3CF35F6C9494048AD4116C45F66401804258BCFC94940D0E04116E65F6640C4C5CF3542C949402E034216326066408471D0357EC7494002F241164C6066409C427AE01CC749407ABE4116AA606640C3107BE064C649401C9C4116EE616640AC5ECF35DEC14940222AECC0EE6366408071D0357EBD4940804CECC07A646640F035248B07BD4940242AECC0DE6566404C3CCF3592BC4940A3CF41164066664087F7CE353ABC49406830976B89666640E819CF3546BB494002F241164C6766405FBF248B37B84940232AECC0AE67664030B6D03556B549401D9C41163E6866402B4FD035F2B44940804CECC06A696640E0B2CE35A2B54940AACF411650696640985ECF351EB54940130E976B3D696640D42CD035A6B4494048AD41162469664090F7CE353AB44940D6E04116F668664010E8CF35CEB34940D6E04116F6686640BCC5CF3502B349403691ECC0226C66402C4FD03572B34940120E976BCD6C66400036248B47B4494003F24116AC6E664008E8CF35CEB04940120E976B1D6F66402FD5CE356EAF49406E30976B896E6640E048258B67AF494074BE41167A6D66409B427AE09CAE49407ABE4116EA6C6640B0107BE0A4AE4940FFF14116FC6C6640DC48258B27AF4940CC52976B056D66400817268B2FAF49402C034216226D66402FD5CE356EAF4940BAEB966BB16C66407C71D0353EB04940A6CF4116406C6640F7CB7AE04CB04940150E976B5D6B66402FD5CE356EAF4940F08A4116286B6640F035248B07AF4940DA6EECC0E66A664074557BE0FCAD494077BE4116BA6A6640D8FD79E0C4AD4940DC6EECC0766A6640D42CD035E6AD4940B6EB966BF1696640948D258B7FAE49403891ECC0A2696640B0107BE0A4AE4940D5E04116366966405CA3CF3536AE4940140E976BAD686640E3B2CE3562AD4940EE8A41162868664038B6D035D6AC4940DA6EECC0C6676640E893D0354AAD494002F241168C676640E319CF3586AE4940262AECC07E676640A85ECF359EAF4940FCF141169C67664068557BE0BCB049403A91ECC0E267664018E8CF350EB24940D6E041167662664010E8CF350EBA4940222AECC0DE616640740AD035DABB4940A6CF4116506166402C04258B0FBD4940AACF4116406166402404258BCFBD49407F4CECC01A61664003CC7AE0CCBE494004F24116DC606640985ECF351EC049404CAD411674606640E348258B27C14940242AECC09E5F664030B6D035D6C249406830976BB95E6640B8107BE064C54940A9CF4116205E6640304FD03572C6494078BE4116EA5B6640D8B2CE3522C9494048AD4116D45A66401804258BCFC949407230976B99596640780AD0351AC949401C9C41160E5966406C557BE03CC949403891ECC0F2586640780AD0359ACA4940160E976B1D586640780AD0359ACA4940D6E0411686576640A05ECF35DECA4940CE52976B05576640E393D035CACB4940D6E04116765666408371D035BECD4940AACF411610566640D0FD79E0C4CE4940140E976B5D5466404FD2258B97D14940CC52976B5555664048D2258BD7D34940F28A4116D8556640680AD0355AD449404CAD411614576640FC35248B47D24940160E976B9D586640E4B2CE35E2D1494001030000000100000014000000DE6EECC06647664074BF248B77EA4940DB6EECC09647664018E8CF354EEA4940120E976BCD476640677479E054EA4940300342161248664098F7CE353AEA49403691ECC0B2486640700AD0359AE949407230976B094A664040877AE034E94940A6CF4116B04A664088F7CE357AE84940D3E04116364B6640E093D0354AE74940160E976BAD4C6640A45ECF355EE2494030034216324C664094427AE0DCE24940F08A4116684B664088F7CE353AE24940120E976BED4A6640A45ECF355EE249406E30976B994A6640780AD0351AE349407230976BF9496640CFB2CE3562E54940EE8A4116B84966407C0AD035DAE54940DC6EECC026496640AC5ECF355EE6494048AD411654486640DFB2CE35A2E7494032034216924766403CB6D03556E949402D03421632476640700AD0351AEB4940DE6EECC06647664074BF248B77EA49400103000000010000000D0000008F41BEE9555866C0DC93D0354AE04940D1B56894DD5966C0D048258BA7DF494000C76894535A66C0D793D035CAE04940A4A46894F75A66C0CF2CD035E6E249408E41BEE9755B66C0204FD035F2E44940BB52BEE97B5B66C07C0AD035DAE54940F838BEE9125B66C0E448258B27E74940E71C6994A15A66C01F4FD035B2E94940244ABEE9085A66C0F880CF356AEB4940B4C4133F2B5966C098F7CE353AEA494000C76894F35766C0D02CD035A6E849405DE96894AF5766C014E8CF354EE449408F41BEE9555866C0DC93D0354AE049400103000000010000002F000000816CBEE9540B66C0700AD0351AEB4940816CBEE9540B66C098F7CE353AEA49405F30BEE90F0B66C008CC7AE04CEA4940EA63BEE9810A66C0D0B2CE3522EA4940CA27BEE93C0A66C098F7CE353AEA4940254ABEE9680A66C07F71D0353EE84940321FBEE9790A66C030D5CE35AEE74940B90B69948B0966C0D02CD03526E949404E1469940E0966C0EC93D0354AE9494021036994780866C088F7CE357AE8494021036994780866C030D5CE35AEE749409B16BEE9A60866C090F7CE353AE74940040EBEE9C30866C023B979E0ACE64940254ABEE9D80866C038D5CE35EEE54940D2B56894ED0866C0C02CD035E6E44940EA63BEE9710866C07871D0353EE449408C41BEE9450866C098427AE01CE449408C41BEE9450866C068557BE03CE349401875BEE9C70866C068BF248B37E34940A3A46894270966C0A45ECF355EE24940C4E068945C0966C088427AE0DCE04940D2B568945D0966C0975ECF35DEDE49403BAD68949A0966C0975ECF35DEDE49403AAD6894DA0966C00CE8CF354EE04940B60B69941B0A66C02F4FD035F2DF4940FFC66894930A66C093F7CE357ADD49409B16BEE9E60A66C0D848258BE7DC4940E51C6994410B66C0677479E0D4DE4940C727BEE98C0B66C0F880CF35EADD49401875BEE9E70B66C007CC7AE04CDE49409C16BEE9560C66C06C0AD0355ADE49407D256994B40C66C064A3CF35F6DE4940C4E06894DC0C66C0FFCB7AE00CE149402FD86894190D66C027D5CE356EE94940C5E06894EC0C66C043B6D03516E94940AF7DBEE99A0C66C070557BE0BCE84940E61C6994710C66C088F7CE357AE849403AAD6894AA0C66C0DCFD79E0C4E949402DD86894890D66C034D5CE35EEEC4940F538BEE9920C66C09BF7CE357AEE4940BD52BEE91B0B66C0740AD0355AEF4940040EBEE9B30966C088F7CE353AEF4940D2B56894ED0866C068BF248BB7ED4940D2B568945D0966C0948D258BFFEB49403BAD6894FA0966C08471D0357EEB4940B07DBEE9AA0A66C01417268B6FEB4940816CBEE9540B66C0700AD0351AEB494001030000000100000033000000D2B56894DD0366C0D42CD03566EC4940806CBEE9940366C038B6D03556EB4940F4F16894720366C050877AE074EC49406C05BEE9000366C0CF2CD035E6ED4940F838BEE9020266C00F17268B6FED4940A2A46894F70066C024B979E0ECEB4940D7FCBDE95D0066C098F7CE353AEA4940AF7DBEE99A0066C027D5CE356EE94940B07DBEE9FAFF65C037D5CE35EEE749408D41BEE9B5FF65C030D5CE35AEE7494000C76894F3FF65C090F7CE35BAE649409A16BEE9D60066C0B0C5CF3542E949408E41BEE9050166C098F7CE353AEA494096CF6894960166C0707479E094E94940BD52BEE91B0266C0D02CD035A6E94940501469941E0366C098F7CE353AEA4940A2A46894670366C0E893D035CAE94940B80B69945B0366C030D5CE35AEE84940F3F16894020366C07C0AD035DAE549404F1469947E0366C0DFFD79E044E649408AFA6894E50366C0A87A248B1FE749405F30BEE92F0466C00717268B6FE849409B16BEE9560466C098F7CE353AEA49405DE96894BF0466C0244FD035B2E8494069BE6894E00466C08CF7CE35FAE64940301FBEE9C90466C0C72CD03526E54940301FBEE9890466C068557BE03CE34940E963BEE9C10466C068557BE03CE34940AE7DBEE9DA0466C064A3CF35B6E3494096CF6894160566C010E8CF354EE54940E963BEE9310566C07C0AD035DAE549409A16BEE9360566C060A3CF3536E64940C3E068942C0566C030B6D03556E74940E963BEE9310566C030D5CE35AEE74940FEC66894530566C040D2258BD7E74940BC52BEE99B0566C0F035248BC7E7494098CF6894360666C048877AE0F4E849403AAD6894AA0666C058A3CF35F6E84940F2F16894020766C0E4FD79E084E94940254ABEE9280766C090F7CE35FAEB494069BE6894700666C0D0B2CE35A2EB49404E1469945E0666C0D048258BA7EC4940D5FCBDE9BD0666C08071D035FEEE4940B90B69948B0666C0DFFD79E0C4F0494088FA6894150666C09C8D258B7FF149406ABE6894900566C0443CCF3552F14940E963BEE9310566C050D2258B57F04940F638BEE9620466C02BD5CE352EEF4940321FBEE9190466C040D2258B97EE4940321FBEE9190466C0D0FD79E004EE4940D2B56894DD0366C0D42CD03566EC494001030000000100000015000000AF7DBEE99A0066C023B979E02CF249408D41BEE9B5FF65C074BF248B37F149407D25699494FF65C0DBFD79E084F14940F638BEE932FF65C0403CCF35D2F249404F1469940EFF65C05CA3CF35F6F24940D3B56894CDFE65C08471D035BEF149403BAD6894AAFE65C060BF248BF7EF4940D4FCBDE99DFE65C00817268B2FEE49404E1469949EFE65C034D5CE35EEEC4940FFC6689443FF65C07C0AD0351AED4940F4F16894720366C074BF248B37F149407D256994F40266C08871D0357EF2494021036994580266C01017268BAFF349404E146994AE0166C0F419CF3586F44940B90B6994AB0066C030B6D035D6F449407C256994540066C0EC93D035CAF44940EB63BEE9010066C08871D0357EF449408D41BEE9B5FF65C00781CF35EAF3494020036994F8FF65C0DF19CF35C6F34940AF7DBEE99A0066C05CA3CF35F6F24940AF7DBEE99A0066C023B979E02CF2494001030000000100000049000000D5FCBDE90D3B66C0E093D0350AED494097CF6894E63A66C0700AD0351AEB49406030BEE9AF3666C02CB979E02CEB4940D4FCBDE9BD3466C08471D0357EEC4940244ABEE9E83366C068BF248BB7ED4940D6FCBDE90D3466C0503CCF3592EA4940A1A46894B73466C0F419CF3506E94940B07DBEE99A3566C0E4FD79E084E84940501469946E3666C088F7CE357AE84940E963BEE9413766C058A3CF35F6E749404D146994CE3866C04C877AE0F4E54940BA52BEE99B3966C07C0AD035DAE54940F2F16894823966C0C82CD035A6E4494000C76894533966C004CC7AE0CCE3494068BE6894103966C0503CCF3552E34940C4E06894BC3866C068557BE03CE34940D6FCBDE97D3966C038D5CE352EE14940B80B6994CB3966C01017268B6FDF494096CF6894D63966C008CC7AE04CDD4940545BBEE9CE3966C0E719CF3506DA49404F146994EE3966C0B7C5CF3502D94940CA27BEE9CC3A66C0204FD03572D64940E71C6994213B66C08F8D258BFFD549403AAD68948A3B66C0E048258B67D649406ABE6894403C66C0E393D035CAD7494000C76894533C66C044B6D03556D649405CE968948F3C66C08071D0357ED54940301FBEE9E93C66C0D8B2CE3522D549401675BEE9573D66C028B979E02CD54940AE7DBEE91A3D66C0E0B2CE3562D449406D05BEE9503D66C0700AD0359AD24940A2A46894373D66C0BCC5CF35C2D04940B07DBEE9AA3C66C010E8CF354ECD4940040EBEE9033D66C018E8CF358ECC4940E61C6994713D66C0700AD0355ACC4940545BBEE9DE3D66C0E3B2CE35A2CC49401975BEE9373E66C010E8CF354ECD4940C827BEE95C3E66C034D5CE352ECE49408AFA6894853E66C0DF48258BA7D049401775BEE9A73E66C04FD2258B97D149401875BEE9273F66C0607479E094D24940B90B69945B4066C060A3CF35F6D24940321FBEE9094166C0E0B2CE3562D44940D2B568946D4166C0284FD03532D54940040EBEE9A34266C0F8CB7AE0CCD449404E1469943E4366C028B979E02CD549406C05BEE9F04266C0B0107BE064D84940545BBEE98E4266C0C4107BE0A4D949406ABE6894F04066C0985ECF359ED94940BD52BEE99B4066C0C02CD035E6D94940E71C6994114066C0740AD0351ADB49405CE968942F3F66C06F7479E094DB4940E51C6994D13E66C09CF7CE353ADC4940D6FCBDE98D3E66C0483CCF3552DD49403AAD68946A3E66C0975ECF35DEDE4940F1F16894923E66C0C4C5CF35C2E14940AE7DBEE92A3F66C0A85ECF359EE349409A16BEE9F63F66C08C427AE09CE44940B07DBEE97A4166C010E8CF354EE54940C4E06894FC4166C07B0AD0355AE64940B80B69940B4366C027D5CE356EE949406C05BEE9104666C00F17268B6FED4940A2A46894D74666C0D8B2CE3522F0494039AD6894AA4566C00781CF35EAF34940B07DBEE9BA4466C0707479E014F54940244ABEE9783E66C0A85ECF355EF64940CA27BEE9CC3D66C043B6D03596F54940CA27BEE9CC3D66C05FA3CF35B6F449401975BEE9A73C66C03F3CCF35D2F149406ABE6894403C66C074BF248B37F149406ABE6894403C66C050D2258B57F049406C05BEE9903C66C09BF7CE35FAEE4940D5FCBDE90D3B66C0E093D0350AED49400103000000010000000D000000D0B568945D2E66C0D7777BE008F24940F738BEE9A22E66C08871D035FEF14940B4C4133FBB2E66C007CC7AE08CF249401775BEE9E72E66C00481CF352AF349407D256994F42E66C028B979E0ECF349403AAD68948A2E66C00017268B2FF64940E41C6994612E66C054877AE074F649406030BEE9BF2D66C0C8777BE088F549408C41BEE9A52D66C0C89679E0E0F44940BD52BEE99B2D66C060A3CF3536F44940A3A46894872D66C008E8CF358EF34940A2A46894972D66C0B8C5CF3502F34940D0B568945D2E66C0D7777BE008F249400103000000010000004F000000BD52BEE93B2466C0F019CF3586DD4940FFC66894032566C0985ECF359ED94940311FBEE9292666C0E019CF35C6DA49408E41BEE9852666C0A85ECF355EDB4940A3A46894772666C0B8C5CF3582DA49403AAD68947A2666C09B427AE0DCD9494001C76894832666C0E093D0354AD949408E41BEE9852666C0F880CF35AAD849402CD86894292766C090F7CE353AD949402DD86894F92766C050A3CF35F6D74940F3F16894E22866C017E8CF350ED74940EA63BEE9D12966C0F880CF35AAD849407F6CBEE9142A66C098F7CE35FAD74940321FBEE9392A66C03CD5CE35EED749402DD86894792A66C0F880CF35AAD84940E51C6994812A66C090427AE0DCD849402FD86894E92A66C00881CF356ADA49403AAD68946A2B66C0B87A248BDFDB4940D3B56894DD2B66C0E048258BA7DC494088FA6894552C66C088F7CE35FADC4940826CBEE9F42D66C0F780CF35EADC4940321FBEE9892E66C0D893D0358ADC49409C16BEE9F62E66C0D0FD79E0C4DB4940FDC66894832F66C07C0AD0355ADA494097CF6894F62F66C0E719CF3506DA4940C3E068940C3166C00881CF356ADA4940A1A46894273366C02C4FD035F2D9494088FA6894253466C0FB35248B87D849406ABE6894903466C098427AE09CD54940C827BEE9BC3466C00CE8CF35CED34940545BBEE91E3566C0607479E094D349406E05BEE9803566C0985ECF355ED44940D1B56894AD3566C098427AE09CD5494020036994B83566C0700AD035DAD64940D5FCBDE9DD3566C050D2258BD7D74940F638BEE9223666C08371D035BED84940C827BEE98C3666C0985ECF359ED94940C827BEE98C3666C00881CF356ADA49408AFA6894053666C0D02CD03526DB49409C16BEE9163566C027D5CE356EDD4940525BBEE9AE3466C0F880CF35EADD4940B07DBEE90A3466C0BF107BE0A4DD4940A2A46894D73266C00717268B6FDC4940F738BEE9423266C00081CF352ADC4940B90B6994BB3066C00081CF352ADC4940B90B69949B3066C044B6D03596DC4940C4E068949C3066C0DFFD79E084DD49405E30BEE98F3066C0344FD03572DE4940244ABEE9483066C0975ECF35DEDE49406D05BEE9302F66C0975ECF35DEDE49403BAD68941A2F66C0B0107BE024DF4940F3F16894022F66C077557BE0BCDF49401875BEE9D72E66C038B6D03556E049402DD86894892E66C09C427AE09CE0494021036994682C66C08071D0357EE14940BB52BEE95B2966C0344FD03532E4494089FA6894E52666C01BE8CF35CEE849408E41BEE9852666C0D4B2CE3562EF49406ABE6894602666C050A3CF3576F04940E51C6994412666C0403CCF3552F349408C41BEE9152666C05FA3CF35B6F4494020036994382666C0E393D0350AF74940CA27BEE98C2566C0BCC5CF35C2F74940244ABEE9E82366C0F880CF356AF74940E41C6994312366C040B6D03516F749407F6CBEE9642266C050D2258B17F649406030BEE9BF2166C048877AE074F449405CE968947F2166C023B979E02CF24940816CBEE9F42166C0B8107BE0A4F149407C256994242266C050D2258BD7F04940AE7DBEE92A2266C0DF48258BE7EF49409B16BEE9262266C08071D035FEEE49406C05BEE9602266C030D5CE35EEED494098CF6894E62366C090F7CE35FAEB4940E963BEE9612466C04B3CCF3552E9494069BE6894202466C004CC7AE04CE449404F1469948E2466C070557BE07CE1494096CF6894162466C028B979E0ACDF4940BD52BEE93B2466C0F019CF3586DD4940010300000001000000140000001BBC133FC8F965C06458248B53FA49409188133F76F965C0189D248B2BF949406C05BEE920F965C0BF9679E020F749403CAD6894FAF865C050D2258B97F64940806CBEE9A4F865C08F427AE09CF649404BCD133F6EF865C0C09679E020F64940A2A4689497F865C0B87A248B5FF54940D2B568944DF965C054A3CF3536F54940321FBEE9C9F965C077DB79E0F8F54940B70B69943BFA65C0AC13248B3BF64940311FBEE989FA65C088DB79E0B8F64940050EBEE9A3FA65C040877AE034F749409916BEE9E6FA65C0E7647AE0E8F749402CD8689449FB65C0E093D0358AF8494050146994FEFB65C020337BE0F0F84940535BBEE9AEFB65C08071D035FEF94940A05D133F47FB65C09813248B3BFA4940030EBEE9F3FA65C0F035248B07FA494055A2133F4FFA65C0B37A248BDFFA49401BBC133FC8F965C06458248B53FA494001030000000100000009000000B2C4133F0B0366C0D4FD79E084F94940E61C6994010466C03B6B258B33F94940BF99133F3C0466C07826258B5BF94940EB63BEE9510466C0E719CF35C6F94940C4E068946C0466C0DC48258BA7FA49406C05BEE9100466C0406B258BF3FA4940AE7DBEE98A0366C00BCC7AE00CFB4940A2A46894E70266C08071D035FEFA4940B2C4133F0B0366C0D4FD79E084F949400103000000010000000D0000007F6CBEE9A4F665C0D848258BA7FC49408E41BEE9B5F565C0F319CF35C6FB49405BE968942FF565C00436248BC7FB49405BE968942FF565C06F7479E0D4FA494096CF689486F665C0E448258BE7F94940BC52BEE9BBF665C07C0AD0359AF949406E05BEE9E0F665C094F7CE35FAF74940BB52BEE93BF765C028D5CE356EF74940B80B6994ABF765C0B07A248B9FF7494068BE689410F865C05BA3CF3536F849404E146994DEF765C0D42CD03566F94940BC52BEE92BF765C0D848258BA7FC49407F6CBEE9A4F665C0D848258BA7FC494001030000000100000007000000C927BEE9CCED65C0F880CF35AAFD49407C25699484EE65C0D0E1248B43FD4940E3D5133FD1EE65C097F7CE35FAFD4940050EBEE9A3EE65C03CD5CE356EFE494056A2133F5FEE65C06CBF248B77FE4940EA63BEE941EE65C074BF248B37FE4940C927BEE9CCED65C0F880CF35AAFD49400103000000010000008C0000003BAD6894EA1166C00417268BEFFA4940D5FCBDE9ED1166C0D8FD79E044F9494022036994B81166C094F7CE35FAF74940816CBEE9441166C0F880CF356AF74940826CBEE9941166C0C4C5CF3502F54940B60B69940B1266C0A85ECF355EF44940B80B69949B1266C0B87A248B5FF44940A4A46894371366C00781CF35EAF3494068BE6894901366C0985ECF359EF24940AD7DBEE9CA1366C0503CCF35D2F049405F30BEE90F1466C07871D0353EEF49409C16BEE9861466C040D2258B97EE49409C16BEE9861466C068BF248BB7ED4940E963BEE9D11266C068BF248BB7ED49406130BEE90F1366C06CBF248BB7EC4940F638BEE9221366C0F019CF3506EC4940331FBEE9191366C017E8CF354EEB49407E256994041366C098F7CE353AEA49408E41BEE9351266C0C82CD03566EB49407E256994941166C0344FD035F2EA49407C256994F41066C0344FD035F2E9494021036994281066C027D5CE356EE9494021036994281066C098F7CE353AEA49406ABE6894601066C098F7CE353AEA49406D05BEE9201066C0E4B2CE3562EB4940BC52BEE9BB0F66C0948D258BFFEB4940254ABEE9D80E66C034D5CE35EEEC4940AE7DBEE91A0E66C0B8C5CF35C2EB49405CE96894AF0D66C0E793D035CAEA4940816CBEE9A40D66C0677479E0D4E94940535BBEE9CE0D66C04C3CCF3552E84940E71C6994B10D66C0C02CD035E6E64940050EBEE9A30D66C06FBF248BB7E54940D6FCBDE9FD0D66C0C02CD035E6E44940F638BEE9E20D66C04CD2258B97E349406D05BEE9C00D66C0FF80CF356AE249406C05BEE9900D66C0E048258B67E14940C4E068944C0D66C09C427AE09CE04940BC52BEE9AB0D66C0D748258BE7DE4940D1B568948D0E66C0888D258B7FDD49406E05BEE9100F66C00081CF352ADC49407D256994B40F66C0E093D0358AE04940BB52BEE9BB1066C0F880CF35EADE4940E963BEE9D11266C0E393D035CAD74940535BBEE9FE1266C0680AD0351AD94940D1B568943D1366C038D5CE35EED94940AE7DBEE98A1366C0D42CD03526DA49407D256994E41366C0985ECF359ED94940C4E06894AC1366C0F880CF35AAD849408C41BEE9251466C0483CCF3592D84940B80B69948B1466C00C81CF35EAD74940C927BEE9DC1466C028D5CE352ED749403CAD68941A1566C040B6D035D6D64940B07DBEE97A1566C0C82CD03526D74940EA63BEE9E11566C07871D035BED74940C927BEE94C1666C0AC7A248B1FD84940B60B6994BB1666C0E393D035CAD7494021036994081766C0D7B2CE35A2D54940D3B568942D1766C0AC5ECF351ED449407C256994141766C024B979E06CD34940EA63BEE9C11666C00481CF35EAD24940535BBEE99E1666C040877AE0B4D1494069BE6894A01666C070557BE03CD04940B60B6994BB1666C088F7CE35FACE4940AF7DBEE90A1866C04FD2258B97D14940525BBEE9AE1866C02C04258B4FCF49403BAD68941A1966C0284FD03572CE4940A3A46894971966C034D5CE352ECE49405F30BEE90F1A66C0EC93D035CACE49407D256994641A66C087F7CE35FACF49406130BEE95F1A66C0A05ECF351ED149405CE96894CF1966C04FD2258B97D149405CE96894CF1966C00FE8CF358ED2494022036994381A66C070BF248B77D44940E61C6994811A66C0888D258B3FD64940C727BEE98C1A66C0B0107BE064D849405CE968943F1A66C0A85ECF355EDB4940A2A46894771A66C00081CF352ADC4940BD52BEE9AB1C66C04FD2258B97D1494001C76894E31C66C0908D258B3FD049403AAD68941A1D66C0B8C5CF3582CE494022036994581D66C0988D258BFFCC4940816CBEE9A41D66C0700AD0355ACC49401975BEE9771E66C004CC7AE0CCCB4940254ABEE9081F66C08F427AE0DCCB4940AE7DBEE94A1F66C03FB6D035D6CC49401775BEE9371F66C0677479E0D4D249404E146994EE1E66C0CC2CD035A6D549404F146994DE1C66C0985ECF359ED949403BAD68947A1C66C0CC2CD035E6DA494038AD68943A1C66C044877AE034DC4940FFC66894231C66C08C71D035BEDD4940BB52BEE93B1C66C0D048258BA7DF4940F638BEE9921B66C077557BE0BCDF4940BD52BEE95B1B66C0D048258BA7DF4940040EBEE9731B66C098F7CE353AE04940515BBEE98E1B66C09C427AE09CE049405CE968943F1A66C0A45ECF355EE249405CE968943F1A66C068557BE03CE34940020EBEE9F31A66C00CCC7AE00CE34940B07DBEE9BA1B66C0FF80CF356AE24940331FBEE9791C66C0284FD03532E2494097CF6894161D66C068557BE03CE3494021036994481D66C0A05ECF355EE54940040EBEE9F31C66C0AB5ECF355EE7494098CF6894561C66C0780AD035DAE84940D2B56894AD1B66C027D5CE356EE94940BD52BEE95B1B66C09CF7CE35BAE849409A16BEE9161B66C00481CF352AE74940D3B56894AD1A66C087427AE09CE54940D4FCBDE9ED1966C0C02CD035E6E449406130BEE93F1766C04CD2258B17E4494021036994881666C0C02CD035E6E449401775BEE9171766C0607479E0D4E549406E05BEE9301866C0670AD0351AE74940BC52BEE99B1866C044B6D03516E849407C256994F41866C0A05ECF351EEA49402ED86894E91866C024B979E0ECEB4940CA27BEE98C1866C08BF7CE353AED4940E61C6994F11766C068BF248BB7ED4940A3A46894971666C0EC93D0350AEE4940A2A46894471866C0C72CD03526F149406030BEE9EF1866C02C04258B4FF449407B256994041966C0985ECF35DEF74940A4A46894D71866C0C4107BE0E4F849401875BEE9471866C0DF93D0350AFA4940B80B6994BB1766C00881CF35AAFA4940D1B568941D1766C0304FD035F2FA4940B80B6994DB1566C06F7479E0D4FA4940F838BEE9221566C0B0C5CF3502FA4940E963BEE9C11466C0747479E0D4F94940D3B568946D1466C02FD5CE356EFA4940501469940E1466C04F3CCF35D2FC49407D256994E41366C040877AE074FD49403BAD68945A1366C010E8CF354EFE4940D6FCBDE9AD1266C034D5CE35AEFE4940E41C6994011266C02C4FD03572FE49401675BEE9771166C040877AE074FD4940826CBEE9B41166C0D848258BA7FC49403BAD6894EA1166C00417268BEFFA4940010300000001000000110000005CE96894FFFB65C00036248B47FF4940F4F16894C2FB65C0C02CD03566FE4940AD7DBEE93AFB65C0483CCF3592FE49408F41BEE9B5FA65C0543CCF3512FF4940331FBEE939FA65C090F7CE353AFF4940AE7DBEE9CAF965C0C02CD03566FE4940B70B69940BFC65C0E019CF3506FC4940E61C699421FD65C008E8CF35CEFB494098CF689466FE65C0D848258BA7FC4940D0B568940DFE65C0E0FD79E044FE4940C4E068946CFD65C0D32CD035A6FE4940B80B6994BBFC65C08471D0353EFE4940F2F1689432FC65C040877AE074FD4940C6E068942CFC65C018E8CF350EFE4940545BBEE91EFC65C00C17268B6FFE4940535BBEE90EFC65C00036248BC7FE49405CE96894FFFB65C00036248B47FF49400103000000010000001A000000D3E0411636516640F019CF35C6F249407230976B8950664060A3CF35B6F24940C952976B155066402C4FD03572F34940CC52976B154F66402404258B8FF649400C0E976BDD4E6640F880CF356AF74940E78A4116B84E6640E0B2CE35E2F849403891ECC0D24E664087427AE0DCF949402E034216024F6640F035248B07FB494070BE41161A4F664018E8CF350EFD4940D2E04116464F6640344FD03532FE4940B0EB966BB14F664008CC7AE08CFE4940320342163250664060A3CF35B6FE4940B3EB966BA15066400036248B47FF494004F24116BC506640E093D035CAFE4940D1E04116D650664037B6D03596FE4940D2E0411616516640C02CD03566FE49407130976B59526640D0B2CE35E2FC4940CA52976BE55266400017268BEFFB4940D4E0411646536640DF93D0350AFA4940D5E0411656536640F019CF3506F849404AAD41161453664028D5CE35EEF649404CAD4116A45266402404258B0FF64940120E976B2D5266405FA3CF35B6F44940AACF4116605266400781CF35EAF349404DAD4116E4516640E093D0354AF34940D3E0411636516640F019CF35C6F249400103000000010000002A00000003F241167C7566400036248B47F0494002F241168C746640C0107BE0E4EF49403691ECC0227266402304258B4FF149407230976BD9716640334FD035B2F1494044AD41169471664007CC7AE08CF2494078BE4116BA706640A85ECF355EF44940B6EB966BF16F66400CCC7AE04CF549406FBE4116EA6F664014E8CF358EF64940CA52976B15706640BCC5CF35C2F74940D4E04116367066405BA3CF3536F84940189C41161E7066409B427AE09CF94940804CECC0FA6F66408871D035BEFA4940824CECC0CA6F664068BF248BB7FB49401E9C41168E6F6640D848258BA7FC4940B3EB966BE16F6640FC16268B2FFD4940D6E041168670664063A3CF3536FD49401E9C4116DE70664040877AE074FD4940150E976BDD71664070557BE03C004A402E034216627266401804258B8F004A402C0342162273664088F7CE357A014A40B0EB966BE17366403CB6D035D6024A403203421662746640F019CF3586044A40DC6EECC096746640E3B2CE35E2034A40DA6EECC0C67466405FBF248BB7034A40B8EB966B41756640C42CD035A6034A40B0EB966B71756640E393D0358A024A40D3E04116A6756640C4C5CF3502024A40B3EB966BE1756640C0107BE0A4014A40D4E04116267666400336248B07014A40B0EB966B01776640C02CD03566FE4940B6EB966B81776640E493D0354AFD494070BE4116FA776640A85ECF359EFC4940120E976BFD7866400436248BC7FB49400B0E976BCD786640F8CB7AE04CFA4940BAEB966B717866409B427AE01CF9494005F241161C786640E819CF3546F84940212AECC0FE7766402804258BCFF7494000F241162C786640700AD0351AF649404CAD4116E477664028B979E0ECF44940AACF4116207766402C4FD03572F349404EAD41166476664097F7CE357AF1494003F241167C7566400036248B47F0494001030000000100000021000000BC52BEE9DBFF65C060BF248B37044A402ED8689489FF65C0E3B2CE3562034A4096CF6894D6FE65C0F019CF3586044A40050EBEE933FF65C017E8CF35CE024A401875BEE9F70066C0C0107BE0A4014A40AE7DBEE97A0166C00036248B47FF4940C4E06894EC0066C077557BE07CFF494050146994AE0066C02004258BCFFE4940F838BEE9B20066C08C427AE09CFD4940C4E06894EC0066C068BF248B37FC494069BE6894600166C01804258B4FFB4940264ABEE9D80166C0E4FD79E0C4FB4940F2F16894920266C040877AE074FD494050146994EE0366C018E8CF350EFF49406477133F700466C00036248B47FF494068BE6894700466C00036248B47FF49402ED86894F90466C0D048258B67FF494097CF6894460566C0403CCF35D2FF494089FA6894750566C0BF107BE0A4004A407D256994140666C034D5CE35EE044A402CD86894390666C0E093D0358A064A406130BEE92F0666C0B87A248B9F074A40D3B56894FD0566C058A3CF35B6084A40D4FCBDE99D0566C098F7CE357A0B4A402ED86894690566C06CBF248B770C4A408AFA6894950466C060A3CF35B60D4A405AE968945F0366C020B979E02C0E4A40F538BEE9320266C0F035248BC70D4A40AE7DBEE97A0166C06CBF248B770C4A40B90B69942B0066C027D5CE35AE084A4000C76894F3FF65C0B87A248B9F074A4000C76894F3FF65C090F7CE35FA054A40BC52BEE9DBFF65C060BF248B37044A4001030000000100000044000000DC6EECC076326640677479E094FE494006F241160C3266404F3CCF3552FD49401C9C4116BE31664050A3CF35F6FB49402803421662326640DF93D0350AFA49401A9C41167E3366400481CF35EAF9494006F24116AC3366407C0AD0359AF949406C30976BA933664017B979E0ECF74940D5E0411696336640EB19CF35C6F649404BAD4116643366407771D0357EF649404AAD411604336640F880CF356AF749402E03421692326640F880CF356AF64940D96EECC05632664040877AE0B4F5494076BE41162A3266405FA3CF35B6F44940CE52976BC53166403CB6D035D6F54940140E976B3D316640483CCF35D2F649401C9C4116AE306640F880CF356AF74940140E976B2D306640F880CF356AF74940A4CF4116D02F664068557BE07CF649401A9C41168E2F66408071D0353EF5494076BE41164A2F664098427AE0DCF4494032034216E22E664064A3CF3576F64940CC52976B152F66405BA3CF3536F8494002F241163C2D6640B07A248B1FF749401C9C41168E2C6640B87A248BDFF54940D4E04116B62B6640908D258BBFF44940D2E04116562B6640304FD035B2F249404AAD4116B42A664094F7CE357AEB4940DA6EECC0962A664098F7CE35BAEA49407E4CECC05A2A6640677479E0D4E949404AAD4116242A6640707479E014EA4940BAEB966BD1296640D0B2CE3522EB49404BAD4116842966400481CF356AEC4940B6EB966B61296640543CCF3552ED4940B6EB966B11296640CF2CD03566EE494004F241169C276640E893D0350AF14940150E976B2D27664023B979E02CF24940D5E0411666296640E493D0350AF649403A91ECC0222A664064A3CF3576F64940D2E04116862A6640888D258BFFF64940B3EB966BE12A6640E893D0354AF84940EB8A4116782B664008E8CF354EFB494002F24116EC2B6640C0C5CF35C2FC49407D4CECC06A2C6640C0C5CF3542FD4940140E976B8D2D664040877AE074FD4940A4CF4116402E6640F019CF3546FE49406830976B892E6640C02CD03566FE49407E4CECC04A2F664010E8CF354EFE4940C952976B852F6640C02CD03566FE4940CA52976B4530664010E8CF354EFF4940CA52976B85306640A87A248B1F004A401A9C4116DE30664053877AE074044A40824CECC0CA316640A05ECF35DE0A4A407030976BB931664040D2258B570D4A40120E976BFD326640C0C5CF3502104A40BAEB966BB1336640C02CD035A6104A40A5CF41169034664064A3CF35F60F4A403091ECC0823566401CB979E06C0E4A40B6EB966BE1356640284FD035720D4A40F28A411618366640B8C5CF35820B4A404EAD4116D4356640670AD0359A0A4A40262AECC03E356640F880CF35AA094A40AACF411600356640BF107BE0E4084A40CC52976BD5346640D8B2CE35A2074A40AACF4116C034664034B6D03596054A40A5CF411690346640F019CF3586044A40A6CF41161034664098F7CE353A034A4076BE41162A32664070557BE03C004A40DC6EECC076326640677479E094FE494001030000000100000078000000E863BEE9F1B265C060A3CF3576134A402203699468B265C0D42CD03566124A40321FBEE989B165C0DFB2CE35E2124A405CE96894FFB065C010E8CF358E124A405AE968946FB165C050D2258B170F4A406030BEE9FFB065C064A3CF35F60F4A40B07DBEE9AAB065C0B0C5CF35C20E4A40E61C699441B065C0F035248B470E4A40030EBEE9C3AD65C098427AE05C0E4A40F738BEE982AD65C0274FD035F20E4A40040EBEE943AD65C050D2258B170F4A40E71C699411AD65C04C3CCF35D20E4A402003699408AD65C064BF248B370E4A403AAD6894FAAC65C0A45ECF359E0D4A401775BEE9B7AC65C040D2258B570D4A401875BEE9D7AB65C0CB2CD035E60D4A409A16BEE986AB65C058A3CF35760D4A40C6E068944CAB65C0B8C5CF35820B4A407E25699494AA65C0D0FD79E0C40C4A40AF7DBEE9BAA965C0EC93D035CA0D4A409C16BEE9D6A865C0A85ECF355E0E4A4068BE689400A865C00CCC7AE04C0E4A40AD7DBEE9FAA765C00436248B070E4A40D0B56894DDA765C00881CF356A0D4A408E41BEE9B5A765C0E019CF35C60C4A406ABE689490A765C06CBF248B770C4A40C827BEE94CA765C0F8CB7AE08C0C4A40B07DBEE9EAA665C0E0B2CE35220D4A4068BE6894B0A665C040D2258B570D4A40CA27BEE90CA565C040D2258B570D4A40501469947EA465C0C4C5CF35020E4A405F30BEE92FA465C09BF7CE353A0E4A40F638BEE9F2A365C04C3CCF35D20D4A408D41BEE9A5A365C068BF248BF70C4A406E05BEE940A365C0737479E0940C4A408D41BEE9959E65C0B8C5CF35820B4A40525BBEE92E9F65C073557BE0BC0A4A40AF7DBEE98AA065C0204FD035720A4A409916BEE916A165C0A05ECF355E094A40244ABEE9A8A165C0F419CF35C6084A40AD7DBEE94AA365C02804258B8F094A40254ABEE978A465C0AFC5CF3582074A409A16BEE946A565C057A3CF3536074A40040EBEE913A665C0F035248B87074A4022036994D8A665C0BCC5CF3502094A40E41C699441A765C09C8D258B7F094A40F4F16894A2A765C0344FD035B2094A40D2B56894CDA765C0A05ECF355E094A40C5E06894ECA765C0780AD0351A084A40816CBEE934A865C04C3CCF3512084A40030EBEE9C3A865C0BF107BE0E4084A40030EBEE9D3A965C0B87A248B1F084A40C5E068940CAC65C060A3CF35F6044A40040EBEE943AD65C0F019CF3586044A40020EBEE963AE65C038D5CE35AE054A4069BE6894D0AE65C090F7CE357A054A40535BBEE91EAF65C0F835248BC7044A40535BBEE97EAF65C00C81CF352A034A406030BEE9AFAF65C0EC19CF35C6024A407D25699404B065C018B979E0EC024A406D05BEE980B065C0C02CD03526044A40F738BEE9C2B065C0F019CF3586044A40A2A4689437B165C0344FD03572044A40254ABEE998B165C09F5ECF351E044A40F538BEE9F2B165C068557BE0FC034A405CE968944FB265C0F019CF3586044A402CD86894D9B165C05CA3CF35B6054A40F638BEE942B265C05CA3CF3536064A4000C76894D3B565C0E819CF3546064A40D5FCBDE9ADB565C0CC2CD03526074A4098CF689496B565C0DF19CF3506084A40AC7DBEE90AB665C0BF107BE0E4084A407C256994E4B665C0EC93D0350A074A40234ABEE9F8B765C0AC5ECF351E064A4067BE6894C0BA65C000CC7AE08C054A408D41BEE965BC65C087F7CE353A074A40E51C699481BD65C0780AD0359A074A40E41C6994C1BD65C070557BE07C084A40D4FCBDE97DBD65C073BF248BB70A4A40321FBEE9C9BD65C033D5CE352E0B4A403BAD68949ABE65C0B8C5CF35820B4A40F638BEE9E2BE65C00C17268BEF0B4A402103699468BF65C068BF248BF70C4A40F3F16894B2BF65C040D2258B570D4A403CAD6894EABF65C098427AE05C0D4A403AAD68947AC065C0CF2CD035260D4A40331FBEE9C9C065C040D2258B570D4A406E05BEE910C165C0D8B2CE35E20D4A40D2B568949DC165C0B7107BE0640F4A409A16BEE9E6C165C064A3CF35F60F4A406ABE6894E0C165C0F019CF3586104A409B16BEE9D6C165C0F780CF35EA104A408AFA6894C5C165C0E819CF3546114A402DD86894A9C165C05CA3CF35B6114A40D6FCBDE96DC165C074BF248BF7104A40E41C6994C1C065C0888D258B7F104A40311FBEE959C065C064A3CF35F60F4A40525BBEE9AEBE65C08C71D035BE0F4A408BFA689425BE65C064A3CF35F60F4A40525BBEE9DEBC65C07B0AD0359A114A408D41BEE965BC65C05CA3CF35B6114A4068BE689490BC65C0F880CF35EA0F4A403CAD6894AABC65C06F0AD0351A0F4A408E41BEE9D5BC65C00CCC7AE04C0E4A401E03699458BC65C068BF248B770E4A405DE968946FBB65C0E893D035CA0F4A4098CF689416BB65C064A3CF35F60F4A40A1A46894D7BA65C018E8CF354E0F4A409C16BEE9C6B965C0B8C5CF35820B4A402DD8689449B965C0B0C5CF35C20E4A40C4E068947CB865C018E8CF354E104A40311FBEE979B765C09C8D258BBF104A40C6E068945CB665C0BCC5CF35C2104A4050146994EEB565C0C02CD03526114A406B05BEE920B565C0304FD035F2124A4098CF6894B6B465C060A3CF3576134A405F30BEE92FB465C093427AE05C134A40B80B6994CBB365C034D5CE35EE124A40B07DBEE96AB365C0E819CF35C6124A40E863BEE9F1B265C060A3CF3576134A400103000000010000000C00000049CD133FBEEF65C0A8F4258B23164A40BA52BEE92BF065C063BF248B77144A40EEAA133F52F065C070557BE07C144A40E3D5133FA1F065C0A45ECF35DE144A403666133FCAF065C00817268B2F154A40D2B56894FDF065C02804258B0F164A401675BEE9E7F065C0FF16268BEF164A4057A2133FDFF065C00C81CF356A174A409A16BEE9A6F065C00C81CF356A174A406130BEE98FF065C0A013248BBB174A408D41BEE955F065C0D42CD035A6174A4049CD133FBEEF65C0A8F4258B23164A4001030000000100000009000000AACF4116D0FE6540E093D0350A2C4A407230976BB9FD654024B979E06C2B4A40BAEB966BC1FC6540CC2CD035A62C4A40F08A411638FC6540CFB2CE3562304A40222AECC04EFD6540CFB2CE3562304A40EE8A4116F8FD6540483CCF35922F4A40CC52976B25FF654018B979E0AC2E4A40D3E04116B6FF654044B6D035D62D4A40AACF4116D0FE6540E093D0350A2C4A40010300000001000000160000007B256994648C65C0BC107BE0E4254A408BFA6894358D65C0D848258BA7234A406030BEE99F8D65C00C81CF356A234A40515BBEE91E8E65C0D8FD79E004254A40A4A46894578F65C0C0107BE0E4214A406B05BEE9F09065C0F035248B07204A40311FBEE9A99265C0E819CF35C61F4A40E863BEE9419465C0204FD03572214A402ED86894299365C0A05ECF351E284A40A2A46894879265C073557BE0FC2A4A40AE7DBEE9DA9165C0E0B2CE35E22C4A40FEC66894E38F65C0BCC5CF35822F4A40515BBEE91E8E65C0707479E014334A405F30BEE9EF8D65C0DB48258B67324A40C827BEE9AC8D65C08871D035FE314A40A2A46894078D65C034B6D03556314A408D41BEE9458C65C053877AE0342F4A402CD86894C98A65C0B47A248BDF2D4A4096CF6894A68965C0403CCF35122C4A40F838BEE9F28965C0C0C5CF3582284A40501469946E8A65C093427AE09C274A407B256994648C65C0BC107BE0E4254A40010300000001000000DE0000009A16BEE9F6C365C00081CF352A334A409C16BEE946C365C0E819CF3586324A40E61C6994C1C265C0707479E014334A40B90B69944BC265C0C02CD035E6304A404F146994BEC165C0F880CF352A2F4A40311FBEE919C165C04C3CCF35122E4A40311FBEE959C065C044B6D035D62D4A408E41BEE955C065C0D793D035CA2B4A40CA27BEE9FCBF65C074557BE0FC294A40D2B56894BDBF65C0C4C5CF3502284A40040EBEE903C065C04C877AE074254A40264ABEE938C065C0948D258BBF244A40E963BEE981C065C0F835248B07244A40E963BEE9D1C065C08C71D0357E234A40B80B69941BC165C0F019CF3546234A40B07DBEE97AC165C074BF248BB7224A407D25699494C165C00081CF356A214A4089FA689495C165C030D5CE35EE1F4A402A91133FA9C165C0543CCF35D21E4A402DD86894A9C165C0543CCF35D21E4A403AAD6894DAC265C0443CCF35121D4A4020036994C8C565C00036248B871D4A40D1B568947DC665C08071D0353E1B4A40B07DBEE92AC665C0E019CF35C6194A401975BEE9C7C565C09B427AE05C184A4069BE6894F0C465C0BBC5CF3502164A40F4F16894C2C365C06C7479E094134A40826CBEE934C365C0E093D0350A124A402DD86894F9C265C08C427AE05C104A403CAD68942AC365C058A3CF35760E4A40E963BEE9A1C365C0CB2CD035660E4A40B80B6994BBC465C08C427AE05C104A40826CBEE904C565C0F019CF3586104A40D6FCBDE93DC565C014E8CF350E104A40806CBEE974C565C0D848258B670F4A409A16BEE9B6C565C050D2258B170F4A40E61C699411C665C0EC19CF35460F4A4067BE6894C0C665C053877AE0F40F4A40806CBEE924C765C064A3CF35F60F4A40D2B56894EDC665C018B979E0EC0E4A40F2F16894D2C665C04C3CCF35D20D4A40F2F16894D2C665C034D5CE35AE0C4A40CA27BEE9ECC665C0B8C5CF35820B4A40C4E068945CC765C074557BE03C0C4A40C4E06894ACC865C06CBF248B770C4A405CE96894EFC865C0CC2CD035E60C4A40D5FCBDE99DC965C07871D0357E0E4A402ED86894C9C965C050D2258B170F4A408F41BEE945CA65C0E893D035CA0F4A4098CF6894D6CA65C028D5CE356E0F4A40B90B69946BCB65C0204FD035B20E4A408E41BEE9F5CB65C00CCC7AE04C0E4A40254ABEE938CD65C0503CCF35920E4A40EB63BEE9C1CD65C044B6D035160E4A406030BEE9EFCD65C06CBF248B770C4A40B80B69947BCD65C054D2258B170D4A405CE96894FFCC65C02FB6D035560D4A40234ABEE9F8CB65C040D2258B570D4A40234ABEE9F8CB65C06CBF248B770C4A40E71C699491CC65C0DCB2CE35E20B4A40D1B56894BDCC65C078557BE0BC064A40321FBEE929CD65C090F7CE357A054A40F2F16894F2CD65C02C4FD035B2054A40244ABEE938CE65C0B0C5CF3582064A405BE968945FCE65C0A85ECF351E084A40AE7DBEE9CACE65C073BF248BB70A4A40264ABEE938CF65C04F3CCF35D2084A40234ABEE9C8CF65C074BF248B37094A402DD8689459D065C000CC7AE0CC0A4A40C6E06894CCD065C06CBF248B770C4A4089FA6894D5D065C08B71D0357E0A4A40D7FCBDE9EDCF65C008E8CF35CE064A405BE96894AFCF65C0F019CF3586044A40A4A4689427D065C0607479E014064A40D0B56894BDD065C044B6D03556074A402FD8689459D165C093427AE0DC074A40050EBEE9E3D165C087F7CE353A074A40515BBEE9AED165C0F735248BC7064A408AFA689465D165C0680AD035DA054A40BB52BEE93BD165C090F7CE357A054A40BB52BEE93BD165C0F019CF3586044A40535BBEE99ED165C04C877AE0B4044A401975BEE947D265C038B6D03556054A40A3A46894A7D265C090F7CE357A054A40826CBEE9F4D265C05CA3CF3536054A40EA63BEE9B1D365C0C0C5CF3502044A4001C7689413D465C0C42CD035A6034A40F838BEE9D2D465C03CD5CE352E044A409916BEE936D665C07B0AD0359A064A40F2F16894B2D665C0E819CF3546064A406C05BEE960D665C0304FD03572054A40FEC6689453D665C040B6D03596044A40806CBEE984D665C0F880CF35EA034A405AE96894EFD665C0C42CD035A6034A401975BEE977D665C0D0B2CE35A2024A4000C76894E3D665C094427AE01C024A40F638BEE922D865C0CB2CD035E6014A40AD7DBEE96AD865C020B979E02C024A4067BE689410D965C0B77A248B5F034A40B07DBEE96ADC65C090F7CE357A054A40806CBEE9C4DC65C050D2258B17054A408BFA689465DD65C0C82CD035E6034A403CAD6894BADD65C0C42CD035A6034A408BFA6894F5DE65C0F880CF35EA034A40FFC6689483DF65C0503CCF3592034A401875BEE907E065C03CB6D03556024A40535BBEE91EE165C007E8CF358E004A403BAD68945AEA65C08771D035FE004A4089FA6894E5EA65C0CB2CD035E6014A40EA63BEE9F1E965C0F880CF356A034A40301FBEE9B9E665C0F019CF3586044A402DD8689429E565C05CA3CF3536064A408AFA689485E465C0E819CF3546064A40BC52BEE9FBE365C030B6D03516064A409A16BEE986E365C05CA3CF35B6054A409B16BEE966E365C060A3CF35F6044A40D3B56894DDE365C0C42CD035A6034A40816CBEE954E365C0483CCF35D2034A404F1469946EE265C02C4FD03532054A408D41BEE9E5E165C090F7CE357A054A40BB52BEE95BE165C050877AE0F4044A407D256994F4E065C00C81CF352A044A40F3F16894A2E065C0FF35248B07044A402DD8689459E065C090F7CE357A054A4068BE6894C0E065C02C4FD03532064A40D3B56894DDE065C00081CF35EA064A402DD86894C9E065C050A3CF3576084A40FEC66894A3E065C0E893D0358A094A40E61C699451E065C0483CCF3592094A40040EBEE903E065C0C82CD03526094A402FD86894E9DF65C0BF107BE0E4084A405F30BEE9CFDF65C070557BE07C084A40E963BEE981DF65C08C8D258BBF074A406030BEE92FDF65C070BF248B77074A40301FBEE909DF65C050A3CF3576084A40254ABEE9E8DE65C054877AE0340A4A40D2B568949DDE65C0DCFD79E0840A4A40BC52BEE90BDE65C050D2258BD7094A40826CBEE9C4DD65C038B6D035160B4A40501469945EDD65C0CB2CD035660D4A40F3F1689402DD65C040877AE0B40E4A40AE7DBEE9DADC65C0DC48258BE70C4A40321FBEE999DC65C0DCB2CE35620B4A40CA27BEE95CDB65C00881CF356A0D4A40F638BEE9E2DA65C0B8C5CF35820B4A408E41BEE965DA65C08771D0357E0C4A4068BE6894E0D965C0F8CB7AE08C0C4A40C4E068946CD965C00481CF35AA0B4A40040EBEE923D965C050D2258BD7094A40C927BEE92CD865C0C4107BE0240C4A40525BBEE9CED765C0908D258B3F0D4A40525BBEE9CED765C050D2258B170F4A40F3F1689422D765C064A3CF35F60F4A407E25699454D665C044877AE0340E4A406030BEE9CFD465C0780AD0355A0D4A406030BEE93FD365C0BC107BE0640D4A40545BBEE94ED265C00CCC7AE04C0E4A40F738BEE9F2D265C0B0C5CF35C20E4A40E963BEE921D365C0204FD035B20F4A409C16BEE9E6D265C0EC19CF35C6104A40545BBEE94ED265C05CA3CF35B6114A409A16BEE9A6D165C018E8CF35CE114A404E146994EED065C000CC7AE08C114A40D2B568944DD065C018E8CF35CE114A40C4E06894ECCF65C060A3CF3576134A40B07DBEE9DAD065C0A45ECF355E134A40B90B69944BD165C097427AE09C134A406C05BEE9B0D165C043B6D03556144A40040EBEE973D165C058A3CF3536154A40331FBEE999D165C0483CCF3592154A40C827BEE9ACD165C090427AE0DC154A40050EBEE9E3D165C040877AE0F4164A405E30BEE95FCE65C040877AE0F4164A40816CBEE994CD65C0A05ECF35DE154A407E25699434CD65C00C81CF35EA154A40B70B69940BCD65C0B0107BE064174A40A2A4689437CD65C0E0FD79E044184A40501469949ECD65C024B979E02C194A405E30BEE95FCE65C048877AE0741A4A405E30BEE95FCE65C08071D0353E1B4A40F638BEE962CC65C0B0C5CF35421B4A40535BBEE98ECB65C0EC93D0354A1A4A40BC52BEE9DBCA65C0607479E0D4174A4098CF689496CA65C0CB2CD035E6194A401975BEE917CA65C087F7CE357A1B4A40B80B69948BC965C040B6D035161C4A40C5E068941CC965C08071D0353E1B4A40F1F16894E2C865C0700AD0351A1C4A40244ABEE9B8C865C090427AE09C1D4A4068BE689490C865C024B979E06C1E4A40AE7DBEE94AC865C038B6D035D61E4A406130BEE98FC765C02C4FD035321F4A401975BEE957C765C0E819CF35C61F4A40D6FCBDE94DC765C07771D0353E224A40816CBEE9D4C765C04CD2258B17234A40C5E068941CC965C0F019CF3546234A409916BEE996C965C08371D0353E244A40A3A46894E7C965C0B8C5CF3582254A408F41BEE925CA65C08071D035BE264A40BA52BEE96BCA65C0D4B2CE35A2274A402ED8689409CB65C0A85ECF355E284A404F1469945ECB65C06C7479E0D4274A4095CF689466CB65C01CE8CF354E264A40244ABEE918CB65C0483CCF3512244A40501469940ECC65C05F7479E054244A404E1469944ECD65C01704258B8F254A402ED8689429CE65C097427AE05C274A406030BEE9EFCD65C018E8CF354E294A40E763BEE9D1CB65C0443CCF3592294A408D41BEE9D5CA65C02F4FD035F22A4A40244ABEE918CB65C0D8B2CE35A22E4A4001C76894B3CA65C0B4107BE0642F4A4096CF689456CA65C03BB6D035162F4A40A2A46894F7C965C02804258B8F2E4A40C4E068948CC965C0D8B2CE35A22E4A40321FBEE939C965C03BB6D035962F4A402103699408C965C070BF248BB7314A40545BBEE9BEC765C00CCC7AE0CC324A409A16BEE916C665C068557BE07C354A40D1B568942DC565C040877AE0B4354A40A2A46894A7C465C0F780CF356A344A409A16BEE9F6C365C00081CF352A334A400103000000010000002C0000002F03421652B96540244FD03532404A40B8EB966B61B765403BD5CE356E3C4A40AFEB966BD1B6654027B979E0AC394A4002F241163CB76540D0B2CE3522364A4076BE41167AB76540D0B2CE35A2344A40CE52976BA5B7654078557BE07C324A4030034216C2B7654028D5CE352E304A4070BE4116CAB7654068557BE03C2E4A40CCE0411626B56540E0B2CE35E22C4A4004F241163CB565406C7479E0942D4A40B0EB966B41B56540FF80CF35EA2D4A40EE8A411648B56540F880CF352A2E4A404EAD411664B56540D8B2CE35A22E4A404EAD411664B56540BCC5CF35822F4A401C9C4116FEB465409F5ECF355E2F4A40AACF4116A0B46540BCC5CF35822F4A401E9C41164EB465409F5ECF35DE2F4A401E9C41160EB46540CFB2CE3562304A40C952976B15B46540B8C5CF3582324A40222AECC05EB36540EB93D035CA324A40CC52976B05B06540DB93D0358A314A40784CECC0DAAC6540E019CF35C6324A402E03421672AC65400317268BAF334A4002F241169CAC654040877AE0B4354A403003421612AD654010E8CF350E374A40160E976BCDAD6540E0B2CE3562384A407230976B89AE65408871D0353E394A403A91ECC002AF6540284FD03532394A4070BE4116BAAF65405F7479E094384A40D6E0411656B06540E019CF3586384A404CAD4116E4B06540E019CF3506394A40A9CF411670B165404C3CCF35123A4A40CE52976B25B265402304258B4F3C4A40824CECC06AB26540985ECF359E3C4A40EE8A4116F8B2654027D5CE35AE3C4A40140E976B2DB3654097F7CE35FA3C4A40D2E0411646B36540E448258BA73D4A40B8EB966B81B36540DCB2CE35E23E4A4006F24116CCB3654030B6D035D63F4A4004F24116FCB3654054D2258B17404A403103421632B4654007E8CF350E404A406F30976B99B76540D7B2CE3562414A401A9C41168EB8654040877AE034414A402F03421652B96540244FD03532404A400103000000010000000C000000BC52BEE91B6765C0F019CF35463B4A40BD52BEE9DB6865C04C3CCF35123A4A40244ABEE9F86965C02CB979E06C3B4A40E51C6994116A65C0D8FD79E0843E4A40806CBEE9646965C017E8CF35CE414A407B256994346865C0D8FD79E0C4434A401875BEE9176765C0D7B2CE3562414A40806CBEE9A46665C030B6D035D63F4A408E41BEE9C56665C0B8C5CF35023E4A402ED86894E96665C038B6D035163D4A403CAD6894FA6665C0687479E0143C4A40BC52BEE91B6765C0F019CF35463B4A400103000000010000000C000000D6FCBDE9CD6365C063A3CF3536484A40CC6E133FBD6365C02304258BCF474A403BAD6894AA6465C0D848258BA7474A402ED86894796565C088DB79E0F8474A40535BBEE9AE6565C03BD5CE35EE474A402FD86894896565C0D448258B67484A4058A2133F4F6565C037B6D03516494A402A91133F396565C050D2258BD7494A40FA7F133F136565C0406B258BB34A4A407F6CBEE9C46365C0F8AF258B0B4A4A400855133FD46365C08B71D035FE484A40D6FCBDE9CD6365C063A3CF3536484A4001030000000100000023000000E51C6994215365C0BCC5CF35424E4A409B16BEE9E65365C0E4FD79E0044C4A40A5A46894A75465C0D42CD035264B4A40A3A46894775565C0BB107BE0644B4A40D2B568946D5665C0C4C5CF35824C4A409B16BEE9165865C0B8C5CF3582494A40CA27BEE99C5865C018E8CF350E484A40A3A46894275965C06B7479E014464A401875BEE9875965C0DC48258B27454A40EA63BEE9F15965C08071D0357E454A402FD86894995A65C0C4C5CF3542474A40BD52BEE9CB5A65C008E8CF354E464A401875BEE9175B65C000CC7AE0CC4A4A40A2A46894475A65C06B0AD035DA4E4A40C827BEE92C5865C0A05ECF355E544A40806CBEE9F45765C04FA3CF3576554A401975BEE9E75765C0403CCF3552564A40C5E06894CC5765C0BB7A248BDF564A40BD52BEE96B5765C0543CCF3512574A40EB63BEE9E15665C0737479E014574A40F838BEE9825665C0F435248B47574A408E41BEE9355665C00881CF35EA574A40040EBEE9E35565C054A3CF3536594A407C256994745565C040877AE0B4594A40806CBEE9B45465C07871D0357E594A40321FBEE9E95365C06C7479E0D4584A402991133F595365C0284FD035F2574A40D1B56894FD5265C050877AE0B4574A40244ABEE9A85265C040D2258B57574A40264ABEE9585265C0607479E0D4564A40311FBEE9095265C0975ECF351E564A40D2B568941D5265C0BFC5CF35C2544A40BB52BEE91B5265C07C557BE0FC534A409916BEE9265265C0D893D0354A534A40E51C6994215365C0BCC5CF35424E4A4001030000000100000008000000D2E0411646C56540F835248B475C4A40CC52976BD5C5654068557BE07C5A4A40EE8A411618C365408C427AE05C5B4A402C03421692C2654087427AE0DC5B4A4000F24116ACC265408471D035FE5C4A40A8CF411620C3654037D5CE352E5E4A40C852976BA5C36540740AD035DA5E4A40D2E0411646C56540F835248B475C4A40010300000001000000130000002DD86894194465C09C427AE01C5D4A4022036994384665C09C427AE01C5D4A407D256994C44565C0C82CD03526624A40B80B69948B4565C08FF7CE353A634A406130BEE9BF4565C040D2258BD7634A4097CF6894D64565C0F835248B07644A40B60B6994FB4565C034D5CE352E644A4021036994684565C053D2258B17654A4068BE6894B04465C0908D258B3F654A40826CBEE9F44365C0B77A248BDF644A409E5D133F574365C034D5CE352E644A40F1F16894C24265C090F7CE35BA634A40AE7DBEE91A4265C02F4FD035B2624A40B90B6994CB4165C0503CCF3552614A405AE968943F4265C007E8CF35CE5F4A4096CF6894264265C007E8CF354E5F4A403BAD68941A4265C0E048258BE75E4A40A5A46894074265C070557BE0FC5D4A402DD86894194465C09C427AE01C5D4A400103000000010000000D000000EA63BEE9C12665C0F4647AE028634A40E41C6994A12765C090427AE05C624A405AE96894CF2765C01C337BE070624A403666133FCA2765C0FFCB7AE0CC624A4086B3133F952765C0988D258BFF624A40C099133F2C2765C0F4647AE0A8634A4089FA6894852665C0C89679E0E0644A401ABC133FC82565C0E019CF3546664A40BC52BEE93B2565C0740AD0351A664A40D0B568946D2565C03F207AE010664A40FA7F133FA32565C094427AE09C654A40806CBEE9F42565C0908D258BBF644A40EA63BEE9C12665C0F4647AE028634A400103000000010000002D000000D0B568940D3965C07F71D0353E724A405CE968948F3865C08071D0353E714A40C927BEE92C3865C0CFFD79E044714A402ED86894C93765C0F7CB7AE08C714A4020036994483765C0EC93D0354A714A4020036994E83665C0D8FD79E084704A40E51C6994A13665C060A3CF35B66F4A403AAD68945A3665C0F019CF35466F4A40234ABEE9F83565C0985ECF359E6F4A40234ABEE9F83565C06CBF248BF76E4A402DD86894E93565C048D2258B976E4A40F838BEE9D23565C0E0FD79E0446E4A40C6E06894BC3565C0E393D035CA6D4A40B70B6994DB3565C017E8CF350E6D4A406C05BEE9303665C0F8CB7AE04C6A4A40C6E06894BC3565C024B979E06C694A402DD86894293665C00C81CF352A684A40BD52BEE99B3665C090427AE01C674A401675BEE9D73665C0DB48258BE7654A406D05BEE9A03665C034D5CE352E644A408F41BEE9253765C0E0B2CE3522634A40C827BEE99C3765C0A77A248B9F634A406ABE6894603865C0780AD035DA654A40E61C6994013965C0C72CD035E6664A40C5E06894AC3B65C0403CCF3512694A40F838BEE9123C65C0D42CD035E6684A4098CF6894463D65C04C3CCF3552664A40E41C6994813D65C044B6D03516664A40050EBEE9133E65C0780AD035DA654A406ABE6894A03E65C00081CF352A654A40331FBEE9D93E65C008E8CF350E654A40B90B69940B3F65C06C7479E054654A40040EBEE9533F65C00436248B87664A408D41BEE9054065C0A05ECF359E674A40AE7DBEE95A4065C024B979E06C694A405BE968945F4065C088F7CE353A6B4A40826CBEE9243F65C0EC19CF35866D4A40331FBEE9D93E65C0E393D035CA6D4A401875BEE9873D65C0FF80CF35EA6C4A40A4A46894C73C65C0FC35248B076D4A408C41BEE9653C65C098F7CE357A6D4A40AE7DBEE9CA3B65C0D8FD79E004704A4089FA6894353B65C057A3CF35F6704A40EB63BEE9B13965C038D5CE35EE704A40D0B568940D3965C07F71D0353E724A400103000000010000000F0000003CAD6894FA4065C0F880CF35AA6E4A40B90B6994CB4165C054877AE0B46D4A40A4A46894E74265C0F880CF35AA6E4A403AAD68945A4365C0B7C5CF35826F4A40545BBEE9BE4365C0D893D0358A704A404F146994FE4365C08071D035BE714A40040EBEE9034465C0A05ECF351E734A406C05BEE9C04365C0F816268B6F744A40D3B568944D4365C0E793D0354A754A4001C76894C34265C02C4FD035B2754A405AE968943F4265C0D048258BA7754A40826CBEE9744065C0334FD035F2734A40FFC66894D33F65C0F880CF35EA734A40AE7DBEE95A4065C038D5CE35EE704A403CAD6894FA4065C0F880CF35AA6E4A400103000000010000000C0000006E05BEE9D00E65C06C557BE07C7E4A40AE7DBEE96A0E65C068BF248B777D4A4058A2133F9F0E65C088427AE01C7D4A4021036994180F65C0149D248BAB7C4A408D41BEE9350F65C0543CCF35127D4A40BC52BEE95B0F65C030207AE0507D4A40254ABEE9880F65C0543CCF35127D4A407E256994840F65C0AFC5CF35C27D4A40A4A46894570F65C03C207AE0507E4A40B2C4133F4B0F65C0D0FD79E0447E4A40C099133F3C0F65C037D5CE356E7E4A406E05BEE9D00E65C06C557BE07C7E4A40010300000001000000720000001C9C4116EE9C6540D02CD03526804A4072BE41162A9D6540483CCF35D27F4A40B0EB966B419D65401804258B0F7F4A402F034216529D654070557BE03C7E4A406C30976B799D654030D5CE35AE7D4A404BAD4116E49D654028B979E06C7D4A4030034216A29E6540BC107BE0647D4A40C852976B059F654090F7CE35BA7C4A402C03421642A0654030D5CE35AE7E4A401C2AECC0DEA0654030D5CE352E7F4A403003421612A46540770AD0355A7F4A40D0E0411696A46540D0FD79E0C47E4A4078BE41169AA56540DCB2CE35627C4A406830976BE9A565407C0AD035DA7B4A404CAD4116F4A5654088427AE01C7B4A4003F241167CA5654020B979E06C794A40FEF141167CA465409C427AE09C764A406830976BD9A46540E0B2CE35E2764A40B8EB966B21A56540988D258BBF764A40202AECC04EA565409C427AE01C764A4004F241165CA56540975ECF35DE744A4002F241161CA765409CF7CE35FA774A40242AECC0FEA76540D4B2CE35E2784A40EC8A411638A8654070557BE07C774A404CAD4116A4A9654090F7CE357A764A403203421652AA6540988D258B3F754A4004F241164CAA6540DFFD79E084734A40D2E04116E6A96540E019CF3546724A4002F241167CA965403FD2258B57714A407D4CECC06AA86540985ECF359E6F4A40D2E04116A6A965408C71D035FE6D4A40AACF411640AB6540A85ECF351E6D4A4002F24116DCAC6540E793D0350A6D4A404EAD411624AE6540E393D035CA6D4A4002F24116DCAD654043B6D035566B4A40D4E0411666AD654038B6D035566A4A40120E976B0DAC6540F8CB7AE04C6A4A40FCF14116CCAA6540B8C5CF35C2694A401C9C41164EAA654074557BE0FC684A4078BE41164AAA6540E893D035CA674A406FBE41167AA9654037D5CE352E6A4A40D6E0411606A965400817268B2F6B4A407D4CECC06AA865400CCC7AE00C6C4A401C9C4116BEA7654030D5CE356E6C4A40A6CF411620A76540B0C5CF35026C4A4002F241169CA665408871D035BE6A4A40FFF141163CA6654000CC7AE08C684A406830976B09A6654000CC7AE08C684A406830976B09A6654024B979E06C694A40FCF14116CCA5654024B979E06C694A404CAD411694A565404FD2258B97674A406830976B09A6654018E8CF35CE664A406830976B09A66540780AD035DA654A40140E976B3DA56540503CCF3592654A40A3CF4116B0A46540CB2CD035E6644A40C852976B35A46540274FD035F2644A4000F241169CA3654018E8CF35CE664A402C03421602A36540FCCB7AE0CC694A4000F24116DCA26540F8CB7AE04C6A4A40804CECC07AA26540E419CF35066A4A4072BE4116DAA16540483CCF35D2684A4000F241168CA1654000CC7AE08C684A40F08A411688A0654030D5CE35AE664A40D86EECC0669F65400881CF35EA624A40E88A4116389E65409CF7CE35FA5F4A4070BE41160A9D6540780AD0359A604A40C452976B259D654004CC7AE04C614A40D4E04116369D6540473CCF3592624A40A8CF4116309D65406CBF248BF7634A4070BE41160A9D654008E8CF350E654A4078BE41169A9C6540CC2CD035E6654A407C4CECC02A9C65400BCC7AE0CC654A40D4E04116669B654008E8CF350E654A40189C41162E9B6540780AD0355A654A40FCF14116DC9A65406F0AD0359A664A4028034216A29A654018E8CF35CE664A40D86EECC0769A65404C3CCF3552664A4004F241164C9A65401704258B8F644A40B8EB966B119A654034D5CE352E644A40EA8A4116A8996540DC48258B67644A4078BE4116DA9865406B557BE07C654A40189C41166E986540780AD035DA654A40189C41166E98654018E8CF35CE664A40804CECC0DA98654018E8CF35CE674A40A2CF411610996540543CCF3552694A40149C41164E996540FF80CF35EA6C4A40B4EB966BE1996540403CCF3552704A4048AD4116F4996540DF48258BA7714A40D0E04116869965407F71D0353E724A40D4E0411636996540F319CF3506724A40B4EB966B319865400881CF356A704A403491ECC0D2976540D4FD79E044704A406830976BA99665400881CF356A704A40139C41167E94654050877AE0346F4A407030976B09946540985ECF359E6F4A40D86EECC05694654008E8CF358E704A403003421622956540975ECF35DE744A404CAD4116E4946540543CCF3552764A4074BE41167A946540D793D035CA764A40100E976B5D9365409C427AE09C764A40D4E0411686916540670AD035DA744A40D86EECC016916540B8C5CF3542754A40C352976BA590654044D2258B17764A40140E976BBD8F6540E819CF35C6754A4004F241163C8F65409C427AE09C764A403191ECC0A29165407C0AD035DA7B4A40D0E04116D6916540C02CD035E67A4A40CCE041167692654034D5CE352E7D4A403003421622956540700AD0351A814A403091ECC06297654003CC7AE00C804A40CC52976BE5976540B07A248B9F804A406C30976B699865402804258BCF814A40242AECC0FE98654073557BE0FC814A401C9C4116EE9C6540D02CD03526804A4001030000000100000011000000806CBEE9043765C0A85ECF359E794A4069BE6894F03765C0D848258B27794A40D6FCBDE9BD3765C0C02CD035E67A4A408B41BEE9553865C08871D035FE7B4A40E71C6994413865C0EB93D035CA7D4A40535BBEE9FE3765C018E8CF35CE7F4A40B07DBEE91A3865C028B979E02C834A40535BBEE97E3765C058A3CF3536844A40FEC66894B33665C027B979E0AC844A406C05BEE9303665C040D2258B97844A4020036994C83565C0988D258B3F844A40AE7DBEE98A3565C08BF7CE353A834A402ED86894693565C0E819CF35C6814A40E51C6994513565C0D02CD03526804A4097CF6894F63565C054D2258B977E4A40EB63BEE9713665C038D5CE35EE7B4A40806CBEE9043765C0A85ECF359E794A4001030000000100000098000000020EBEE9430065C0988D258BFFC84A40A5A46894B7FE64C03FB6D035D6C44A40254ABEE9E8FD64C020B979E06CC34A402FD86894D9FC64C0E0B2CE35E2C24A40BC52BEE9CBFA64C0C4C5CF3542C34A40F838BEE9D2F964C04C3CCF3592C24A40515BBEE96EF964C0B8C5CF3542C04A40BC52BEE9DBF964C020B979E02CBD4A40B80B69944BFB64C0888D258B3FB94A4068BE6894E0FB64C0CC2CD035A6B64A40F638BEE992FB64C02F4FD035F2B54A40F638BEE952FB64C0304FD035F2B44A40D5FCBDE93DFB64C02C4FD035B2B34A406ABE689470FB64C0EC19CF3546B24A40FFC6689433FB64C06B7479E054B14A407C25699404FC64C0740AD0359AAF4A40EA63BEE901FE64C06C0AD0359AAC4A40CA27BEE9ECFE64C03CB6D03516AC4A40501469949EFF64C040B6D03556AB4A40BC52BEE96B0465C088F7CE35FAA24A40F838BEE9820565C028B979E0ECA14A402DD86894390765C08471D0353EA14A40826CBEE9340865C0E893D0350AA04A40D2B56894AD0865C0E0FD79E0C49F4A40040EBEE9330965C0770AD0351A9F4A402FD86894F90965C00881CF352A9C4A40244ABEE9880A65C090F7CE357A9B4A40301FBEE9690A65C050A3CF35369A4A408F41BEE9550A65C098F7CE35BA994A40F738BEE9E20A65C08071D0353E984A404F1469942E0B65C0543CCF3512964A40D5FCBDE97D0B65C0975ECF359E944A4089FA6894150C65C0EF19CF3546954A40C927BEE90C0C65C0204FD035F2914A4069BE6894800C65C060A3CF35F68F4A406030BEE92F0D65C00481CF356A8E4A40311FBEE9D90D65C064A3CF35768C4A40321FBEE9E90E65C0888D258B3F874A40D1B56894AD0F65C0D4B2CE3562854A404E1469947E1065C02CB979E06C864A405DE96894FF1065C02FD5CE356E844A4069BE6894B01265C0CF2CD035E6834A40545BBEE96E1365C00481CF356A824A40301FBEE9091465C0D0B2CE35A2804A40D3B568947D1565C07F71D035BE7D4A407C256994F41565C07C0AD035DA7B4A404D146994CE1565C0F019CF35467B4A40C727BEE9BC1565C0C02CD035E67A4A403BAD68940A1865C0C02CD035E67A4A40264ABEE9C81865C00C81CF356A7A4A403AAD6894EA1865C0C4C5CF3542794A40F638BEE9A21865C054D2258BD7774A40040EBEE9231865C09C427AE09C764A40FFC66894831865C094F7CE35FA744A40244ABEE9F81865C0344FD035F2744A40040EBEE9731965C08471D035FE754A4001C76894E31965C070557BE07C774A406030BEE92F1A65C05CA3CF35B6754A40D5FCBDE99D1A65C0403CCF3592754A40A5A46894171B65C038B6D035D6754A409B16BEE9861B65C0B8C5CF3542754A401875BEE9571C65C050A3CF35B6724A4000C76894D31C65C0304FD035B2714A40234ABEE9E81D65C088F7CE35FA704A406E05BEE9A01F65C0F880CF35AA6E4A4098CF6894C62065C0EC19CF35066E4A409B16BEE9462165C0E0FD79E0446D4A4000C76894232165C00CCC7AE00C6C4A4000C76894232165C028B979E02C6B4A405CE968948F2365C024B979E06C694A40C827BEE90C2365C0A45ECF35DE6A4A401F036994782265C058A3CF35366B4A40F2F16894F22165C08B8D258BBF6B4A4021036994982165C0E393D035CA6D4A4000C76894B32165C017E8CF350E6E4A40254ABEE9B82165C0AC7A248B1F6E4A40B07DBEE9BA2165C0888D258B3F6E4A40AF7DBEE9CA2165C0F880CF35AA6E4A40040EBEE9E31F65C018E8CF358E6F4A40020EBEE9631F65C00881CF356A704A40D6FCBDE90D1F65C0F319CF3586724A40244ABEE9F81E65C038D5CE35AE764A40545BBEE97E1E65C094427AE05C784A407C256994C41D65C0A45ECF35DE784A405DE968941F1D65C0CF2CD03566784A40F538BEE9821C65C094427AE05C784A406030BEE9DF1B65C098427AE01C7A4A406030BEE99F1B65C09C427AE05C7C4A4089FA6894951B65C0E4B2CE35E2804A401975BEE9371B65C048D2258BD7824A4098CF6894861A65C02004258B0F824A40B70B6994DB1965C0DCB2CE35A2834A40816CBEE9B41865C0543CCF3592884A401F036994981865C028B979E06C8A4A40C5E068946C1965C0E893D035CA8E4A4020036994781965C048877AE0B4914A40B70B69943B1965C09C8D258B7F934A405DE96894CF1865C09C427AE0DC954A40D5FCBDE94D1865C0CB2CD035E6974A409B16BEE9461765C0C0C5CF3582994A407C256994541665C0DBB2CE35A29C4A407C256994F41565C087F7CE353A9D4A409C16BEE9661465C02804258B0FA04A405F30BEE92F1465C0975ECF351EA14A40F3F16894F21365C0730AD0351AA34A40EA63BEE9611365C070BF248B37A34A40254ABEE9381265C0B8C5CF3582A14A40D1B568949D1165C02404258B4FA04A40F2F16894521165C00C81CF35EA9F4A409C16BEE9E61065C0E0FD79E0C49F4A403CAD6894AA1065C0F880CF352AA04A40C5E068940C1065C098F7CE35FAA14A406030BEE96F0F65C0A77A248B9FA24A40264ABEE9280F65C0730AD0351AA34A40B80B6994DB0E65C038D5CE356EA34A40E963BEE9810E65C0B0C5CF3542A34A40816CBEE9540E65C00481CF35AAA24A40B80B69940B0E65C0670AD0359AA04A40311FBEE9D90D65C0E0FD79E0C49F4A4067BE6894F00C65C0D8FD79E004A14A407C256994240C65C0D048258B67A14A40B70B69948B0B65C08FF7CE35BAA24A40AE7DBEE93A0B65C0BCC5CF35C2A64A401975BEE9970B65C014E8CF350EA64A40FFC66894E30B65C00017268B2FA64A40030EBEE9030C65C02004258B0FA74A40D0B56894DD0B65C030B6D03596A84A40B07DBEE95A0C65C0D893D0354AA94A404D1469945E0D65C0C4C5CF35C2A94A40311FBEE9D90D65C08C8D258B3FAA4A40311FBEE9D90D65C058A3CF3536AB4A40501469946E0D65C0A05ECF35DEAB4A405AE96894FF0C65C0E0FD79E044AD4A402ED86894A90C65C04C877AE0F4AE4A403AAD68948A0C65C0274FD03572B04A40040EBEE9B30C65C0EC19CF35C6B24A40D4FCBDE9ED0C65C090427AE09CB34A40F2F16894020D65C00481CF356AB44A40D2B56894BD0C65C0CC2CD035A6B64A407D256994F40B65C0C02CD035E6BA4A40AE7DBEE9AA0B65C0BC107BE0E4BB4A406E05BEE9300B65C0D02CD035A6BC4A406C05BEE9100A65C0204FD035B2BD4A402ED86894A90865C0E819CF35C6C14A40030EBEE9930765C0740AD035DAC34A40816CBEE9640665C0C82CD03526C54A40040EBEE9030465C098F7CE35FAC54A40C5E068946C0365C0985ECF359EC64A40C827BEE9FC0265C0D42CD035A6C74A40D4FCBDE97D0265C088427AE01CC84A40C4E06894EC0065C08471D035BEC74A40020EBEE9430065C0988D258BFFC84A400103000000010000002F0000003AAD6894DAC264C0975ECF351EEC4A40C4E068942CC364C07871D035BEEA4A40331FBEE949C364C0A05ECF355EEA4A40C927BEE99CC364C00036248B47EA4A40545BBEE9DEC364C0E493D035CAE94A40525BBEE90EC464C00317268BEFE84A40321FBEE929C464C08871D035BEE74A40050EBEE9D3C364C078557BE0BCE64A406030BEE9BFC364C0C0C5CF3582E54A406C05BEE9E0C364C017E8CF354EE44A40321FBEE929C464C0B87A248B5FE34A405BE968949FC464C0D7B2CE35E2E24A40FFC6689493C564C0A85ECF355EE34A40E51C699421C664C0B87A248B5FE34A40A4A46894A7C564C08CF7CE35FAE04A40D2B568947DC564C090F7CE35BADF4A401775BEE997C564C0FC35248B87DE4A40A3A46894E7C564C00017268BEFDD4A40D7FCBDE93DC764C028D5CE352EDD4A40B70B69941BC764C0E019CF3586DC4A40D5FCBDE9CDC664C0DCB2CE35A2DA4A40040EBEE973C764C0978D258BBFDB4A40FFC66894B3C864C0C82CD03526DF4A40535BBEE94EC964C0DBB2CE35E2DF4A401875BEE987C964C010E8CF354EE14A40FEC6689493C964C013E8CF350EE44A40BC52BEE94BC964C018E8CF35CEE54A40D0B568948DC864C08C71D0353EE44A405CE968948FC864C08371D035FEE54A40F2F1689462C864C01C04258BCFE64A403BAD68941AC864C038B6D03556E74A40321FBEE9C9C764C038D5CE352EE84A40C4E068949CC764C0740AD0355AE84A40030EBEE993C764C00C17268B2FE74A40D5FCBDE9ADC764C08C71D0353EE44A406C05BEE970C764C08C71D0353EE44A40B70B6994CBC664C044B6D03556E94A407E25699454C664C0C82CD03526EB4A40E71C6994B1C564C0A05ECF355EEA4A40501469946EC564C0C02CD035E6EB4A408AFA689425C564C098F7CE35FAEB4A40525BBEE9CEC464C060BF248B77EB4A40EB63BEE961C464C07871D0353EEB4A40C4E06894FCC364C018B979E0ACEB4A4096CF6894B6C364C0C0C5CF3542EC4A40040EBEE963C364C008CC7AE08CEC4A403AAD6894DAC264C0975ECF351EEC4A4001030000000100000005000000030EBEE9F30065C0C09679E060F64A40B70B6994FB0065C040B6D03556F64A409188133F960165C05FBF248BF7F74A4058A2133F2F0165C084DB79E0B8F74A40030EBEE9F30065C0C09679E060F64A400103000000010000000E000000E61C699491C364C0AC5ECF355EFA4A40C827BEE9ECC464C0EF35248B47FA4A40254ABEE968C564C068BF248B77FA4A40525BBEE91EC664C0C4C5CF3582FB4A4098CF689446C664C04F3CCF3592FD4A40D2B568940DC664C03CD5CE35AEFE4A40816CBEE9C4C564C02C4FD035B2FE4A40F2F1689402C564C038D5CE352EFF4A407E256994B4C364C000CC7AE08CFE4A4098CF689406C364C0F019CF3586FD4A40545BBEE9CEC264C02CB979E02CFD4A40B80B69948BC264C0E019CF3546FC4A40264ABEE9D8C264C053D2258B17FB4A40E61C699491C364C0AC5ECF355EFA4A400103000000010000008D010000F638BEE9E2D764C008CC7AE0CCFC4A407E25699464D764C00017268BAFFC4A40806CBEE904D764C0F019CF3506FE4A40050EBEE9B3D664C00CE8CF35CEFF4A4068BE689460D664C030B6D03516014B40F538BEE962D564C06C557BE0BC014B404E1469944ED464C030B6D03596004B40E863BEE961D364C03CD5CE352EFE4A40C5E06894DCD264C008E8CF350EFB4A40B80B69949BD364C010E8CF354EFA4A4068BE689400D464C0F816268BAFF94A40C4E068942CD464C0607479E0D4F84A40040EBEE933D464C0344FD03532F84A409C16BEE956D464C04FA3CF35F6F64A40535BBEE95ED464C048877AE034F64A404E1469944ED464C0E0B2CE3562F54A403AAD68942AD464C0EB93D0358AF44A408AFA689405D464C090F7CE35FAF34A407D256994F4D364C070557BE0FCF34A40B07DBEE95AD464C0204FD03532F04A4089FA689445D464C094427AE09CEF4A407D256994D4D364C0F419CF3506F04A408E41BEE975D364C018E8CF35CEF04A408E41BEE915D364C060BF248B37F14A405DE968949FD264C02404258B8FF04A40321FBEE969D364C0E4B2CE3522EC4A407C25699484D364C0A05ECF355EEA4A401F036994C8D264C03CD5CE356EEB4A40321FBEE9A9CF64C05CA3CF3536F34A408E41BEE935CF64C0607479E014F34A406C05BEE9B0CE64C06B0AD0355AF14A408F41BEE995CE64C04C877AE0B4F24A40264ABEE908CE64C0770AD0359AF64A406D05BEE910CE64C004CC7AE0CCF64A40F4F1689412CE64C0E893D0358AF84A40264ABEE908CE64C08FF7CE353AF94A409B16BEE986CD64C0948D258BBFF94A406C05BEE960CD64C048D2258B17FA4A40CFB568941DCD64C064A3CF3576FD4A40C6E06894ECCC64C0AF7A248B9FFE4A40321FBEE9D9CB64C030B6D03516014B4096CF689486CB64C0607479E014FF4A406030BEE9CFCB64C0D02CD035A6FC4A40F738BEE9F2CB64C068BF248B77FA4A40C927BEE92CCB64C08FF7CE353AF94A40525BBEE96ECA64C06CBF248BF7F94A40B90B69949BC964C00081CF35AAFB4A40AE7DBEE9DAC864C0E893D035CAFC4A408F41BEE955C864C0780AD035DAFB4A40F1F1689422C864C0F435248BC7F94A401675BEE907C864C0D0B2CE35E2F74A40F1F1689422C864C048877AE034F64A40D0B568948DC864C0740AD035DAF44A40AF7DBEE91AC864C030D5CE35EEF44A4098CF6894B6C764C0D8B2CE35A2F54A406C05BEE900C764C017E8CF358EF74A406030BEE9FFC664C06C7479E094F54A40F2F1689432C764C0D32CD035E6F34A408AFA689485C764C08471D0357EF24A408E41BEE9E5C764C06B0AD0355AF14A40A4A4689487C864C0F880CF35EAEF4A408D41BEE915C964C09BF7CE353AEF4A40A4A46894A7C964C0FF80CF352AEF4A40EA63BEE951CA64C094427AE09CEF4A40C827BEE97CCA64C0204FD03532F04A40B80B69949BCA64C06F0AD0351AF14A40816CBEE9C4CA64C050D2258B97F14A406C05BEE910CB64C064A3CF35F6F04A40515BBEE92ECB64C0A05ECF351EF04A40B90B69944BCB64C0AC5ECF35DEED4A40301FBEE969CB64C08871D035FEEC4A403AAD6894FACB64C0E093D035CAEB4A40E863BEE941CD64C0BFC5CF3542EB4A406D05BEE9D0CD64C0A05ECF355EEA4A40FFC6689463CD64C0B47A248B5FE84A402ED8689429CD64C08871D035BEE74A40F638BEE992CD64C0B4C5CF3502E74A406D05BEE9B0D064C07871D035FEE44A40806CBEE954D164C0B07A248B1FE54A40EA63BEE991D064C0F880CF35EAE34A409A16BEE936D064C0503CCF3592E34A4020036994C8CF64C0B87A248B5FE34A4020036994C8CF64C08B8D258B7FE24A402ED86894A9D064C0A75ECF35DEE14A40525BBEE94ED164C090F7CE353AE04A40A4A4689467D264C02FD5CE356EDB4A40A3A46894E7D164C0780AD0359ADB4A406E05BEE9A0D164C050877AE0F4DA4A40040EBEE993D164C028B979E0ACD94A405E30BEE9BFD164C0FB16268BEFD74A40C927BEE94CD164C094F7CE35FAD84A406D05BEE9B0D064C054D2258B57DC4A406ABE689470D064C028D5CE352EDD4A40F638BEE9F2CF64C0E019CF3586DC4A40D1B568949DCF64C0F816268BEFD84A40525BBEE93ECF64C0E893D0354AD94A407C25699424CF64C090F7CE35FAD94A40BA52BEE91BCF64C0A87A248BDFDA4A4069BE689420CF64C07871D035BEDC4A40806CBEE914CF64C0204FD035F2DD4A408F41BEE9F5CE64C060BF248B77DE4A40254ABEE9C8CE64C0E493D035CADE4A40806CBEE994CE64C0D048258B67DF4A40A4A4689417CE64C0543CCF3592E04A40F538BEE972CD64C0985ECF351EE14A408AFA6894F5CC64C033D5CE35AEE04A40C6E06894ECCC64C03CD5CE35EEDE4A403AAD68949ACC64C003CC7AE0CCDE4A40B90B69945BCC64C004CC7AE04CDE4A40C827BEE92CCC64C03F877AE074DD4A40C4E068940CCC64C008E8CF354EDC4A407C256994D4CB64C02804258B0FDE4A40254ABEE9C8CB64C0985ECF351EE14A4000C7689483CB64C00817268BEFE24A40040EBEE913CB64C0FF16268B2FE44A406C05BEE9B0CA64C0D02CD03526E44A40B70B69945BCA64C0FF80CF352AE34A4089FA689415CA64C0F8CB7AE08CE14A405D30BEE90FCA64C0948D258BBFDF4A40B80B69943BCA64C0AF7A248B5FDE4A402DD8689429CA64C08C71D0357EDD4A40B07DBEE96AC964C028D5CE352EDD4A4097CF6894E6C864C0DB48258BA7DC4A4050146994CEC864C0740AD0355ADB4A403AAD6894DAC864C0C02CD035A6D94A4068BE6894C0C864C0FB16268BEFD74A4000C7689443C964C00436248B07D74A40301FBEE999CA64C0E019CF3546D64A40C6E068940CCD64C0730AD0351AD64A402CD8689499CD64C02C04258B4FD54A40311FBEE919CD64C038D5CE35EED34A40C6E06894ECCC64C02804258B8FD34A40515BBEE9AECD64C050D2258B57D34A405F30BEE95FCE64C0A05ECF355ED24A40D3B568940DCF64C0C0C5CF35C2D14A4020036994C8CF64C0334FD035B2D24A40F538BEE982D164C0A85ECF351ED04A40CA27BEE9FCD164C0A85ECF351ECF4A40AF7DBEE97AD164C0D8FD79E0C4CE4A40B07DBEE91AD164C0304FD035F2CD4A401F036994D8D064C0B0107BE0A4CC4A40D2B56894ADD064C0677479E0D4CA4A408BFA689495D164C0F816268BEFCC4A40C827BEE96CD264C07771D035FECB4A40C927BEE9FCD264C0DB48258BE7C84A405BE968940FD364C0D8B2CE35A2C44A40311FBEE979D364C018E8CF350EC74A40050EBEE943D564C0403CCF3592CC4A40545BBEE94ED564C058A3CF3576CA4A40F4F1689492D464C0CF48258B67C64A40535BBEE95ED464C0274FD03532C44A40A3A46894B7D464C088F7CE35BAC34A4069BE6894D0D664C0B07A248B5FC64A40B70B6994ABD664C0B7107BE0A4C44A40331FBEE949D664C0D4B2CE35E2C34A405F30BEE9CFD564C0CF2CD03566C34A406130BEE95FD564C070557BE07CC24A406E05BEE900D564C018E8CF354EC04A401775BEE917D564C03CB6D035D6BE4A40CA27BEE97CD564C0F019CF3586BE4A407E25699454D664C037D5CE35AEC04A408BFA6894A5D664C010E8CF350EC14A402FD8689459D764C0DCB2CE3522C14A405F30BEE97FD764C090F7CE357AC14A40FDC66894C3D764C00881CF352AC34A40F638BEE9E2D764C0C4C5CF35C2C34A4068BE6894B0D864C0F880CF352AC64A405BE968946FD964C0988D258BFFC84A407C256994E4D964C0948D258B3FC74A40BC52BEE99BD964C0C02CD035E6C54A406130BEE9FFD864C0DCB2CE3522C14A40826CBEE904D864C030B6D03556BD4A40F638BEE9E2D764C0BC107BE0E4BB4A40E863BEE911D864C064A3CF35B6B94A4097CF689476D864C07C557BE07CB94A405BE968946FD964C0D8FD79E004BB4A40BC52BEE99BD964C078557BE07CBB4A4020036994A8D964C0F835248B07BC4A40F4F16894C2D964C0EC93D0354ABC4A40A4A4689417DA64C0BC107BE0E4BB4A40D3B568941DDA64C02C4FD03572BB4A4096CF689466DA64C0473CCF3512B94A40A5A4689487DA64C02404258B4FB84A40D3B56894CDDB64C038D5CE35EEBC4A40535BBEE90EDC64C0D4B2CE35A2BD4A40050EBEE993DC64C028B979E0ECBC4A40E51C6994F1DC64C0344FD03532B94A40501469945EDD64C02404258B4FB84A408E41BEE9C5DD64C098F7CE35FAB84A40A4A46894E7DD64C050D2258B57BA4A40B90B69940BDE64C0AC5ECF355EBB4A40AE7DBEE97ADE64C0D8FD79E004BB4A40AE7DBEE9BADE64C0E093D035CAB94A40F2F16894D2DE64C0C0C5CF3542B84A4000C7689403DF64C08F8D258BFFB64A40F638BEE992DF64C0CC2CD035A6B64A406030BEE97FDF64C058A3CF3536B74A408E41BEE955DF64C0E0FD79E044B94A40C4E068943CE064C03CD5CE35EEB94A405F30BEE92FE264C0DC48258BA7B64A40F638BEE932E364C0284FD035B2B54A40B80B6994DBE364C0403CCF3592B54A405BE968945FE464C077557BE03CB54A403AAD6894CAE664C06F0AD0359AB14A4096CF6894C6E764C0F7CB7AE00CB14A40E41C6994C1E864C0780AD035DAAF4A408E41BEE955E964C0533CCF3592AF4A40F638BEE992E964C02FB6D035D6AE4A40F738BEE902EA64C0700AD0355AAB4A40C5E068944CEA64C08C8D258B3FAA4A408F41BEE985EC64C03CB6D03516AC4A402203699408ED64C04CD2258B97AB4A40C4E068940CEE64C0D8B2CE35A2A94A405E30BEE9AFEE64C060A3CF3576A94A405BE968948FEE64C0BC7A248B1FA84A40D2B568947DEE64C0DCB2CE35A2A74A407F6CBEE904EF64C094F7CE35FAA64A4068BE689460EF64C0A85ECF35DEA54A40806CBEE904F064C0B0C5CF3542A34A408C41BEE915F064C088427AE09CA24A40F638BEE922F064C070BF248BB7A14A40FFC6689443F064C0E0FD79E044A14A40D6FCBDE9DDF064C040D2258BD7A24A403BAD68942AF164C070BF248B37A34A4088FA6894E5F164C0B0C5CF3542A34A40F2F16894F2F264C058A3CF35F6A34A40826CBEE964F364C038D5CE35EEA34A40A4A46894D7F364C0403CCF35D2A24A4096CF689406F464C0B8C5CF3502A24A40A3A4689417F464C0985ECF359EA14A40C827BEE92CF464C010E8CF354EA14A401F03699448F564C060BF248BF79E4A4000C7689483F564C077557BE07CA14A40525BBEE94EF664C034D5CE35AEA24A405DE968941FF864C0B0C5CF3542A34A403CAD6894FAF864C038D5CE35EEA34A40BD52BEE9ABF964C0C4C5CF3502A54A407E256994E4F964C0D02CD035A6A54A40A4A46894F7F964C050A3CF3536A64A4088FA689415FA64C0700AD0359AA64A40F2F16894B2FA64C008CC7AE0CCA64A40050EBEE9E3FA64C0334FD035F2A64A40BC52BEE90BFB64C05CA3CF3536A74A40FFC6689433FB64C0DCB2CE35A2A74A40D2B56894FDF664C01CE8CF35CEB04A404F1469947EF664C06B7479E054B14A40020EBEE973F564C03BB6D03556B14A40F738BEE9F2F464C068BF248BF7B04A409C16BEE986F464C0C4C5CF3502B04A40B07DBEE96AF464C0DC48258B67B04A40FEC6689403F364C057A3CF3576B04A40F2F16894F2F264C00817268BEFB04A40244ABEE918F364C0EC19CF3546B24A40E963BEE941F264C098F7CE35BAB24A40A4A4689487F064C04C3CCF35D2B04A40826CBEE994EF64C0274FD03572B04A40301FBEE9D9EF64C01CE8CF354EB14A405DE968946FF064C0F019CF3506B44A405DE968946FF064C0543CCF35D2B44A4089FA689425F064C0B4C5CF3502B54A40244ABEE9F8EF64C02F4FD03572B54A40EA63BEE9D1EF64C0D0FD79E004B64A405F30BEE92FEF64C01CE8CF358EB74A405E30BEE9AFEE64C0D0FD79E084B74A40B70B69941BEE64C040D2258B17B74A40E963BEE911ED64C00881CF35AAB54A406C05BEE980EC64C0284FD035B2B54A40A3A46894A7EC64C00336248B47B64A40F638BEE9D2EC64C0D7B2CE3522B74A406D05BEE9F0EC64C0D0FD79E084B74A40BD52BEE91BEC64C0D893D0354AB74A40B70B6994FBEA64C07C0AD0359AB54A40321FBEE949EA64C008E8CF354EB54A40E61C6994C1EA64C0E0FD79E044B94A40826CBEE904EA64C0473CCF3592B84A409C16BEE9B6E964C08C71D035FEB84A402ED86894A9E964C010E8CF354EBA4A40525BBEE9AEE964C06B7479E054BC4A40826CBEE954E964C038D5CE35EEBC4A40D1B568943DE764C0D8FD79E004BB4A40515BBEE9CEE664C0E0B2CE3522BB4A40D3B568946DE564C00417268B2FBC4A40FEC6689413E564C0503CCF3512BD4A40B07DBEE92AE564C07F71D035BEBD4A407E25699454E564C0D048258BA7BF4A408D41BEE945E564C0E4B2CE3562BF4A40806CBEE984E564C00CE8CF354EC14A40D6FCBDE9ADE564C040D2258B17C24A40D5FCBDE9EDE564C0E0B2CE35E2C24A40EB63BEE971E564C09CF7CE35FAC24A40525BBEE96EE364C0680AD035DAC14A406D05BEE960E164C0E819CF3546C24A40C4E068945CDF64C040D2258B97C34A4022036994B8DE64C0D8B2CE35A2C44A40B70B69946BDF64C07871D035BEC54A40E71C699421E064C09B5ECF359EC54A40254ABEE9A8E164C0D8B2CE35A2C44A40040EBEE923E364C0EC19CF3506C54A40C4E06894DCE364C02304258BCFC54A404E1469949EE464C0948D258B3FC74A401875BEE977E464C038B6D03596C74A407D25699464E464C00C17268BEFC74A40E51C699451E464C0DBB2CE3562C84A402ED8689429E464C0988D258BFFC84A403CAD6894EAE464C018B979E06CCA4A405CE968942FE564C07C0AD0351ACD4A40264ABEE9F8E464C0274FD035B2CF4A401975BEE947E464C09F5ECF35DED04A40A5A46894F7E264C05FBF248B77D04A409C16BEE9A6E264C04C3CCF3512D04A40254ABEE958E264C048877AE034CF4A402CD86894E9E164C08871D0353ECD4A403CAD68948AE164C0403CCF3592CC4A40AF7DBEE99AE164C00036248B07CD4A4095CF6894A6E164C09C427AE01CCD4A40F738BEE9B2E164C0AC5ECF351ECD4A409C16BEE9C6E164C0985ECF355ECD4A403CAD68948AE164C08771D0353ECE4A409B16BEE9B6E164C0503CCF3552D04A408BFA689435E164C09BF7CE357AD04A40AF7DBEE9CADF64C0A85ECF351ECF4A401975BEE937E064C0483CCF3592D14A406030BEE96FE164C007CC7AE08CD34A40525BBEE9FEE164C02C04258B4FD54A40E71C699411E264C0D7B2CE3562D74A40515BBEE99EE164C0403CCF3512D94A408AFA6894E5E064C05CA3CF3536DA4A40311FBEE949DE64C0A85ECF359EDB4A40F538BEE952DD64C098427AE09CDB4A40C927BEE99CDC64C0CF48258B27DA4A403AAD6894DADB64C0B0C5CF3542D64A40D3B56894ADDB64C0975ECF351ED44A40515BBEE99EDB64C09F5ECF35DED04A409916BEE966DB64C09F5ECF35DED04A4068BE689450DB64C0EC19CF3506D24A407C25699434DB64C02CB979E0ECD24A409B16BEE9F6DA64C00C17268B6FD44A4088FA689495DA64C0543CCF3592D34A40A2A46894A7D964C09F5ECF35DED04A40A4A4689477DA64C028D5CE356ED84A40A5A4689487DA64C0DCB2CE35A2DA4A40C827BEE92CD964C0433CCF3592D84A403BAD68948AD864C028D5CE356ED84A40F638BEE9E2D764C038D5CE35AED94A404D1469943ED864C02004258B8FD94A409A16BEE996D864C05CA3CF35B6D94A402ED86894E9D864C05F7479E014DA4A40F638BEE932D964C0DCB2CE35A2DA4A407C25699494D864C060A3CF3576DB4A40E51C699431D764C0E048258B67DB4A4001C7689493D664C008E8CF354EDC4A40C827BEE97CD764C070557BE0FCDC4A4021036994D8D964C0CFB2CE3562DD4A402FD8689449DC64C024B979E0ACE04A40E41C6994C1DC64C0DCB2CE35E2E04A4096CF689406DE64C08B8D258B7FE24A40525BBEE9FEDE64C0BC107BE0E4E24A40F2F16894B2DF64C030D5CE352EE24A40C4E068945CE064C033D5CE352EE14A40244ABEE938E164C024B979E0ACE04A40525BBEE94EE364C0985ECF35DEE64A40301FBEE939E364C09C427AE01CE74A405CE968941FE364C0DF48258BE7E74A404E1469940EE364C044B6D035D6E84A409916BEE916E364C08071D0357EE94A40FFC6689443E364C027D5CE35AEE94A40F738BEE9C2E364C030D5CE356EE94A402ED8689429E464C02C04258B8FE94A408E41BEE9A5E464C0707479E054E94A408F41BEE9D5E464C08071D0357EE94A405DE96894FFE464C063A3CF3536EA4A405CE968940FE564C000CC7AE0CCEB4A40301FBEE929E564C017E8CF358EEC4A403AAD68943AE564C08071D035BEED4A40C6E06894DCE464C0A85ECF355EEE4A407D25699464E464C08071D035BEEE4A402ED8689429E464C020B979E02CEF4A404E1469940EE464C0C4C5CF3502F04A40525BBEE94EE364C070557BE0FCF34A408F41BEE9C5E264C0F8CB7AE0CCF54A409B16BEE996E164C0F835248B87F84A404F146994FEE064C0747479E094FA4A406D05BEE9B0E064C0D893D0350AFB4A40020EBEE973DF64C048D2258B17FA4A406130BEE91FDF64C058A3CF3576FA4A4096CF689406DE64C008CC7AE0CCFC4A40E61C699451DD64C018B979E06CFD4A408F41BEE9A5DC64C014E8CF358EFD4A40F4F1689402DC64C0707479E014FD4A409916BEE966DB64C0780AD035DAFB4A404F1469949EDA64C050A3CF35B6FD4A40D3B56894EDD864C0680AD0355A004B405E30BEE91FD864C00CCC7AE00C024B40D2B56894BDD764C0284FD035B2004B40F638BEE9E2D764C037B6D03556FF4A40A3A4689417D864C0C0C5CF3502FE4A40F638BEE9E2D764C008CC7AE0CCFC4A400103000000010000000E000000BA52BEE9DBAF64C088427AE09C044B400655133F84B164C013E8CF354E034B40FC7F133FF3B164C024337BE0B0034B409E5D133F47B264C010E8CF35CE044B40EEAA133F42B264C0680AD0359A054B408F41BEE9E5B064C0D0FD79E044084B404BCD133FAEB064C00B9D248B6B084B401875BEE987B064C07F71D0353E084B406377133F90B064C008E8CF358E074B409C16BEE966B064C06F557BE0BC064B401CBC133FE8AF64C07826258B1B064B40254ABEE9A8AF64C0B7C5CF3582054B405F30BEE9AFAF64C087DB79E0F8044B40BA52BEE9DBAF64C088427AE09C044B40010300000001000000140000009C16BEE916A864C0334FD035F2094B40321FBEE9E9A764C09CF7CE35BA084B40C4E06894DCA764C0EC93D0354A074B40EB63BEE961A864C044B6D03516084B40525BBEE9AEA864C0F035248B47084B40234ABEE9F8A864C00081CF352A084B40244ABEE918A964C0304FD035B2074B40525BBEE95EA964C08871D035FE054B40254ABEE968A964C0985ECF359E054B402ED86894D9A964C0A87A248B1F064B40535BBEE96EAA64C008E8CF358E084B407E256994D4AA64C0A05ECF351E094B40254ABEE968AC64C088F7CE35FA084B407C25699484AD64C0F780CF35EA094B40FEC66894E3AE64C054877AE074094B40BC52BEE98BAF64C0F780CF35EA094B40C927BEE90CAC64C0D048258BA70B4B40264ABEE988A864C0D048258BA70B4B40E51C699451A864C028D5CE35EE0A4B409C16BEE916A864C0334FD035F2094B400103000000010000002D000000F4F16894029E64C0EC19CF3506104B40264ABEE9D89D64C040D2258B970E4B40050EBEE9139E64C05BA3CF35B60C4B40D4FCBDE97D9E64C054877AE0F40A4B40EA63BEE9E19E64C0F780CF35EA094B40B80B69943B9F64C0204FD035B2094B40254ABEE9B8A164C0F780CF35EA094B403BAD6894DAA264C04F3CCF3512094B4089FA689445A364C0A05ECF351E094B40F3F1689472A364C054877AE074094B40264ABEE9B8A364C0A05ECF359E0A4B405F30BEE9EFA364C088427AE0DC0A4B40C927BEE91CA464C04FA3CF35B60A4B408AFA689495A464C0F780CF35EA094B40D6FCBDE99DA664C018B979E0EC0A4B402ED8689439A764C0D048258BA70B4B40806CBEE904A764C0B0C5CF35020D4B40D3B56894CDA664C0908D258BFF0D4B407D25699484A664C00817268BAF0E4B40CA27BEE91CA664C0C82CD035260F4B40CA27BEE9DCA564C0C82CD035260F4B40AF7DBEE97AA564C0E019CF35860E4B40F3F1689442A564C0740AD0355A0E4B4088FA6894F5A464C0E3FD79E0C40E4B40F4F1689482A464C0483CCF3592104B40E51C699441A464C098F7CE35FA104B40331FBEE909A464C0F816268BAF104B40AE7DBEE9DAA364C0483CCF3512104B40D1B56894BDA364C0FF16268B6F0F4B403AAD6894BAA364C0C82CD035260F4B4068BE689480A364C0E393D0354A0F4B40D6FCBDE91DA364C0C0107BE0E40F4B405CE96894EFA264C0EC19CF3506104B40321FBEE979A264C0503CCF35D20F4B40D2B568940DA264C0E3FD79E0440F4B4022036994A8A164C00417268B6F0E4B40244ABEE948A164C0D02CD035660D4B40BD52BEE9DBA064C0E3FD79E0440E4B40F1F16894A29F64C0503CCF35D20F4B40826CBEE9649F64C094F7CE35BA104B40535BBEE91E9F64C0EC19CF3506104B401775BEE9D79E64C00036248BC7104B406130BEE98F9E64C0E893D0350A114B409B16BEE9469E64C00036248BC7104B40F4F16894029E64C0EC19CF3506104B4001030000000100000038000000525BBEE9FEBB64C0483CCF3552164B409C16BEE956BB64C058A3CF3576154B403CAD68949ABA64C054877AE0F4154B40F638BEE912BA64C090F7CE35FA174B402203699498B964C0BBC5CF3542164B405CE968944FB864C0D8B2CE35E2144B4097CF6894A6B764C0740AD0359A134B40D5FCBDE94DB864C08871D0357E124B40AF7DBEE94ABA64C07C0AD035DA114B40AF7DBEE94ABA64C098F7CE35FA104B40B07DBEE9EAB964C07B557BE0FC104B4097CF6894F6B864C0EC19CF3506104B4097CF6894A6B764C0EC19CF3506104B40EA63BEE981B564C08C71D0357E104B40A5A4689407B564C0EC19CF3506104B407E25699444B564C0C82CD035260F4B404D146994BEB564C038D5CE35AE0C4B40F1F1689462B664C0670AD0355A0B4B40254ABEE9A8B864C014E8CF350E094B40D6FCBDE9FDB864C058A3CF35F6084B40B07DBEE96AB964C0A05ECF351E094B4097CF689486BA64C0AF7A248B9F0A4B402CD86894D9BA64C088427AE0DC0A4B408AFA689445BB64C090427AE09C094B40816CBEE964BC64C0C82CD035A6044B40F738BEE9D2BC64C0E0FD79E044044B40F638BEE912BD64C0E0B2CE35A2054B40F638BEE932BD64C0BC107BE0E4064B40E863BEE961BD64C01CE8CF35CE074B40515BBEE9CEBD64C00081CF352A084B40535BBEE99EBE64C0E019CF35C6074B403CAD6894EABE64C07B71D035FE074B404E1469941EBF64C0A05ECF351E094B4000C76894A3BF64C0503CCF3592074B40D4FCBDE9BDC064C0BC7A248BDF054B40D5FCBDE94DC164C0F880CF35AA044B403CAD68946AC264C00081CF352A084B40C6E068941CC264C027D5CE35EE094B406B05BEE990C264C008CC7AE0CC0B4B40CA27BEE9ECC364C0C82CD035260F4B40C927BEE97CC364C098F7CE35FA104B40311FBEE9B9C364C07C0AD035DA114B401875BEE967C364C0C4107BE024134B40535BBEE9EEC264C018B979E0EC154B40D2B568949DC264C0700AD0351A174B40A4A4689447C264C04C877AE0B4174B40B07DBEE91AC164C048D2258BD7184B408AFA689415BF64C04CD2258B171C4B40E71C699441BE64C02CB979E06C1C4B407C256994E4BD64C0F019CF35461C4B405F30BEE92FBD64C0A85ECF359E1B4B408D41BEE925BC64C0503CCF35521B4B40501469940EBC64C0707479E0D41A4B40501469942EBC64C0C0107BE0E4194B40A4A4689447BC64C0E348258B67184B40525BBEE9FEBB64C0483CCF3552164B400103000000010000000A000000EEAA133F929864C057A3CF35361B4B40C4E06894BC9864C03F207AE0D01A4B404F1469945E9964C05C58248B131B4B403466133FDA9B64C038B6D03556184B400855133F349C64C0F816268BEF184B40EA63BEE9419C64C0908D258B7F194B401F036994989964C0089D248B2B1D4B40020EBEE9439964C088DB79E0F81C4B401BBC133FC89864C0A8F4258B231C4B40EEAA133F929864C057A3CF35361B4B400103000000010000003D000000BD52BEE99BB064C040B6D03596224B40826CBEE9F4B064C0BC107BE064214B40B07DBEE97AB164C030B6D03556204B4020036994F8B164C0DC93D0350A1F4B4067BE6894C0B164C038B6D035161E4B402203699488B164C0A87A248B9F1E4B4069BE689450B164C0DC93D0350A1F4B406130BEE96FB164C09C5ECF351E1D4B40FFC6689483B164C02CB979E06C1C4B40050EBEE933AE64C0AC5ECF359E194B40E963BEE961AD64C040D2258B971A4B40EB63BEE9F1AC64C010E8CF358E184B4069BE689490AD64C0F816268B6F174B40F3F16894A2AE64C0EF19CF3506174B40BC52BEE98BAF64C0700AD0351A174B40BC52BEE98BAF64C098F7CE353A164B40AE7DBEE92AAF64C070557BE03C154B402FD8689459AF64C04B3CCF35D2144B40030EBEE933B064C0BC107BE064144B40331FBEE9E9B064C0D8FD79E004134B409B16BEE946B164C038B6D03596124B4067BE6894C0B164C0D42CD035A6124B4069BE689450B164C07C0AD035DA114B4068BE6894A0B164C0D848258BA70F4B40C4E068942CB264C0CF2CD035660E4B40A3A46894D7B264C0284FD035320E4B40806CBEE984B364C0C82CD035260F4B40545BBEE9FEB364C0204FD035F2104B409A16BEE9F6B364C0543CCF3592124B402203699498B364C0AFC5CF3542144B406030BEE90FB364C098F7CE353A164B40A4A4689437B464C0E819CF3546184B4001C76894F3B364C047877AE0B4194B40F3F1689412B364C0740AD0355A1B4B40F638BEE962B264C038B6D035161E4B40264ABEE938B364C098F7CE35FA1E4B409916BEE9E6B564C038B6D035161E4B406E05BEE9C0B564C09C427AE0DC1F4B40D5FCBDE98DB564C0707479E094214B40E51C699441B564C0B8107BE0E4224B405DE96894CFB464C0D848258B67234B406ABE689450B464C09C5ECF355E234B404E1469942EB464C08C71D035BE234B406E05BEE910B464C0304FD035F2254B40040EBEE9E3B364C06FBF248BF7254B40A4A46894A7B364C090F7CE357A254B4098CF689426B364C0E819CF35C6244B402ED8689419B364C0D848258BE7234B40C6E068941CB364C07771D035FE224B406030BEE90FB364C054877AE074224B403BAD6894CAB264C0A05ECF351E224B401F036994B8B264C02804258B4F224B409916BEE9A6B264C0687479E0D4224B40F638BEE962B264C0D848258B67234B405BE96894FFB064C038D5CE35AE254B40BB52BEE96BB064C0DF93D0350A264B40E71C6994D1AF64C00417268BEF254B4022036994B8AF64C0AC5ECF351E254B409C16BEE906B064C038B6D03556244B4000C76894A3B064C0E893D0354A244B40BD52BEE99BB064C040B6D03596224B40010300000001000000070000008F41BEE9B54E64C050D2258B972E4B40525BBEE93E4F64C02B04258B4F2E4B408AFA6894355064C094F7CE35FA2E4B40B2C4133F6B5064C0503CCF35922F4B409E5D133F574F64C010337BE0B02F4B4050146994EE4E64C0204FD035322F4B408F41BEE9B54E64C050D2258B972E4B40010300000001000000110000009A16BEE9F64C64C08471D035FE314B40311FBEE9D94C64C0C3107BE064314B40331FBEE9A94C64C0C3107BE064314B40A3A46894C74B64C00C17268B2F324B40A3A46894C74B64C0C3107BE064314B40254ABEE9384D64C050D2258B972F4B40525BBEE9EE4D64C0A05ECF359E2F4B408AFA6894854E64C050877AE0F4304B40D2B568945D4F64C0304FD03572334B4000C76894834F64C0D0FD79E004344B4020036994884F64C09CF7CE35FA344B401F036994684F64C054877AE0B4354B40C6E068941C4F64C0FC35248B07364B40525BBEE99E4E64C0E0FD79E0C4354B40A4A46894174D64C0D0FD79E004344B40244ABEE9084D64C0A45ECF35DE324B409A16BEE9F64C64C08471D035FE314B400103000000010000001900000068BE6894905A64C098F7CE357A364B404BCD133F9E5A64C0DCFD79E004364B4058A2133FCF5A64C0677479E014364B40F3F16894D25A64C040877AE0F4354B40BC52BEE91B5A64C0344FD035B2354B4086B3133F555964C0908D258B7F334B40CC6E133F0D5964C030207AE010324B4022036994385964C06458248B53324B401975BEE9375964C057EE7AE0D8314B40040EBEE9035964C0AFA97AE080314B40525BBEE99E5864C01C04258BCF314B403566133FBA5864C0533CCF3552314B40301FBEE9A95864C0FC647AE0A8304B40F3F16894525864C0ACA97AE0C02F4B40264ABEE9B85864C0F880CF35EA2F4B405CE96894DF5964C07B0AD0351A324B403AAD68942A5A64C070557BE07C334B402A91133F595B64C040877AE0F4354B408C41BEE9655B64C0BFC5CF3542364B40BC52BEE92B5B64C050D2258B57364B40E963BEE9015B64C018B979E0AC364B40E61C6994015B64C0F816268B2F374B409388133FF65A64C047D2258B97374B400655133FC45A64C0F019CF3546374B4068BE6894905A64C098F7CE357A364B4001030000000100000027000000F3F16894E25364C054A3CF35363A4B40E61C6994B15364C0CF2CD035263A4B407C256994445364C0A85ECF355E3A4B40A4A46894075364C054A3CF35363A4B409C16BEE9065364C08C8D258BFF394B4096CF6894F65264C00817268B6F394B404E146994DE5264C02FB6D035D6384B403BAD6894CA5264C05BA3CF3576384B403766133FCA5264C05BA3CF3576384B402ED86894995164C0E0FD79E0C4354B40CA27BEE97C5164C0687479E014354B4000C76894735164C06B7479E094334B40CA27BEE97C5164C0607479E014324B402ED86894995164C0C3107BE064314B40321FBEE9F95464C00C17268B2F324B4068BE6894B05464C0985ECF355E314B406E05BEE9605464C0483CCF35D2304B40311FBEE9095464C010E8CF358E304B4039AD6894AA5364C0F019CF3586304B4039AD6894AA5364C0C42CD035A62F4B40535BBEE93E5464C06F0AD0359A2F4B40234ABEE9B85464C014E8CF350E304B409C16BEE9A65564C0C3107BE064314B4068BE6894505764C00881CF35AA324B406E05BEE9205864C020B979E06C344B40FEC66894135964C003CC7AE04C354B40BC52BEE97B5964C054877AE034364B403CAD6894EA5A64C0C4C5CF35023B4B40AE7DBEE94A5A64C0204FD035323B4B40E963BEE9515A64C0C02CD035A63C4B4022036994885A64C07C0AD0359A3E4B403BAD68947A5A64C08C8D258B3F404B40AE7DBEE90A5A64C01CE8CF358E404B406C05BEE9605964C0EB93D0350A404B408D41BEE9455864C0938D258B7F3E4B40E61C6994815764C0F019CF35063E4B4089FA6894155664C0687479E0543C4B407E256994045564C09C8D258BBF3B4B40F3F16894E25364C054A3CF35363A4B4001030000000100000014000000FC7F133FB34B64C03F207AE090524B40EDAA133FC24B64C08326258B1B524B401DBC133FA84B64C0780AD0355A524B40040EBEE9934B64C0908D258BBF524B406E05BEE9804B64C00081CF35AA524B40545BBEE98E4B64C018337BE0F0514B40E1D5133F814B64C008E8CF358E514B40D6FCBDE99D4B64C07CDB79E078514B40501469948E4B64C0988D258BFF504B40F0AA133FB24B64C04C877AE0F44F4B40525BBEE9FE4B64C0A8F4258BA34F4B402891133F094C64C04C877AE0F44F4B406C05BEE9304C64C038B6D03596504B40E1D5133F414C64C074557BE03C514B409A16BEE9164C64C044207AE090514B40E3D5133FF14B64C0DB777BE048524B405BE96894EF4B64C070BF248BB7524B40B2C4133FDB4B64C06058248B13534B409F5D133FB74B64C06C557BE0FC524B40FC7F133FB34B64C03F207AE090524B4001030000000100000016000000D6FCBDE9DDF063C04FA3CF3536614B40EA63BEE981F163C0888D258B7F604B401975BEE937F263C040B6D03596604B40B80B6994DBF263C07C557BE03C614B40545BBEE9FEF263C0D048258B27624B40F738BEE9E2F263C008CC7AE04C634B409C16BEE9F6F263C00817268BAF644B403CAD68941AF363C0F035248B07664B402ED8689449F363C008CC7AE00C674B4088FA689455F363C098F7CE35FA674B40C827BEE91CF363C078557BE0FC684B402CD86894B9F263C0978D258B7F694B401875BEE947F263C0938D258B3F694B40D5FCBDE9DDF163C0700AD0355A684B407C25699474F163C00817268B2F674B40D4FCBDE9CDF063C038D5CE35AE654B406030BEE9AFF063C0F0647AE068654B406030BEE9AFF063C0E048258B67654B40B70B69947BF063C088F7CE35BA644B40A5A4689467F063C0C02CD035A6634B40D2B568947DF063C0C82CD03566624B40D6FCBDE9DDF063C04FA3CF3536614B4001030000000100000014000000C099133F7CB060C0D048258B27644B40EDAA133FB2B060C0B0107BE024624B405CE96894EFB060C058EE7AE058624B401DBC133F68B160C0D8FD79E0C4634B402ED8689479B160C0A013248B7B644B4096CF689466B160C0ACF4258BA3654B40826CBEE964B160C064EE7AE058664B4097CF689476B160C0D8B2CE35A2664B406F05BEE970B160C067EE7AE018674B40E863BEE971B160C0306B258B73684B407E25699464B160C0B0A97AE040694B404C1469946EB160C04B877AE0746A4B408F41BEE935B160C0CC9679E0E06A4B400755133FF4B060C0BC7A248B5F6A4B401E036994A8B060C08871D035FE684B4095CF6894A6B060C074BF248B37684B4095CF6894A6B060C054877AE034684B40826CBEE9A4B060C0306B258B73674B40E3D5133F81B060C0908D258BFF654B40C099133F7CB060C0D048258B27644B40010300000001000000060000000855133F245C64C030D5CE356E734B4055A2133F1F5C64C0503CCF3552724B403766133F6A5C64C06B7479E094724B409A16BEE9A65C64C0C09679E060734B40FA7F133F735C64C0D848258B27744B400855133F245C64C030D5CE356E734B40010300000001000000440000006C05BEE9909760C000CC7AE0CC754B4038AD68943A9760C0670AD0351A754B40FC7F133FE39660C0C82CD03526754B4056A2133F8F9660C08471D035BE754B40E1D5133F419660C0948D258BBF764B406030BEE9EF9560C0D048258BE7754B40030EBEE9939560C0700AD0355A754B4021036994489560C093F7CE35BA744B40311FBEE9299560C0D848258BA7734B40C3E06894FC9460C09CF7CE357A734B40806CBEE9949460C014E8CF35CE734B40FB7F133F239460C064A3CF35B6734B40311FBEE9D99360C008E8CF354E724B406E05BEE9B09360C050877AE0F4704B40D4FCBDE9BD9360C0C02CD03526704B408D41BEE9F59360C090F7CE35FA6F4B40555BBEE94E9460C010E8CF358E704B4095CF6894569460C0E093D0350A6F4B404E1469942E9460C0700AD0359A6D4B40CF6E133F1D9460C0F419CF35866C4B401E036994689460C0730AD0351A6C4B40B4C4133FDB9460C030B6D035566C4B402A91133F399560C04FA3CF35B66C4B40264ABEE9989560C0EF35248BC76C4B404F1469940E9660C0730AD0351A6C4B404E1469949E9560C00317268B2F6B4B40B07DBEE96A9560C00CE8CF350E6A4B407F256994349560C048D2258B17694B40331FBEE9B99460C0F716268BAF684B40FB7F133F639460C0334FD03532684B40B2C4133F0B9460C0BCC5CF3502674B40FC7F133FC39360C02C04258B8F654B40C827BEE99C9360C0543CCF3552644B401975BEE9B79360C018E8CF354E614B4038AD68945A9460C054877AE0F4604B40BC52BEE92B9560C0E793D0354A624B40E3D5133FD19560C0543CCF3552644B40244ABEE9E89560C060A3CF35F6644B404F1469940E9660C0D8B2CE35A2664B401775BEE9279660C040B6D03556674B40264ABEE9589660C0B4107BE0E4674B40826CBEE9D49660C038B6D03596684B401775BEE9079760C0A87A248B1F694B4058A2133F1F9760C000CC7AE0CC694B409A16BEE9469760C04F3CCF35926B4B40D7FCBDE95D9760C0730AD0351A6C4B4069BE6894909760C048877AE0746C4B4057A2133FFF9760C01F4FD035B26C4B40D5FCBDE93D9860C014E8CF350E6D4B40030EBEE9B39860C09C5ECF355E6E4B40C2E06894DC9860C0985ECF355E6F4B40030EBEE9F39860C00481CF356A704B402A91133F399960C0A45ECF35DE714B40274ABEE9689960C0204FD03572734B40D5FCBDE93D9960C08C427AE09C744B402891133F099960C0975ECF359E754B40CE6E133F1D9960C0948D258BBF764B408D41BEE9E59860C0B47A248B9F774B40C2E06894BC9860C0543CCF3512774B40D5FCBDE93D9860C000CC7AE0CC754B407D256994049860C033D5CE352E774B40535BBEE99E9760C08FF7CE35BA774B409A16BEE9269760C068BF248BF7774B4096CF6894B69660C028B979E06C784B409C16BEE9D69660C038D5CE356E774B401F036994089760C0D32CD035A6764B409E5D133F479760C0670AD0351A764B406C05BEE9909760C000CC7AE0CC754B4001030000000100000015000000AE7DBEE91AE963C028B979E06C784B40B90B69949BE863C08871D035FE764B40C827BEE9ECE763C01804258B0F774B40F2F1689442E763C0988D258B7F774B40D0B56894CDE663C00317268B2F774B404E146994AEE663C0483CCF3592754B408E41BEE905E763C0483CCF3512744B40F2F16894E2E763C0A45ECF35DE714B40BB52BEE92BE963C05F7479E0946F4B40B90B69942BEA63C08871D0353E714B406030BEE96FEA63C054877AE034744B40AE7DBEE98AE963C000CC7AE0CC754B40F4F16894D2E963C08871D035FE764B40AD7DBEE92AEA63C0E819CF3586774B40A4A4689487EA63C0D02CD035A6774B4039AD6894DAEA63C0B47A248B9F774B406030BEE94FEA63C094427AE01C784B40F838BEE9D2E963C0A45ECF351E794B40B07DBEE95AE963C0473CCF35D2794B40D4FCBDE9DDE863C0A85ECF355E794B40AE7DBEE91AE963C028B979E06C784B4001030000000100000014000000B70B6994EB4864C014E8CF350E6D4B4000C76894E34964C030D5CE352E6B4B40F838BEE9F24A64C058A3CF35766B4B40AE7DBEE9FA4B64C0204FD035326D4B40311FBEE9D94C64C038D5CE35AE6F4B40F638BEE9924D64C00017268BEF724B407D256994E44D64C0E893D0350A754B409C16BEE9F64D64C0948D258BBF764B40A2A46894A74D64C0D02CD03526784B405DE96894FF4B64C00C81CF352A7A4B40826CBEE9044B64C0DCB2CE35227C4B404E146994AE4964C00881CF352A7E4B401975BEE9674864C0A85ECF359E7E4B40BB52BEE99B4764C00481CF35EA7B4B401875BEE9774764C07871D0357E7A4B405CE968945F4764C060A3CF3536784B4098CF6894564764C040B6D035D6754B40030EBEE9634764C0E4B2CE3522744B408D41BEE9A54764C030D5CE356E724B40B70B6994EB4864C014E8CF350E6D4B4001030000000100000021000000B07DBEE9BA6760C0988D258BBF7C4B40C927BEE99C6760C0F019CF35067B4B409D16BEE9966760C0E393D0358A794B40C3E06894CC6760C028B979E06C784B40C3E06894CC6760C0B47A248B9F774B408D41BEE9C56660C0F816268BAF764B40E863BEE9516660C000CC7AE0CC754B40AF7DBEE93A6660C0E4B2CE3522744B4066BE6894806660C0E493D0354A734B40A05D133FA76760C0E019CF3506714B40E763BEE9016860C010E8CF358E704B407E256994246960C0985ECF35DE704B401875BEE9976960C0E093D0358A704B40F3F16894126A60C0E893D0354A6F4B40264ABEE9986A60C07C557BE03C6E4B40050EBEE9336B60C0204FD035326E4B40F1F16894D26B60C017E8CF35CE6E4B40FA38BEE9626C60C038D5CE35AE6F4B409D16BEE9666C60C038D5CE352E714B4083B3133FA56D60C0204FD035F2734B40F0F16894226E60C000CC7AE0CC754B40B4C4133FFB6E60C0E493D035CA744B40D5FCBDE96D6F60C098F7CE357A764B40545BBEE94E6F60C01CB979E0EC784B40FD7F133F736E60C00C81CF352A7A4B407C256994C46D60C0A85ECF355E7A4B40FA7F133FE36B60C0E719CF35C67B4B408F41BEE9456B60C0985ECF35DE7C4B406D05BEE9906A60C014E8CF350E7B4B40E2D5133F716860C0780AD0359A7F4B4057A2133F8F6760C00081CF356A7F4B40C3E06894CC6760C0A85ECF359E7E4B40B07DBEE9BA6760C0988D258BBF7C4B400103000000010000000A000000B3C4133FDB3B64C01F337BE0707E4B40B4C4133F2B3C64C090F7CE35FA7D4B40EA63BEE9513D64C0D32CD03526824B40C827BEE95C3D64C08471D035BE824B404E1469942E3D64C020337BE030834B409A16BEE9D63C64C038D5CE35EE824B40F2F16894323C64C0AB7A248B1F814B40C6E06894BC3B64C0E493D0354A804B40B3C4133FAB3B64C0D02CD035667F4B40B3C4133FDB3B64C01F337BE0707E4B40010300000001000000860000008AFA6894357864C098F7CE35BA874B406D05BEE9D07564C02FD5CE35AE854B40AF7DBEE94A7264C008CC7AE04C874B40F4F16894D27064C094427AE09C854B4069BE6894407164C01704258B8F854B4096CF6894767164C02B04258BCF844B401775BEE9777164C038B6D03596834B40A4A46894477164C0975ECF351E824B405E30BEE9FF7064C07871D0353E814B408AFA6894457064C0C0C5CF3542804B40254ABEE9586F64C04C3CCF35127E4B40040EBEE9C36E64C0B7C5CF35427C4B40BA52BEE93B6E64C0503CCF35127A4B4021036994C86D64C0B47A248B9F774B4039AD68948A6D64C067557BE0BC744B40331FBEE9796D64C038B6D035D66E4B40806CBEE9346D64C043B6D035966C4B405F30BEE9EF6B64C060A3CF3576654B409A16BEE9566B64C02F4FD03572634B408E41BEE9856A64C0C0C5CF3502624B40816CBEE9B46964C0BFC5CF3582614B408BFA6894756764C098F7CE35BA614B408E41BEE9256764C0700AD0351A624B40321FBEE9E96664C017E8CF35CE624B407F6CBEE9A46664C0E0B2CE35E2634B40C827BEE95C6664C038B6D03556644B409B16BEE9066664C0DCB2CE3522644B40AF7DBEE9AA6564C00C17268BAF634B408AFA6894556564C02F4FD03572634B40CA27BEE99C6464C0700AD0359A624B405BE968941F6464C00336248B87604B407D256994746364C09C8D258B7F5B4B4068BE6894306364C048877AE0345A4B401775BEE9E76264C0E048258B67594B406030BEE99F6264C0D893D035CA584B40C927BEE95C6264C0B0C5CF3502584B40B07DBEE92A6264C0948D258B7F574B40B80B6994CB6164C0B8C5CF3542564B40525BBEE99E6164C0C0C5CF3502554B4098CF6894066264C027D5CE356E544B40321FBEE9F96464C0EC19CF3546554B406E05BEE9706564C0B8C5CF3542564B407C256994F46464C073557BE07C564B40C5E06894AC6364C0B0C5CF3502584B406C05BEE9106464C0E019CF3506594B40BB52BEE97B6464C06C7479E094594B4068BE6894F06464C00436248BC7594B406E05BEE9706564C0C4C5CF35C2594B40D2B56894ED6564C00436248B47594B401575BEE9E76664C05FA3CF3576574B40C5E068944C6764C000CC7AE00C574B40E61C6994A16764C033D5CE356E574B40D2B56894ED6764C007E8CF354E584B40E51C6994616864C0274FD035325A4B4096CF6894B66864C0E0FD79E0C45A4B40F638BEE9926964C0A05ECF35DE5A4B401675BEE9076A64C09C8D258B7F5B4B406D05BEE9206B64C0EC93D0354A604B40F638BEE9D26B64C08C427AE0DC614B40F738BEE9E26C64C0E0B2CE35A25F4B40C4E068945C6D64C0284FD035F25E4B40B80B6994CB6D64C0747479E0145E4B40B70B6994FB6D64C02004258BCF5C4B40525BBEE9BE6D64C040D2258B97584B4021036994C86D64C000CC7AE00C574B405DE968945F6E64C027D5CE35EE544B4098CF6894367064C00717268BEF534B403BAD68949A7064C04C877AE074514B408BFA6894157164C0403CCF3552514B40BD52BEE9EB7364C02404258B4F4E4B40F638BEE9B27564C0B3107BE0E44E4B4096CF6894467964C0E448258BA7514B40525BBEE93E8464C0F019CF35C64F4B40B80B6994DB8564C098427AE01C4E4B40CA27BEE9FC8664C02C04258B8F4C4B40C827BEE98C8A64C04C877AE074444B40030EBEE9B38A64C03CD5CE356E434B4098CF6894A68A64C08B71D035FE414B406030BEE98F8A64C088F7CE353A414B40B80B69948B8A64C04F3CCF3552404B40030EBEE9B38A64C0938D258B7F3E4B405E30BEE98F8B64C0FF16268BAF3A4B403BAD6894FA8C64C010E8CF35CE374B4068BE6894A08E64C0B4107BE0E4354B405CE968942F9064C060BF248BF7344B4020036994589264C00081CF35EA344B403AAD68947A9364C054D2258B57344B40E963BEE9419464C00881CF35AA324B40E863BEE9E19464C027B979E02C324B40C3E06894AC9964C068BF248BB7334B404F1469946E9A64C0C72CD035A6344B40C6E068940C9B64C054877AE034364B406030BEE9EF9B64C0F419CF35863A4B40040EBEE9739C64C0FC35248B473C4B40D2B568941D9D64C038B6D035D63C4B406030BEE9EF9C64C04C3CCF35923F4B40FFC66894339D64C0A75ECF351E414B40A4A46894979D64C0F880CF352A424B403BAD6894CA9D64C03CD5CE356E434B4068BE6894E09D64C0988D258B7F454B401975BEE9179E64C0C3C5CF3582474B40321FBEE9A99E64C0D32CD035E64A4B4097CF6894069E64C0DC48258BA74C4B4022036994189D64C0700AD0355A4E4B40E61C6994219C64C0E3B2CE35A24F4B405AE968947F9964C060A3CF3536514B40A4A46894A79764C008E8CF358E534B40BC52BEE96B9664C0543CCF35D2564B402BD86894399264C0E0B2CE35226B4B401975BEE9D79164C0730AD0351A6C4B40040EBEE9839164C08071D035FE704B4096CF6894569164C03FD2258B97714B401775BEE9478F64C0975ECF359E754B4068BE6894808E64C0BF2CD03566764B40311FBEE9C98C64C0948D258BBF764B40301FBEE9198C64C0A87A248B1F764B4069BE6894C08A64C048877AE034734B40BC52BEE90B8A64C008E8CF354E724B40030EBEE9338764C0E019CF3586724B4067BE6894D08664C00717268B2F734B405E30BEE9BF8664C00036248B47744B405F30BEE92F8764C000CC7AE0CC754B40331FBEE9198664C054D2258B97784B40806CBEE9048564C07871D0357E7A4B40E863BEE9D18364C0403CCF35927B4B405CE968949F8164C018E8CF354E7C4B4021036994D88064C08CF7CE353A7D4B403AAD68948A7F64C00081CF356A7F4B40B952BEE9FB7D64C08FF7CE35BA834B408F41BEE9557D64C0E048258BA7844B40D5FCBDE95D7A64C094427AE09C854B40040EBEE9B37964C0D02CD03526864B403CAD6894FA7864C0C42CD03526874B408AFA6894357864C098F7CE35BA874B4001030000000100000022000000C6E068945CEB63C0E019CF35C6844B405CE968949FEB63C0CF2CD035A6844B407E256994F4EB63C0E048258BA7844B40F838BEE942EC63C0CB2CD03566844B408E41BEE985EC63C0403CCF35D2834B40E71C6994A1EC63C0948D258B3F834B40B80B69947BEC63C08871D035FE824B40F4F1689422EC63C0F816268B2F824B405CE968949FEB63C050D2258B57804B4039AD6894DAEA63C0985ECF35DE7C4B4089FA6894D5EC63C0C0107BE0A4794B408D41BEE9E5ED63C008E8CF358E784B404F146994CEEE63C0A85ECF355E794B40F2F1689472EE63C028D5CE356E7A4B402203699478EE63C0C02CD035A67B4B403AAD68949AEE63C0FCCB7AE0CC7C4B40E61C699491EE63C00881CF35AA7D4B40F638BEE942EE63C030B6D035167E4B40C6E068947CED63C038D5CE35AE7D4B40525BBEE90EED63C00881CF35AA7D4B401875BEE937ED63C044877AE0F47E4B401875BEE997ED63C0AC5ECF35DE834B40C827BEE90CEE63C024B979E0AC834B408E41BEE975EF63C0975ECF351E824B409A16BEE9B6EE63C0D8B2CE35E2844B402FD8689489EE63C0A85ECF355E864B404F146994CEEE63C028D5CE356E874B404F146994CEEE63C097F7CE353A884B4096CF689436EE63C018E8CF35CE874B40331FBEE9A9EB63C09B5ECF355E874B401675BEE957EB63C0C0C5CF3502874B40D2B568940DEB63C068557BE07C864B40BC52BEE92BEB63C01CE8CF354E854B40C6E068945CEB63C0E019CF35C6844B40010300000001000000090000009E5D133F073E64C0F019CF3586864B406C05BEE9003E64C064BF248B37854B409A16BEE9663E64C0204FD035B2854B40EA63BEE9013F64C0189D248BAB884B402DD86894E93E64C000CC7AE08C894B40CD6E133FAD3E64C044207AE0D0894B405CE968948F3E64C00036248B07894B409E5D133F673E64C07826258BDB874B409E5D133F073E64C0F019CF3586864B4001030000000100000010000000B4C4133FCB6D64C0F835248BC7884B409A16BEE9C66D64C01C9D248B2B884B405E30BEE93F6D64C0985ECF355E884B40C199133F0C6D64C0C09679E020884B40E963BEE9D16C64C0F716268B6F884B401975BEE9976C64C000CC7AE00C894B401F036994686C64C03F3CCF3512894B40EFAA133FA26C64C078557BE03C884B409C16BEE9566D64C0D8777BE048874B40040EBEE9F36D64C0647479E094874B4089FA6894456E64C0F7647AE0A8884B40D3B568944D6E64C010E8CF358E894B40545BBEE98E6D64C0D893D035CA8A4B40F2F16894D26B64C00336248B478C4B403AAD6894BA6B64C02C04258B0F8C4B40B4C4133FCB6D64C0F835248BC7884B40010300000001000000080000001293C56A146660C0807053EA2F864B40EEDDDE1CEB6660C0DFF4B1A625864B407B3F9218286860C028BD60BEDC884B40A1E54210D06760C0E78C6406DF8B4B40DA173AF0866660C048029148128E4B40B4AF1C840D6660C0C098F23D3D8D4B4088AE36BF046660C0D37102089C894B401293C56A146660C0807053EA2F864B4001030000000100000010000000CD6E133F0D3264C00B81CF35AA874B4022036994D83264C0D4777BE088874B40BD52BEE99B3364C0A87A248BDF884B40535BBEE9AE3364C0189D248B2B894B40535BBEE92E3364C02C04258B0F8B4B40EDAA133F223364C048877AE0B48B4B409C16BEE9263364C030D5CE356E8C4B407C256994843364C050D2258BD78D4B404ACD133F9E3364C0E893D0358A8E4B40A4A46894A73364C0C8E1248B038F4B406E05BEE9203264C0E8647AE0288C4B40CC6E133FBD3164C037D5CE35AE8A4B408D41BEE9953164C070BF248B77894B40E2D5133F913164C0A813248BBB884B40FB7F133FA33164C034D5CE356E884B40CD6E133F0D3264C00B81CF35AA874B4001030000000100000026000000E81C6994613764C000CC7AE08C944B40D4FCBDE95D3764C054877AE0F4934B402ED86894693764C0EC19CF35C6934B4068BE6894803764C0BCC5CF35C2934B40545BBEE99E3764C02CB979E0AC934B40EA63BEE9D13664C028D5CE356E924B408AFA6894253564C090F7CE35BA904B408AFA6894853464C0FFCB7AE04C8F4B40FEC66894E33464C06C0AD0359A8D4B40EB63BEE9F13564C04B3CCF35928B4B40301FBEE9493664C07B0AD0351A894B40A4A46894C73664C09C427AE01C8A4B406E05BEE9303764C0B4C5CF3582894B40A4A46894973764C0E893D0354A884B402DD86894093864C028D5CE356E874B401975BEE9A73864C014E8CF358E874B40AE7DBEE91A3964C000CC7AE08C884B407C256994843964C088427AE0DC894B409041BEE9053A64C030D5CE35EE8A4B40EA63BEE9D13964C07871D0353E8C4B406030BEE9CF3864C0304FD035B28F4B40E41C6994B13864C0304FD03532914B406030BEE90F3964C004CC7AE08C924B409041BEE9053A64C000CC7AE08C944B4000C76894E33964C02304258B8F924B40D1B56894FD3964C094427AE09C904B406E05BEE9703A64C028D5CE35AE8C4B40030EBEE9E33A64C010E8CF354E8E4B409916BEE9E63B64C0DC93D0358A8F4B407D256994943C64C0C0107BE024914B40EA63BEE9D13C64C044B6D03516914B404E146994FE3C64C09BF7CE353A914B405F30BEE90F3D64C098427AE05C924B404E146994FE3C64C0483CCF35D2934B40D5FCBDE9CD3C64C097F7CE353A944B4020036994883C64C08C71D0353E944B4067BE6894003B64C033D5CE35EE954B40E81C6994613764C000CC7AE08C944B40010300000001000000240000007E256994549960C0D048258B27964B40B4C4133FBB9760C040B6D03516934B406E05BEE9209760C0F8CB7AE00C914B40EA63BEE9619560C068557BE07C864B401F036994D89560C0CB2CD03566844B408E41BEE9059860C00081CF356A7F4B40A05D133F479860C0483CCF3512814B40836CBEE9949860C0BF2CD03566824B4086B3133F559960C0E048258BA7844B407E256994549960C08471D035BE814B4021036994189A60C0B8C5CF3502824B40826CBEE9F49B60C0E048258BA7844B40F0F16894929B60C04C3CCF35D2854B40EB63BEE9A19A60C09B8D258B3F864B40F2F16894729A60C064A3CF35F6864B402891133F599A60C034D5CE356E884B40CC6E133F1D9A60C0607479E094894B40FD7F133FD39960C0E048258B678A4B40F2F16894929960C030D5CE35EE8A4B406E05BEE9F09960C01CE8CF358E8B4B4020036994789A60C098427AE01C8C4B40254ABEE9689B60C028D5CE35AE8C4B40040EBEE9939B60C00C81CF356A8D4B40E0D5133FB19B60C0737479E0148F4B40EA63BEE9C19B60C0780AD035DA904B40CE6E133FBD9B60C08C71D035BE924B4068BE6894D09B60C050A3CF35B6934B40EA63BEE9C19B60C000CC7AE08C944B404E1469949E9B60C08871D035BE944B40050EBEE9639B60C03CD5CE35AE944B40CD6E133F2D9B60C0D42CD035E6944B40A05D133FF79A60C030D5CE35EE964B40555BBEE9AE9A60C0A35ECF35DE974B40FC7F133F539A60C0D3B2CE3562984B40CC6E133FFD9960C0A75ECF351E984B407E256994549960C0D048258B27964B40010300000001000000130000009C16BEE9562B64C07C0AD0355A9C4B40040EBEE9E32A64C0F835248B079C4B40F2F16894D22A64C0C02CD035669B4B40D2B56894ED2A64C05FBF248B779A4B40F2F16894D22A64C0707479E054994B40C6E06894AC2A64C0B0C5CF3582984B40B80B69949B2A64C04C3CCF3512984B406E05BEE9902A64C0F8CB7AE04C974B408AFA6894952A64C00CE8CF35CE954B406ABE6894F02A64C0677479E0D4944B40264ABEE9882B64C0985ECF35DE944B4088FA6894D52B64C00881CF352A954B40F4F16894822D64C06C557BE0BC974B40EA63BEE9112E64C0C0C5CF3542994B405CE96894FF2D64C094F7CE353A9A4B40C5E06894AC2D64C07C0AD0355A9B4B403BAD68942A2D64C048D2258B179C4B402ED86894E92B64C0FCCB7AE00C9C4B409C16BEE9562B64C07C0AD0355A9C4B40010300000001000000450000008E41BEE9C5F063C0FFCB7AE04C8F4B40321FBEE9B9F063C030B6D035168A4B408E41BEE9C5F063C07B0AD0351A894B40F2F16894D2EF63C0607479E014884B40D6FCBDE9ADEF63C028D5CE356E874B40BA52BEE9CBEF63C050D2258B17864B407E25699424F063C00817268B6F854B40501469948EF063C02BD5CE356E854B40E61C6994E1F063C004CC7AE00C864B402ED8689499F163C0304FD03572894B40040EBEE903F263C00317268BEF8A4B40806CBEE984F263C007E8CF35CE8B4B40EC63BEE9A1F263C0304FD035728A4B40D2B56894ADF263C03F3CCF3512894B407F6CBEE9A4F263C08C71D035BE874B40806CBEE984F263C068557BE07C864B40E71C699401F363C07871D0357E864B401875BEE9D7F363C008CC7AE04C874B407D25699444F463C028D5CE356E874B402203699478F463C0B8107BE0E4864B40264ABEE998F463C068BF248BF7854B403AAD6894BAF463C0D893D0358A854B40E61C6994F1F463C068557BE07C864B402203699418F563C038B6D03556884B406ABE6894F0F463C0C4107BE064894B407D25699444F463C030D5CE35EE8A4B40E41C699411F463C067BF248B378B4B407E256994E4F363C01BE8CF350E8B4B40D2B56894BDF363C01BE8CF350E8B4B40C727BEE99CF363C007E8CF35CE8B4B40F4F1689492F363C0F880CF35AA8C4B405F30BEE99FF363C028D5CE352E8D4B40EA63BEE9C1F363C00C81CF356A8D4B40F738BEE9F2F363C098F7CE357A8D4B409C16BEE9A6F463C02BB979E06C8E4B405F30BEE9CFF463C024B979E02C904B40CA27BEE97CF463C0C0107BE024914B4098CF6894F6F263C0680AD0351A8E4B401975BEE977F263C040B6D035568E4B40254ABEE978F263C0747479E0948F4B40E963BEE931F363C0F8CB7AE00C914B404F146994BEF263C0D893D0350A924B40806CBEE9A4F163C0204FD03532924B40D3B568946DF163C07B557BE03C934B40535BBEE9AEF163C048D2258B57944B406130BEE9EFF263C060A3CF35F6944B40826CBEE964F363C08471D0357E954B40040EBEE9A3F263C028B979E0AC964B40E61C6994B1F263C088F7CE35BA984B40B07DBEE9DAF263C017B979E0AC9A4B40BB52BEE96BF263C0E893D0358A9B4B40D5FCBDE9FDF163C0747479E0949B4B40020EBEE9D3F163C00036248BC79B4B408E41BEE9B5F163C0607479E0549C4B40D3B568946DF163C098427AE05C9D4B40D7FCBDE94DF163C0FC80CF356A9E4B40E51C699441F163C0D0B2CE35A29F4B4000C7689413F163C0D0B2CE3522A04B40F838BEE992F063C00436248B079F4B40BC52BEE9ABF063C088F7CE35FA9C4B401875BEE9F7F063C090F7CE35BA9B4B401F03699448F163C064A3CF35B69A4B40D3B568946DF163C0700AD0355A994B40311FBEE939F163C08071D0357E974B40311FBEE9C9F063C000CC7AE08C964B404F1469945EF063C0DCB2CE3522964B40331FBEE939F063C0D32CD035E6954B40020EBEE963F063C0C02CD035A6944B408E41BEE9C5F063C0FFCB7AE04C8F4B400103000000010000008B000000D6FCBDE9FDA160C0F035248B87974B401775BEE917A260C07B557BE03C934B40311FBEE9C9A160C0284FD03572924B40B4C4133F5BA060C00817268BEF904B4020036994E89F60C048D2258B17904B408E41BEE9D59F60C0E0FD79E0448F4B409F5D133FC79F60C0EF19CF35C68C4B4086B3133FB59F60C007E8CF35CE8B4B40264ABEE9989E60C097F7CE353A884B40040EBEE9839F60C08CF7CE35BA894B404C1469949EA060C01F4FD035728C4B40E1D5133FC1A160C0204FD035F28D4B40806CBEE9C4A260C007E8CF35CE8B4B4020036994E89F60C097F7CE353A884B4020036994E89F60C028D5CE356E874B40B17DBEE90AA160C00817268B6F864B40806CBEE974A160C068557BE07C864B40806CBEE974A160C094427AE09C854B40FD7F133F73A060C028B979E06C844B4086B3133F759F60C0730AD0351A844B407D256994A49E60C078557BE0FC824B40264ABEE9289E60C00081CF356A7F4B40F638BEE9229E60C00C81CF352A7A4B40264ABEE9289E60C0A85ECF355E794B402891133FD99D60C0F419CF3506794B40FC7F133F039D60C0EC19CF35C6794B40C5E068949C9C60C0A85ECF355E794B402991133FD99C60C028B979E06C784B40B5C4133F9B9C60C060A3CF3536784B40040EBEE9839C60C0C4C5CF3502784B407C256994649C60C0B47A248B9F774B40535BBEE98E9C60C08CF7CE35FA764B402991133FD99C60C03CD5CE35EE744B40254ABEE9889B60C07871D0353E734B4067BE6894009B60C008E8CF35CE714B40CA27BEE9DC9A60C038D5CE35AE6F4B40F738BEE9629A60C0F019CF3506704B407E256994149A60C0FFCB7AE00C6F4B4056A2133F0F9A60C0888D258B7F6D4B40F2F16894729A60C0730AD0351A6C4B40EFF16894029A60C0E4FD79E0846B4B40AE7DBEE91A9960C0A45ECF351E6B4B40D4FCBDE9AD9860C00C17268B6F6A4B40A05D133F679860C0F735248B87694B40A05D133F479860C093F7CE35BA684B4068BE6894309860C0CFB2CE35E2674B408E41BEE9059860C09F5ECF35DE664B404C1469941E9760C0D42CD03566634B40816CBEE9349760C098F7CE353A624B408E41BEE9059860C0483CCF35D2604B40D5FCBDE9CD9760C0B87A248BDF5F4B40264ABEE9089860C0A45ECF359E5F4B4055A2133F1F9860C00781CF356A5F4B40D5FCBDE93D9860C0988D258BFF5E4B40F638BEE9929660C0DF93D0354A5D4B4094CF6894069660C0C02CD035E65B4B404D1469947E9660C0C4C5CF35C2594B403AAD68947A9560C02C4FD035B2564B40AE7DBEE9FA9560C0D8FD79E044564B40CE6E133F2D9760C05CA3CF35B6564B40D5FCBDE93D9860C0B8C5CF3542564B4087B3133F959860C047877AE0B4584B4094CF6894669960C0740AD0355A594B40274ABEE9F89A60C008E8CF35CE584B404F146994FE9A60C0E0B2CE3562594B40B4C4133F4B9B60C008CC7AE00C5C4B40F2F16894A29B60C0D8FD79E0045E4B407E256994A49B60C028B979E0EC5E4B408E41BEE9659B60C04C3CCF35525F4B40CA27BEE9DC9A60C0988D258BFF5E4B407E256994049E60C0747479E0D4644B40264ABEE9989E60C09F5ECF35DE664B40E1D5133F319E60C014E8CF354E674B404C1469949E9D60C090427AE05C684B409B16BEE9269D60C00036248BC7694B40E2D5133F119D60C01BE8CF354E6B4B404C1469947E9D60C00417268B2F6C4B409D16BEE9269E60C0F035248BC76B4B4059A2133F5F9F60C00C17268B6F6A4B408E41BEE9F59F60C0AFC5CF35426B4B40311FBEE939A060C088427AE0DC6E4B40555BBEE9AEA060C038D5CE35AE6F4B405F30BEE92FA160C00CE8CF354E704B40F0F1689492A160C00436248BC7714B408E41BEE9A5A160C0DBFD79E084734B401875BEE937A160C03CD5CE35EE744B407F256994B4A160C098F7CE357A754B40F738BEE932A260C090F7CE35BA754B402991133F39A360C000CC7AE0CC754B402991133F39A360C0948D258BBF764B40CF6E133F6DA260C0403CCF3552774B40301FBEE909A260C0E019CF35C6774B405E30BEE9DFA160C028B979E06C784B406F05BEE910A260C09CF7CE353A794B40E963BEE981A260C0C4C5CF3582794B40C3E068946CA360C0A85ECF355E794B405E30BEE93FA460C0908D258BBF784B40FC7F133F73A460C07771D035FE784B40BB52BEE9BBA460C00C81CF352A7A4B40CE6E133F9DA460C017E8CF354E7A4B4086B3133F85A460C0EC19CF35467B4B40A05D133F97A460C00FE8CF358E7C4B40040EBEE9F3A460C00881CF35AA7D4B4068BE689450A460C027D5CE35AE7F4B402991133FE9A460C05FA3CF35B6824B406F05BEE980A660C028D5CE356E874B4068BE689460A660C0680AD0355A884B40836CBEE984A660C0AB5ECF359E894B40F738BEE9C2A660C098427AE01C8B4B4069BE6894F0A660C028D5CE35AE8C4B40FC7F133F63A560C040B6D035568C4B40C4E06894DCA360C028D5CE35AE8C4B4084B3133F75A460C010E8CF35CE8E4B4057A2133F0FA660C0747479E0948F4B406F05BEE980A660C0F8CB7AE00C914B40020EBEE9D3A560C0F8CB7AE00C914B4069BE6894F0A660C02CB979E0AC934B408E41BEE995A660C0334FD035F2934B40020EBEE9D3A560C090427AE09C934B40040EBEE963A560C02CB979E0AC934B4057A2133FAFA560C00036248B07954B40BC52BEE9FBA560C0D4FD79E004964B405F30BEE95FA660C090F7CE357A964B4069BE6894F0A660C0D893D0354A964B4069BE6894F0A660C00881CF352A974B40040EBEE9F3A460C0FF80CF35EA984B40B4C4133F0BA660C09B427AE05C9B4B4085B3133F35A660C02C4FD035729C4B40020EBEE9D3A560C0DF48258B279E4B406E05BEE950A560C0A05ECF351E9F4B40A05D133F97A460C0770AD035DA9F4B40F3F16894E2A360C00C81CF352AA04B40C3E068946CA360C0687479E0D49F4B409D16BEE916A360C030B6D035D69D4B4087B3133F45A360C0304FD035329C4B408E41BEE955A360C0687479E0149B4B4094CF6894A6A260C0F880CF35AA9A4B40F838BEE922A260C073BF248BB7994B40D6FCBDE9FDA160C0F035248B87974B4001030000000100000010000000C927BEE90C3264C088427AE09C9A4B40525BBEE95E3264C09B8D258B7F9A4B409A16BEE9F63264C02804258B8F9A4B40030EBEE9633464C0F419CF35C6984B4095CF6894A63464C0CF2CD035E6984B406E05BEE9403564C03CD5CE356E994B40254ABEE9A83564C0B77A248B9F994B40F2F16894223664C038B6D035169B4B40D6FCBDE9DD3564C008E8CF358E9D4B4088FA6894153564C0F419CF35069F4B40264ABEE9983364C0B87A248B5F9F4B40FDC66894E33164C0443CCF3592A04B40D6FCBDE98D3164C08C427AE05CA04B4022036994683164C00CCC7AE0CC9E4B4098CF6894D63164C0985ECF359E9B4B40C927BEE90C3264C088427AE09C9A4B40010300000001000000470000008F41BEE9456B60C0304FD035B28F4B406F05BEE9606B60C02F4FD035B28E4B40806CBEE9946B60C04CD2258B978D4B40A05D133FB76B60C060BF248B778C4B4057A2133F9F6B60C0A45ECF355E8B4B402A91133F296B60C090F7CE35FA894B40AF7DBEE90A6B60C034B6D03516894B404E1469940E6B60C028D5CE356E874B40CA27BEE96C6B60C00081CF352A844B4020036994186C60C0E093D0354A824B406030BEE9EF6C60C0204FD03572814B402B91133F196F60C0A75ECF359E804B4020036994586F60C014E8CF35CE804B401975BEE9876F60C033D5CE352E824B4066BE6894806F60C040D2258B57834B403AAD68946A6F60C00817268B6F844B40E763BEE9716F60C094427AE09C854B40C827BEE9CC6F60C0687479E054874B4068BE6894707060C08471D0357E894B4039AD68941A7160C0CC2CD035268B4B401675BEE9877160C0A45ECF355E8B4B401875BEE9977160C0E819CF35C6894B40C3E068942C7160C0988D258B3F884B40C4E06894CC7060C0C82CD03566864B40535BBEE9FE7060C0AC5ECF35DE834B40E863BEE9417160C0B0107BE0E4824B40B4C4133F9B7160C0D0B2CE35E2814B40D5FCBDE94D7260C0A05ECF355E804B401E036994687260C018E8CF350E804B405F30BEE97F7260C027D5CE35AE7F4B401975BEE9A77260C0E048258B677F4B408F41BEE9F57260C00081CF356A7F4B40AF7DBEE92A7360C0E4FD79E0C47F4B404C1469944E7360C0C0107BE064804B40244ABEE9687360C07C557BE0FC804B40EA63BEE9817360C07871D0353E814B40BD52BEE9FB7360C090F7CE353A824B40331FBEE9C97360C0C4C5CF3582844B401875BEE9977260C0F035248B878B4B40D4FCBDE9AD7260C0C4C5CF35428C4B40D7FCBDE92D7360C028D5CE35AE8C4B409D16BEE9A67260C0533CCF3512904B404E1469940E7260C00481CF352A904B403AAD68946A7160C024B979E02C8F4B40E1D5133FC17060C0FFCB7AE04C8F4B40CF6E133F8D7060C020B979E02C914B40E863BEE9017160C018B979E06C934B402F1FBEE9B97160C088427AE05C954B40D5FCBDE94D7260C0D893D0354A964B404E1469942E7260C048877AE0B4964B40B4C4133FFB7160C0284FD035B2974B404C146994DE7160C0A75ECF351E984B4058A2133F4F7260C0344FD03532994B40CE6E133F9D7260C0D048258B679A4B40826CBEE9C47260C078557BE0FC9B4B40FD7F133FC37260C0DF48258B279E4B40321FBEE9997260C028D5CE356EA04B408C41BEE9557260C048D2258B57A14B40F2F16894F27160C0D8FD79E0C4A14B402A91133F697160C09C427AE09CA24B4096CF6894A67160C0D02CD03566A34B406030BEE9FF7060C07C0AD0351AA34B40CD6E133F1D7060C0C4107BE0E4A14B408C41BEE9556F60C03CB6D03556A04B406D05BEE9706E60C0C3107BE0A49C4B4020036994A86C60C0533CCF35929B4B40D5FCBDE9ED6B60C0E393D035CA994B406030BEE90F6C60C0E048258B67974B406130BEE9CF6B60C04F877AE0F4944B407D256994746B60C0B8107BE064924B408F41BEE9456B60C0304FD035B28F4B40010300000001000000690000006E05BEE980FD63C0D048258B679C4B406B05BEE9F0FC63C018E8CF358E9A4B40A2A4689457FD63C040B6D03516944B40244ABEE9D8FC63C02CD5CE35EE914B40EB63BEE961FC63C040B6D03516934B406C05BEE900FC63C07C0AD0351A964B406E05BEE970FB63C0730AD0355A984B40C727BEE96CFA63C00881CF352A974B409C16BEE9A6FA63C070BF248BF7954B40B60B6994DBFA63C06F7479E094924B407E25699414FB63C0F8CB7AE00C914B40806CBEE924FB63C050877AE034914B402DD86894F9FB63C048D2258B17904B40C6E068940CFC63C05CA3CF35768F4B40EC63BEE901FC63C08FF7CE35BA8E4B40545BBEE9FEFB63C0EC19CF35068E4B409A16BEE926FC63C098F7CE357A8D4B40A3A46894B7FC63C02CB979E06C8D4B402003699418FD63C02F4FD035B28E4B40E863BEE971FD63C0B0C5CF3542904B40B70B6994EBFD63C0F8CB7AE00C914B40E963BEE961FE63C0988D258B7F904B40254ABEE9F8FE63C0F880CF35AA8D4B4000C7689473FF63C028D5CE35AE8C4B4096CF689496FE63C030D5CE356E8A4B4098CF689446FE63C00481CF35EA884B407E256994B4FE63C097F7CE353A884B40A4A46894670064C0DBB2CE3522894B406130BEE9FF0064C07B0AD0351A894B40D0B568948D0064C0DCFD79E0C4864B40B80B69948B0064C00BCC7AE0CC854B40826CBEE9740164C0AC5ECF35DE834B40D1B56894AD0264C060BF248B777F4B40A4A46894270464C0B0107BE0A47B4B40254ABEE9F80464C028B979E06C784B40D3B56894DD0564C0A87A248B9F754B4022036994480664C0A05ECF35DE734B40B70B6994AB0664C0680AD035DA6F4B4069BE6894200764C0B0107BE024704B408E41BEE9950764C078557BE0BC714B40B07DBEE9CA0764C0D848258BA7734B405E30BEE9AF0764C00381CF35AA764B404E1469945E0764C094427AE09C774B4000C76894D30664C0E4FD79E004784B40B80B69940B0664C0A85ECF355E794B405F30BEE99F0464C014E8CF35CE804B40501469942E0464C0B8C5CF3502824B40C3E06894AC0364C0FCCB7AE00C834B40321FBEE9390364C0D7B2CE3562844B40A4A46894F70264C068557BE07C864B4098CF6894960564C028D5CE356E874B4098CF6894960564C097F7CE353A884B40525BBEE92E0564C038B6D035D6884B406C05BEE9C00464C034B6D03516894B409B16BEE9D60364C07B0AD0351A894B40E61C6994010464C01BE8CF358E8A4B40AF7DBEE94A0464C02CD5CE35AE8B4B40244ABEE9A80464C00081CF356A8C4B406D05BEE9900564C064A3CF35368D4B40D5FCBDE90D0664C0D0B2CE35628E4B40BC52BEE93B0664C00CE8CF358E8F4B406D05BEE9D00564C048D2258B17904B407C256994E40464C0543CCF35928F4B4020036994380364C068557BE03C8D4B405EE968944F0264C028D5CE35AE8C4B406D05BEE9B00264C0C0C5CF35C28E4B40E61C6994A10364C06B7479E0D4914B40030EBEE9130464C02CB979E0AC934B40311FBEE9890364C040B6D03596944B407E256994040364C040B6D03516944B404E1469948E0264C0483CCF35D2924B4001C76894330264C07C71D0357E914B40CA27BEE90C0264C08871D0357E904B40244ABEE9080264C02004258BCF8F4B406E05BEE9F00164C028B979E06C8F4B408C41BEE9450164C00481CF352A8F4B40F2F16894020164C0E093D035CA8E4B40816CBEE9C40064C064A3CF35368E4B406030BEE98F0064C098F7CE357A8D4B40F3F16894720064C0647479E0D48D4B4000C76894530064C010E8CF354E8E4B405F30BEE91F0064C0FFCB7AE04C8F4B40C927BEE99C0064C0A45ECF351E914B40B60B6994CB0164C067BF248B37974B40A4A46894170264C0E393D035CA994B4096CF689466FF63C0D7FD79E0C4964B40040EBEE983FE63C0AFC5CF3582964B4068BE689440FF63C0F880CF35AA9A4B406030BEE9DFFE63C02C4FD035F29A4B401875BEE987FE63C050D2258BD79A4B405F30BEE92FFE63C098F7CE35FA9A4B406030BEE9CFFD63C098F7CE35FA9B4B401875BEE9C7FD63C0274FD035F29C4B40B60B6994FBFD63C093427AE01C9E4B40BC52BEE93BFE63C0E893D0354A9F4B40B90B69945BFE63C018E8CF354EA04B40EB63BEE911FE63C0DCFD79E0C4A04B40EA63BEE9C1FC63C0E019CF3586A44B407B25699464FC63C0EC19CF3506A64B405EE968940FFC63C01704258BCFA44B402DD86894F9FB63C0740AD0355AA44B40D5FCBDE9ADFB63C0C42CD03526A04B406C05BEE900FC63C0503CCF35929E4B40E863BEE9B1FC63C0DB48258BE79D4B406E05BEE980FD63C0D048258B679C4B400103000000010000000E0000009C16BEE9265F64C0ACA97AE0C0A04B409088133F465F64C0344FD03572A04B404BCD133F6E5F64C0F816268BEFA04B400755133F645F64C070BF248BF7A14B409E5D133F675D64C06CEE7AE0D8A84B401DBC133FF85C64C078557BE07CA94B401975BEE9B75C64C0D09679E020A94B4021036994D85C64C0E448258BA7A84B40545BBEE93E5D64C097F7CE35FAA74B4086B3133FA55D64C0CFB2CE35E2A64B404F146994DE5D64C068BF248B37A54B401775BEE9F75E64C0F019CF3506A24B403666133F1A5F64C088427AE05CA14B409C16BEE9265F64C0ACA97AE0C0A04B400103000000010000002E0000006C05BEE920A960C0304FD035B2A84B407E25699454A960C0BCC5CF3582A64B40A05D133F37AA60C09C427AE09CA24B40F638BEE952A960C0D048258BA7A14B40264ABEE9F8A860C098427AE01CA44B40545BBEE94EA860C0EC93D0350AA44B40535BBEE97EA760C0E019CF3506A34B40FD7F133FB3A660C09C427AE09CA24B4067BE689440A760C09C5ECF355EA04B40B07DBEE97AA760C0C4C5CF35029F4B4058A2133FAFA760C050877AE0349C4B409B16BEE9F6A760C060A3CF35B69B4B40826CBEE9B4A860C0E893D0358A9B4B4056A2133FCFA960C09B8D258BFF994B40D7FCBDE91DAA60C0E393D035CA994B40F2F1689482AA60C098F7CE35FA994B40F838BEE9B2AA60C0204FD035729A4B401875BEE9D7AA60C0D8FD79E0049B4B409F5D133F17AB60C0E893D0358A9B4B40F3F16894D2AB60C00881CF356A9C4B40C927BEE93CAC60C038B6D035969C4B40BA52BEE96BAC60C098F7CE35FA9B4B40321FBEE989AC60C0F019CF35C69A4B40FD7F133FD3AC60C0DCFD79E0049A4B40555BBEE92EAD60C0344FD035B2994B40FA7F133F83AD60C0E393D035CA994B4020036994F8AD60C018E8CF350E9B4B40F2F1689442AE60C06B7479E0549D4B4086B3133F65AE60C00036248B07A04B40FD7F133F63AE60C09C427AE09CA24B4055A2133FFFAD60C0F019CF3506A24B409C16BEE996AD60C028B979E0ACA14B40EA63BEE931AD60C0F835248BC7A14B409C16BEE9D6AC60C09C427AE09CA24B409D16BEE9E6AD60C040D2258B97A44B40B4C4133F2BAE60C0A85ECF351EA64B40806CBEE9D4AD60C0948D258B3FA84B4068BE689440AD60C090F7CE35BAA84B40BB52BEE98BAC60C0AF107BE064A84B407E25699414AC60C0DB93D0358AA84B40264ABEE938AC60C088F7CE357AAA4B40A05D133F87AB60C093427AE09CAA4B40A05D133FD7AA60C030D5CE352EAB4B40D6FCBDE92DAA60C0C82CD03566AB4B4056A2133F8FA960C088F7CE357AAA4B406C05BEE920A960C0304FD035B2A84B40010300000001000000100000009C16BEE9060164C0D42CD03526A84B40A4A46894470164C010E8CF354EA74B4088FA6894550264C05CA3CF3576A74B403BAD68941A0364C02004258B4FA84B40D1B568947D0364C0304FD035B2A94B4020036994780364C070557BE0BCAA4B40D5FCBDE92D0364C014E8CF358EAB4B40BC52BEE9BB0264C054877AE0F4AB4B40E41C6994210264C0AF7A248B1FAC4B401975BEE9F70164C098427AE0DCAB4B4000C76894E30164C03CB6D03556AB4B404F146994AE0164C030D5CE35AEAA4B40244ABEE9280164C0A0A97AE0C0A94B40244ABEE9280164C0908D258BBFA94B40545BBEE90E0164C0E093D0354AA94B409C16BEE9060164C0D42CD03526A84B40010300000001000000170000009C16BEE9A60A64C050D2258B17AD4B407D256994640A64C034D5CE352EA84B40BA52BEE95B0A64C0E493D035CAA54B40301FBEE9690A64C0D02CD03566A34B40F838BEE9C20A64C0687479E0D49F4B40321FBEE9190B64C0503CCF3512A04B4001C76894930B64C0D048258BA7A04B406030BEE9FF0B64C00381CF356AA14B408F41BEE9D50C64C048877AE0B4A44B4000C76894F30F64C0F816268BAFA64B40E963BEE9011164C0740AD0359AA94B40B60B69949B1064C0B87A248BDFA94B40826CBEE9441064C058A3CF3576AA4B40F638BEE9221064C0D0FD79E044AB4B403AAD68945A1064C060BF248B37AC4B40806CBEE9940F64C050A3CF3536AD4B408F41BEE9C50E64C0344FD035F2AC4B40C927BEE9FC0D64C02804258B4FAC4B40B80B69944B0D64C060BF248B37AC4B40E71C6994C10B64C00481CF35EAAE4B40BC52BEE90B0B64C0908D258B7FAF4B40301FBEE9690A64C0C4107BE0E4AD4B409C16BEE9A60A64C050D2258B17AD4B400103000000010000005B000000331FBEE9191664C0C02CD03566A74B40D2B56894BD1564C0C0C5CF3542A74B405DE968940F1564C07C0AD035DAA74B40D6FCBDE9ED1464C0C0C5CF3542A84B40D6FCBDE9CD1464C00481CF352AA94B408BFA6894A51464C01804258B0FAA4B40331FBEE9691464C088F7CE357AAA4B40AF7DBEE92A1464C030B6D03556AA4B409B16BEE9C61364C07F71D035BEA94B401775BEE9871364C0740AD0359AA94B40321FBEE9591364C030B6D03556AA4B40A4A46894471364C050D2258B17AE4B40E41C6994311364C068BF248BB7AF4B40F2F16894E21264C0D8B2CE3522B14B40AE7DBEE96A1264C0780AD0351AB24B408BFA6894E51164C0503CCF3552B24B40CA27BEE96C1164C050A3CF3576B14B4000C76894231164C0DCB2CE35A2AE4B4097CF6894A61164C00C81CF352AAC4B40EB63BEE9611264C054D2258B97A94B40E61C6994C11264C050A3CF3576A64B40F638BEE9A21264C00CCC7AE08CA44B401875BEE9571264C040D2258B97A34B40BB52BEE9FB1164C0985ECF35DEA24B40321FBEE9A91164C0D048258BA7A14B402CD86894791164C014E8CF350EA04B4021036994981164C098427AE05C9F4B404E1469948E1264C0DF48258B279E4B40321FBEE9091264C00881CF356A9D4B4088FA6894E51064C0B37A248B1F9D4B403AAD68945A1064C0D048258B679C4B40525BBEE93E1064C0DFFD79E0C49B4B40F838BEE9121064C0E4B2CE35A2994B403CAD6894EA0F64C0FF80CF35EA984B406030BEE98F0F64C0E393D035CA984B40A2A46894470F64C0E393D0354A994B40264ABEE9080F64C0E048258B67994B40D2B56894CD0E64C0A75ECF351E984B40525BBEE98E0F64C088F7CE353A974B40F638BEE9121164C01CE8CF350E984B40EC63BEE9E11164C0A75ECF351E984B4021036994981064C0E0B2CE35E2964B403AAD68945A1064C0D893D0354A964B40C827BEE96C1064C0AB5ECF351E954B40321FBEE9391164C0F8CB7AE00C914B407B256994C41164C0D048258B27944B4022036994681264C0483CCF35D2944B406E05BEE9101464C02CB979E0AC934B401875BEE9671464C0687479E0D4934B40F638BEE9521564C0E4B2CE35E2944B40D6FCBDE99D1564C08471D0357E954B40D0B56894ED1564C030B6D03516974B409C16BEE9D61564C030D5CE35EE974B40F638BEE9A21564C0B8107BE0A4984B40D6FCBDE99D1564C0E393D035CA994B40D6FCBDE9DD1564C018E8CF350E9B4B40A5A46894271664C0F019CF35C69A4B40E51C6994811664C0F019CF35C6994B40F3F16894F21664C0FF80CF35EA984B40A4A46894771764C04C3CCF3592984B40D4FCBDE9DD1764C0B0C5CF3582984B40545BBEE93E1864C047877AE034984B40E963BEE9B11864C00881CF352A974B4088FA6894151964C0975ECF355E954B406C05BEE9B01964C0503CCF3512914B407E256994341A64C0FFCB7AE04C8F4B40E51C6994411A64C06C7479E054914B40EA63BEE9011A64C0B8C5CF3542954B40AE7DBEE91A1A64C088F7CE35BA964B40AE7DBEE9DA1A64C040B6D03556994B40D4FCBDE91D1B64C0BCC5CF35829A4B406E05BEE9501B64C0D048258B679C4B4097CF6894461B64C000CC7AE0CC9C4B40C4E068941C1B64C068557BE0FC9E4B40040EBEE9131B64C0687479E0D49F4B401875BEE9271B64C0FC35248BC7A04B409C16BEE9761B64C0C0C5CF3502A24B40264ABEE9881B64C0B0C5CF3502A34B40BA52BEE96B1B64C040877AE0F4A44B40A4A46894371B64C014E8CF35CEA64B40C827BEE91C1B64C0985ECF359EA84B406E05BEE9501B64C088F7CE357AAA4B40244ABEE9481A64C08471D0357EAE4B409C16BEE9161964C0DF48258BE7B14B40545BBEE9BE1764C0B8C5CF3502B44B4089FA6894451664C038B6D03516B44B40D6FCBDE94D1564C0D8B2CE3522B14B407D256994141564C0403CCF3592AE4B406C05BEE9801564C0F880CF35EAAB4B40D2B568947D1664C0D42CD035A6A84B40331FBEE9191664C0C02CD03566A74B400103000000010000000A00000085B3133FF55B64C018E8CF354EAC4B40E61C6994315C64C00436248B87AA4B40F838BEE9225C64C040877AE0B4AB4B402A91133F995B64C0B8C5CF35C2AD4B401DBC133F785964C01804258B4FB14B40D6FCBDE92D5764C07B0AD0355AB44B401DBC133F585664C0A8A97AE080B44B40F97F133F335664C0978D258BFFB34B40E61C6994715664C01C9D248BEBB34B4085B3133FF55B64C018E8CF354EAC4B40010300000001000000230000006E05BEE9307A60C05CA3CF35F6B44B40301FBEE9497660C064A3CF35F6AB4B40B07DBEE95A7460C02404258B4FA64B4087B3133F457460C0D048258BA7A14B4056A2133F6F7460C0543CCF3552A34B40565BBEE9AE7460C058A3CF35B6A44B409E5D133F077560C0F880CF35AAA54B40B4C4133F7B7560C0EC19CF3506A64B40C4E068949C7560C0F419CF3546A54B40F2F16894627560C0FC35248BC7A04B40836CBEE9F47560C087F7CE357A9D4B4093CF6894C67660C0EB93D0354A9E4B40321FBEE9A97760C050D2258B17A04B40E1D5133F717860C0687479E0D49F4B40A05D133F977760C0DCB2CE35E29B4B40E2D5133F117760C08C71D035FE994B40321FBEE9797660C0FF80CF35EA984B40525BBEE9CE7660C067BF248BB7964B406030BEE93F7760C0E893D0354A954B40A05D133F777760C027D5CE35EE934B40E963BEE9217760C02CD5CE35EE914B402A91133FC97760C0D0FD79E044924B40040EBEE9B37860C08471D0357E954B40EA63BEE9C17960C00817268B2F974B40B4C4133F2B7A60C050D2258B57994B40CD6E133F4D7B60C050A3CF3576A64B40CA27BEE94C7B60C058A3CF3576AB4B40C6E068946C7B60C0988D258BBFAD4B40CE6E133FBD7B60C068BF248BB7AF4B40B07DBEE93A7B60C0D893D035CAAF4B4069BE6894107B60C068BF248BB7AF4B40FB7F133F437B60C0E893D0358AB24B4058A2133F2F7B60C0B4C5CF3542B54B40050EBEE9D37A60C0E4FD79E084B64B406E05BEE9307A60C05CA3CF35F6B44B4001030000000100000033000000B17DBEE93AB260C02C04258B4FB64B409F5D133F57B160C0543CCF3512B54B409E5D133F17AF60C010E8CF354EB54B40FD7F133F63AE60C038B6D03516B44B404D1469945EAE60C074BF248B37B24B40F0F1689452AE60C09BF7CE357AB14B4096CF689426AE60C027B979E0ACB04B40FD7F133F63AE60C0C0107BE0E4AF4B409C16BEE9A6AE60C0543CCF3552AF4B406E05BEE9F0AE60C05FA3CF35F6AE4B40CE6E133FEDAF60C048D2258BD7AE4B40BA52BEE92BB060C0C02CD035A6AE4B402A91133F29B060C028B979E02CAE4B40A05D133F17B060C040B6D03596AD4B401775BEE927B060C050D2258B17AD4B40826CBEE984B060C060BF248B37AC4B406030BEE9AFB060C030D5CE35AEAB4B40BC52BEE9DBB060C0F780CF356AAB4B40CA27BEE93CB160C04BD2258B57AB4B40BC52BEE98BB160C0E4FD79E084AB4B40D6FCBDE92DB260C03CD5CE352EAC4B40535BBEE98EB260C060BF248B37AC4B4094CF689426B260C0EB93D0354AAA4B408E41BEE915B260C00C17268BEFA84B40535BBEE98EB260C0D848258B27A54B40525BBEE9CEB260C074557BE0FCA04B407F25699404B360C0700AD0351A9F4B40555BBEE96EB360C0DF48258B279E4B4067BE6894E0B360C0D0FD79E0C49E4B40C3E068945CB460C0D848258B67A04B40B2C4133FFBB460C0D02CD03566A34B402003699408B560C054D2258B57A44B40C927BEE9FCB460C03CD5CE356EA64B40826CBEE914B560C0B07A248B5FA74B40F738BEE942B560C060A3CF35B6A74B40A05D133FC7B560C048D2258B97A74B40D5FCBDE90DB660C07C0AD035DAA74B40B07DBEE94AB560C0BC107BE064A94B40826CBEE914B560C0740AD0359AA94B40545BBEE9AEB460C0304FD035B2A94B409C16BEE986B460C0C4C5CF3502AA4B407F25699474B460C008E8CF358EAA4B40F638BEE9E2B360C038B6D03556AD4B40F0F16894F2B360C0988D258B3FAE4B40B2C4133FFBB460C068BF248BB7AF4B40E0D5133F91B460C0D02CD035E6B04B404E146994AEB360C030D5CE35EEB14B40F738BEE952B360C0F019CF35C6B24B40826CBEE9E4B260C0C02CD03566B54B40020EBEE993B260C007E8CF358EB64B40B17DBEE93AB260C02C04258B4FB64B400103000000010000000C000000F838BEE9726464C0C72CD035A6B34B403AAD6894DA6464C02304258BCFB24B40030EBEE9336564C0483CCF3512B34B4068BE6894806564C074BF248BB7B34B40D3FCBDE93D6664C0403CCF35D2B44B408BFA6894056664C00881CF356AB64B405CE968945F6564C00817268BEFB74B40E41C6994916464C054877AE074B84B40F2F16894426464C0770AD0355AB74B40020EBEE9236464C0D02CD03526B64B407C256994346464C0C02CD035E6B44B40F838BEE9726464C0C72CD035A6B34B4001030000000100000008000000B8FCAA03A0A760C0F8F5C37CF7B44B408FA372A6C8A860C0181AFB71BFB34B4094E30D1716AA60C0C48A8D32C8B34B4052C3F2A53FAA60C0FC622C0329B64B404062C235D5A960C0C44C41E951B74B4042563DB49DA860C0E4BFF45BD3B84B402F57E5C68DA760C0B4CDBE2059B84B40B8FCAA03A0A760C0F8F5C37CF7B44B4001030000000100000020000000816CBEE9940764C0647479E094B94B402ED86894790764C0687479E054B94B402CD86894290764C094F7CE357AB94B40321FBEE9990664C0D0B2CE3522BA4B40C827BEE95C0664C0F835248B47BA4B40301FBEE9790564C0607479E014BA4B40D4FCBDE91D0564C0E393D0358AB94B40254ABEE9F80464C054877AE074B84B40D0B568941D0564C0E048258BA7B64B40311FBEE9190564C0403CCF35D2B44B4096CF6894F60464C018E8CF350EB34B40BC52BEE9BB0464C050A3CF3576B14B40D0B568941D0564C07C71D035BEB04B401975BEE9570564C048877AE034B14B40321FBEE9890564C068557BE03CB24B4000C76894D30564C064A3CF3536B34B405CE968944F0664C08471D035BEB34B403AAD68947A0764C097F7CE357AB44B409C16BEE9E60764C00C17268B6FB54B40D2B568944D0864C008E8CF350EB64B405CE96894BF0864C0607479E054B54B405CE968948F0964C064A3CF3536B34B40525BBEE9FE0964C0B07A248BDFB24B406130BEE97F0A64C050A3CF35F6B24B403BAD6894EA0A64C093F7CE35BAB34B409A16BEE9160B64C00C17268B6FB54B406E05BEE9B00A64C0E793D035CAB84B406ABE6894C00964C00881CF35AABA4B4021036994A80864C0680AD0355ABB4B40B07DBEE9CA0764C0CF48258B27BB4B40040EBEE9A30764C0B7C5CF35C2BA4B40816CBEE9940764C0647479E094B94B400103000000010000001400000086B3133FD5AF60C088F7CE35FAB64B40CF6E133F5DB060C05FA3CF35B6B64B404D1469940EB160C007E8CF350EB74B409C16BEE936B360C0687479E054B94B4058A2133FDFB260C0FCCB7AE04CBB4B4068BE689460B260C0DCB2CE3522BC4B40CF6E133FCDB160C038D5CE35AEBC4B403AAD68943AB160C00436248BC7BD4B403AAD6894CAB060C01F4FD035F2BF4B406D05BEE990B060C0BF2CD035E6C14B40545BBEE92EB060C0BB107BE0E4C24B40F838BEE942AF60C0D42CD03526C24B406C05BEE9D0AD60C018E8CF358EBF4B40FA7F133F83AD60C0C72CD035A6BE4B40030EBEE963AD60C0B37A248BDFBC4B409C16BEE976AD60C038B6D035D6BA4B40F838BEE9B2AD60C0D448258B27B94B40C827BEE90CAE60C054877AE074B84B4069BE6894A0AE60C030D5CE352EB84B4086B3133FD5AF60C088F7CE35FAB64B4001030000000100000014000000264ABEE9C8AA60C060A3CF3576BB4B409F5D133F17AB60C0687479E054B94B40301FBEE989AB60C060A3CF35F6BA4B40040EBEE9A3AC60C0C02CD03566C04B40E0D5133F91AD60C010E8CF354EC24B40C4E06894DCAD60C0707479E094C34B4094CF6894B6AD60C0C42CD035A6C54B40C4E068943CAD60C02704258BCFC64B406030BEE97FAC60C0533CCF3552C74B40EA63BEE961AA60C0E893D0354AC74B406E05BEE9C0A960C02704258BCFC64B40F2F1689432A960C0DCFD79E0C4C54B40826CBEE9B4A860C0CB2CD035E6C34B40020EBEE9B3A860C0F835248B87C14B406130BEE9BFA860C0E893D0350AC04B40D5FCBDE9EDA860C03F877AE0F4BE4B40F638BEE952A960C00436248BC7BD4B407E256994E4A960C00436248BC7BC4B40EA63BEE961AA60C01704258B4FBC4B40264ABEE9C8AA60C060A3CF3576BB4B400103000000010000001F0000004C146994AEB460C0F880CF356AC54B40244ABEE998B360C0473CCF3552C54B409B16BEE9C6B260C0C42CD035A6C54B409D16BEE996B260C068BF248B77C34B407C25699484B260C0F816268B2FC14B408E41BEE9B5B260C0D0B2CE3562BF4B40F738BEE952B360C0C72CD035A6BE4B403AAD6894CAB360C0503CCF35D2BD4B40F538BEE942B460C00C81CF352ABA4B40CA27BEE9DCB460C0687479E054B94B402A91133F79B560C0DCFD79E0C4B94B4085B3133FB5B660C0BC7A248B9FBB4B40CE6E133F5DB760C050877AE0F4BB4B40AD7DBEE9FAB760C00481CF356ABB4B406E05BEE9F0B860C0647479E094B94B40EA63BEE991B960C0687479E054B94B40EA63BEE991B960C0F835248B47BA4B40CD6E133FDDB860C034D5CE356EBB4B40EC63BEE9F1B760C0BCC5CF3582BF4B40CD6E133F6DB660C02C4FD035F2C04B4085B3133F75B660C0D42CD03526C24B40F738BEE9C2B660C02FB6D03556C34B40BD52BEE90BB760C0E048258B27C44B4058A2133F2FB760C008E8CF350EC44B406030BEE94FB760C040877AE034C44B40CE6E133F5DB760C050A3CF3536C54B40E2D5133F41B760C074BF248BF7C54B405F30BEE9FFB660C0B07A248B9FC64B40D7FCBDE97DB660C0C3107BE064C74B40CD6E133FBDB560C02404258B0FC64B404C146994AEB460C0F880CF356AC54B400103000000010000000C0000007B25699444E963C0D793D0354AE24B40AE7DBEE9AAE963C037D5CE352EE14B40D4FCBDE92DEA63C0F419CF3546E24B40050EBEE983EA63C0D7B2CE35A2E34B401775BEE907EB63C040B6D03556E44B401675BEE997EB63C0B7107BE0A4E44B40040EBEE983EB63C00481CF352AE64B4096CF6894A6EA63C08871D035FEE74B40EA63BEE901EA63C030B6D035D6E74B402ED8689489E963C038B6D03596E54B405F30BEE93FE963C058A3CF35B6E34B407B25699444E963C0D793D0354AE24B4001030000000100000028000000311FBEE9D9B260C0BC107BE0E4E74B409D16BEE956B260C0B7C5CF3502E74B409C16BEE986B260C0F319CF3586E94B4096CF689416B260C0FC35248B47EA4B40826CBEE924B060C06B7479E054E94B40254ABEE9D8AF60C08C8D258BFFE84B407E25699494AF60C0EC93D0354AE84B405F30BEE96FAF60C08471D0353EE74B4084B3133F65AF60C08371D0353EE64B402B91133F49AF60C098F7CE357AE54B40E3D5133FF1AE60C028D5CE352EE54B406E05BEE940AB60C040B6D035D6E44B4056A2133FDFAA60C028D5CE352EE54B40CD6E133F8DAA60C0948D258B3FE64B408B41BEE955AA60C008E8CF358EE74B40CB27BEE91CAA60C0BC107BE0E4E74B401775BEE9C7A960C02704258B0FE64B40BA52BEE9EBA960C0B87A248B1FE44B4020036994C8AB60C0AC5ECF351EE14B401875BEE987AC60C0C0C5CF3582DF4B4058A2133F5FAD60C0F019CF3586DE4B40AF7DBEE95AAE60C050D2258B17E04B401675BEE937AF60C0D893D035CAE24B40F938BEE9B2AF60C028D5CE352EE54B4058A2133F1FB060C04B3CCF3512E24B40F0F16894A2AF60C0888D258BFFDD4B409D16BEE996AF60C05CA3CF3576DA4B40254ABEE958B160C0204FD035F2D84B407C25699484B260C08FF7CE353ADA4B4094CF6894F6B360C0B87A248B5FDD4B402A91133F39B560C0A87A248B5FE14B408E41BEE9D5B560C028D5CE352EE54B40A05D133FC7B460C0FF16268BEFE44B4095CF689486B460C028D5CE352EE54B4087B3133F75B460C02C4FD035F2E54B40E863BEE971B460C044B6D03596E84B404D1469944EB460C0D4B2CE35A2E94B40CE6E133FADB360C0D02CD035A6EA4B404C1469943EB360C044B6D03596E94B40311FBEE9D9B260C0BC107BE0E4E74B40010300000001000000180000002ED86894D9D763C070557BE07CEE4B40C827BEE95CD763C05FA3CF3576ED4B40EA63BEE9F1D663C00036248B07EC4B40C6E06894ACD663C027D5CE356EEA4B4089FA6894F5D963C0D0FD79E004EE4B401775BEE977DB63C060A3CF3576EE4B40806CBEE964DC63C027D5CE356EEA4B40D5FCBDE9FDDB63C088F7CE35FAE94B40FEC6689493DB63C03F877AE0B4E94B40C6E068943CDB63C0C0107BE024E94B4068BE689410DB63C00FE8CF35CEE74B4022036994B8DB63C0E0B2CE3522E74B401775BEE947DC63C0533CCF3512E74B402DD86894B9DC63C07B0AD035DAE74B40A2A4689407DD63C0D4B2CE35A2E94B40040EBEE913DD63C00017268BAFEB4B409A16BEE9B6DC63C0DC48258B27EE4B405EE96894CFDC63C044B6D035D6EF4B40EB63BEE951DB63C0E893D0350AF24B405E30BEE97FDA63C00036248BC7F24B408D41BEE955D963C03F877AE0F4F14B40BD52BEE9DBD863C0C0C5CF35C2F04B40806CBEE954D863C0E0B2CE35E2EE4B402ED86894D9D763C070557BE07CEE4B400103000000010000001F0000001775BEE977A860C0E0B2CE35E2EE4B40E2D5133F21A860C0A75ECF359EEE4B40FC7F133F53A760C0E019CF3586EF4B4069BE6894F0A660C0E0B2CE35E2EE4B40CE6E133F0DA760C0E019CF3546E94B401E03699428A760C00FE8CF35CEE74B40C4E068948CA760C0473CCF3592E44B40E863BEE9B1A760C040B6D035D6E34B4096CF689406A860C0503CCF3552E34B4038AD68944AA860C0B07A248BDFE34B40244ABEE988A860C068557BE0BCE44B404F146994CEA860C028D5CE352EE54B40E2D5133F11A960C0CFB2CE35E2E54B406E05BEE9B0A960C00817268BEFE84B40D7FCBDE91DAA60C0D4B2CE35A2E94B4067BE689460AA60C04B3CCF35D2E94B40F1F16894B2AA60C0780AD0355AEA4B40B07DBEE9EAAA60C03CD5CE352EEB4B4056A2133FDFAA60C0B8C5CF3542EC4B405F30BEE99FAA60C090F7CE357AEC4B40F638BEE952A960C010E8CF350EED4B4085B3133F35AA60C0CC2CD03526EE4B40040EBEE993AA60C0BC107BE024EF4B40A05D133FA7AA60C0B77A248B9FF04B40CD6E133F6DAA60C0503CCF35D2F04B40826CBEE954A960C04C877AE074F34B405F30BEE91FA960C0985ECF351EF44B404C1469948EA860C097F7CE357AF34B40244ABEE988A860C0E4B2CE3522F24B40806CBEE9A4A860C09BF7CE357AF04B401775BEE977A860C0E0B2CE35E2EE4B400103000000010000001600000068BE6894407263C094F7CE353AE44B400CE2A5C91C7363C0387720D155E14B40A45FC724287463C04451AFC1A6E14B4088F92DF83C7563C090EA3B9921E34B4070883401517663C0FC6A0076BBE24B405E9C3E89FF7663C0A732ED512EE34B40BB52BEE94B7763C0B7C5CF3502E74B40CB8BA6C2FE7763C078F572BEA9E84B40B90B6994BB7763C027D5CE356EEA4B4039C684B4707663C0A07A62ECB0EB4B40AA6863BA3A7563C06C4190AC91ED4B406030BEE9DF7463C08C71D0357EF14B405CE96894DF7463C09C8D258B7FF14B407C256994547463C00C17268BEFF34B409E3F88F2327363C030DE599F18F54B40B80B6994CB7163C0503CCF3512F54B40826CBEE9D47163C038B6D03596F24B408AFA6894357263C047877AE034EF4B4068BE6894407263C010E8CF350EED4B40B90B6994DB7163C0D02CD035A6E84B40826CBEE9D47163C05CA3CF3576E64B4068BE6894407263C094F7CE353AE44B40010300000001000000170000006030BEE9CFC760C0A85ECF35DEF54B406C05BEE940C860C0F716268B2FF34B40040EBEE983C760C0304FD03532F34B40C4E06894BCC560C0503CCF3512F54B401A75BEE9E7C360C070557BE03CF64B406030BEE93FC360C098427AE0DCF54B40264ABEE9A8C360C08471D0353EF34B409B16BEE9E6C460C0CFB2CE3562F24B4086B3133F45C660C0D893D035CAEF4B40BB52BEE97BC760C018E8CF354EEC4B40806CBEE944C860C0B0C5CF35C2E84B40A05D133FD7C860C040B6D03516EA4B4068BE689430CA60C097F7CE35BAEA4B40040EBEE973CA60C0C02CD035A6EC4B4068BE689430CA60C007E8CF35CEED4B40A05D133F77C860C044B6D035D6EF4B40525BBEE9EEC860C00C81CF35EAF04B4097CF6894B6CA60C0483CCF3592F24B40BA52BEE91BCB60C0740AD0359AF44B40E2D5133FA1CA60C0707479E014F64B40555BBEE98EC960C050D2258B97F64B4057A2133F6FC860C027D5CE356EF64B406030BEE9CFC760C0A85ECF35DEF54B400103000000010000000B0000008F41BEE9F5BA60C0C0107BE0E4EE4B407C256994E4BB60C0E4B2CE3562EC4B407C25699434BD60C00417268B6FEE4B40BC52BEE97BBD60C0FF80CF35EAEF4B4067BE6894D0BD60C03BD5CE356EF24B4086B3133FE5BD60C02C04258BCFF44B40C4E068946CBD60C0A85ECF35DEF54B40F638BEE912BC60C0443CCF3512F84B407D25699464BB60C08F427AE09CF84B40E2D5133FA1BA60C0F019CF3546F34B408F41BEE9F5BA60C0C0107BE0E4EE4B400103000000010000000E00000056A2133FDF1964C030D5CE35AEF44B4089FA6894E51964C030B6D035D6F34B406D05BEE9701B64C0F0AF258B4BF44B40C099133FFC1D64C0F019CF35C6F24B4085B3133F451D64C088427AE01CF44B40BE99133FFC1C64C0F035248B47F44B404ACD133F9E1C64C07CDB79E0F8F34B401CBC133FB81B64C030D5CE35AEF44B40C6E068942C1B64C01CB979E0ECF54B405F30BEE97F1A64C073557BE0FCF84B405DE968943F1A64C0C0C5CF3502F94B4000C76894231A64C0DCFD79E044F74B402891133F091A64C0BB107BE0E4F54B4056A2133FDF1964C030D5CE35AEF44B40010300000001000000EC00000058A2133FAF6660C02F4FD035F2F84B40535BBEE9BE6560C050A3CF3536F64B40BA52BEE96B6160C028D5CE352EE54B40311FBEE9796160C0B87A248B1FE24B40AE7DBEE9BA6060C040B6D03516DF4B406030BEE9FF5E60C08471D035BED94B406D05BEE9F05E60C0700AD035DAD84B404C146994FE5E60C0F8CB7AE0CCD64B40030EBEE9E35E60C0BF107BE0E4D54B4094CF6894065E60C0C3107BE064D34B401875BEE9E75D60C0483CCF3552D24B408C41BEE9055E60C0CB2CD035E6CF4B40050EBEE9935E60C08F427AE0DCCC4B401775BEE9C75E60C0BF107BE0E4CA4B40040EBEE9435E60C04BD2258B97CA4B40F638BEE9325E60C008E8CF354EC94B4020036994885E60C0D42CD03566C84B401875BEE9375F60C068BF248B37C94B40F2F16894325F60C018B979E06CC44B408E41BEE9455F60C0D793D0350AC24B40806CBEE9745F60C0C02CD03566C04B40E963BEE9515F60C0B8107BE024BF4B408B41BEE9555F60C0C72CD03526BE4B40264ABEE9685F60C02C04258B0FBD4B40806CBEE9745F60C010E8CF358EBB4B402891133F195F60C0FC35248BC7B84B406030BEE9FF5E60C00081CF35AAB74B40F838BEE9F25E60C08071D0353EB64B406030BEE9FF5E60C0F019CF35C6B24B401775BEE9175F60C01804258B4FB14B40CE6E133F4D5F60C0A85ECF359EB14B40A05D133FA75F60C064A3CF3536B34B402991133F296060C00881CF35EAB44B40BA52BEE97B6060C0C02CD03566B54B40D6FCBDE9DD6060C0E819CF3586B44B40D4FCBDE9FD6060C0C0C5CF3542B34B4059A2133FDF6060C018E8CF350EB24B40BC52BEE9AB6060C0D02CD035E6B04B40C4E068948C6060C068BF248BB7AF4B4096CF6894966060C0680AD0355AAD4B40545BBEE9CE6060C0483CCF35D2AB4B40D5FCBDE91D6160C0DF19CF3546AA4B40BA52BEE96B6160C07C0AD035DAA74B401875BEE9C76160C0D0FD79E004A34B408D41BEE9156260C00381CF356AA14B40BB52BEE9BB6260C0687479E0D49F4B409C16BEE9666360C0707479E0949E4B403AAD6894BA6360C0AFC5CF35429E4B40331FBEE9296460C0DF48258B279E4B40A05D133F676460C0A45ECF359E9D4B4057A2133F7F6460C0AC5ECF355E9C4B4066BE6894906460C00C81CF35EA9A4B4020036994B86460C0E393D035CA994B40826CBEE9246660C0F419CF35C6974B40F2F16894726760C073BF248BB7994B40E963BEE9B16860C000CC7AE0CC9C4B409A16BEE9F66960C0DF48258B279E4B40FD7F133F336860C0DCB2CE35A2A24B40FC7F133F836760C07871D0353EA54B40A05D133FE76660C0D42CD035A6A84B409A16BEE9D66660C07C0AD0355AA94B4037AD6894AA6660C060BF248B37AC4B4058A2133F8F6660C0E793D035CAAC4B4039AD68946A6660C0FC35248B47AD4B40254ABEE9486660C0C0C5CF3502AE4B40AF7DBEE93A6660C0F835248B47AF4B406E05BEE9406660C06B7479E094B14B40F2F16894626660C0F780CF352AB34B401775BEE9B76660C0B8C5CF3502B44B40A15D133F576760C038B6D03516B44B403AAD68941A6760C040B6D03556B24B404E146994CE6760C0D02CD03566B24B402891133F996860C030D5CE356EB14B40535BBEE90E6960C0908D258B7FAF4B40F638BEE9C26860C0D348258BA7AC4B406030BEE95F6860C044B6D03516AA4B40E2D5133F716860C0680AD0359AA74B40CE6E133FDD6860C040B6D03556A54B40BB52BEE98B6960C0D02CD03566A34B406030BEE95F6A60C00C17268B2FA24B40311FBEE9496B60C02C4FD035B2A14B40535BBEE9EE6C60C0D048258BA7A14B40CA27BEE9AC6D60C037D5CE352EA24B40AE7DBEE96A6E60C04C3CCF3592A34B40F2F16894D26E60C017E8CF358EA54B40CE6E133F8D6E60C07C0AD035DAA74B40EA63BEE9D16D60C05CA3CF35F6A84B407E256994F46C60C0607479E054A94B40B4C4133F3B6C60C00081CF352AAA4B40D5FCBDE9ED6B60C0D348258BA7AC4B40E2D5133FE16B60C098F7CE353AAE4B402F1FBEE9B96B60C0908D258B7FAF4B4085B3133F756B60C094427AE05CB04B406E05BEE9106B60C027B979E0ACB04B40C4E068948C6A60C0503CCF35D2B04B40F638BEE9526A60C0F419CF3546B14B409A16BEE9F66960C064A3CF3536B34B409D16BEE9E66860C0503CCF3512B74B40321FBEE9A96860C0BCC5CF3542B94B40CD6E133FFD6860C010E8CF358EBB4B40040EBEE9136960C00417268B6FBC4B40FD7F133F636960C09C427AE0DCC14B40040EBEE9936960C08071D0353EC34B407E256994946A60C0E819CF35C6C84B401875BEE9C76A60C0284FD03532CA4B404D146994FE6A60C020B979E0ACD04B40311FBEE9396B60C0CFB2CE35A2D24B4057A2133F9F6B60C0483CCF3552D24B40826CBEE9E46B60C00417268B2FCF4B406130BEE9AF6B60C018B979E02CCB4B404D1469947E6A60C0700AD0355AC04B40CE6E133F4D6A60C01804258BCFBC4B40331FBEE9696A60C0FF16268B2FB94B40816CBEE9F46A60C00C17268B6FB54B406E05BEE9306B60C0978D258B7FB44B40D5FCBDE9ED6B60C040B6D03556B24B402A91133F296C60C0B37A248B5FB14B405E30BEE99F6C60C048D2258BD7AE4B40264ABEE9186D60C0637479E014AD4B4095CF6894966D60C0E493D0350AAC4B40321FBEE9C96E60C088F7CE357AAA4B40CC27BEE97C6E60C064A3CF35F6AB4B409C16BEE9A66D60C043D2258B97AE4B40B17DBEE97A6D60C0284FD03532B04B409C16BEE9A66D60C064A3CF3536B24B40C3E068940C6E60C0AF107BE0E4B34B40CC27BEE97C6E60C09C427AE05CB54B40321FBEE9C96E60C05FA3CF35B6B64B40E963BEE9016F60C05CA3CF35B6BA4B40B2C4133FAB6E60C00081CF35EABD4B40B17DBEE97A6D60C0CB2CD035E6C34B40FC7F133F036E60C0FC80CF35EAC34B40040EBEE9D36E60C088F7CE35FAC24B408E41BEE9A56F60C0B8C5CF3582C14B4086B3133F357060C02CB979E0ECBF4B40B07DBEE98A7060C0234FD03572BD4B407C256994847060C0E0B2CE35E2BA4B40EA63BEE9417060C03CB6D03556B84B40EA63BEE9E16F60C00781CF35EAB54B40F638BEE9026F60C0B07A248BDFB14B409A16BEE9E66E60C0CB2CD035A6AF4B4020036994586F60C0D348258BA7AC4B4020036994487060C0C02CD035E6A74B40264ABEE9D87060C0503CCF3552A64B4096CF6894A67160C0EC19CF3506A64B409C16BEE9567260C0483CCF3512A74B4096CF6894B67360C044B6D03596AA4B40B6C4133F2B7560C028D5CE35EEAB4B40D4FCBDE9ED7560C0680AD0355AAD4B40E963BEE9217760C027B979E0ACB04B40826CBEE9347760C03FD2258B17B14B409B16BEE9667760C008CC7AE08CB24B40C3E068948C7760C064A3CF3536B34B40BC52BEE92B7960C02F4FD035B2B64B4059A2133FDF7960C0B8107BE0E4B84B4058A2133F3F7A60C0985ECF355EBB4B40D7FCBDE9ED7960C0B0C5CF3502BD4B401D036994F87660C000CC7AE04CC24B408E41BEE9957660C058A3CF3576C34B40B4C4133F0B7660C0888D258B7FC54B40F838BEE9B27560C0680AD0355AC64B403BAD68945A7560C0948D258B7FC64B40E2D5133FD17460C0F816268B6FC64B406030BEE99F7460C018E8CF354EC74B4085B3133FD57360C0344FD03532CC4B40CA27BEE92C7460C09C427AE05CCD4B404D146994CE7560C0D42CD03526CE4B40D6FCBDE95D7660C09B427AE0DCCE4B40FC7F133FA37660C053D2258B97D04B40BC52BEE9AB7660C0A05ECF359ED24B4095CF6894867660C0BC7A248B9FD44B40EA63BEE9417660C0707479E054D64B405E30BEE91F7660C09CF7CE35FAD64B40AF7DBEE9FA7560C0E893D0358AD74B4021036994C87560C03CD5CE35EED74B40B4C4133F7B7560C0677479E014D84B40FD7F133F537460C03CD5CE35EED74B40F638BEE9127460C0677479E014D84B407B256994047460C00036248BC7D84B402B91133F097460C0D42CD03526DB4B407E256994F47360C0F8CB7AE00CDC4B40B4C4133FAB7360C0DFB2CE35A2DC4B40244ABEE9687360C0A85ECF355EDC4B40CC27BEE92C7360C04C3CCF35D2DB4B408F41BEE9F57260C0533CCF3592DB4B404C1469941E7160C008E8CF358EDC4B40535BBEE98E7060C04C3CCF3552DD4B40535BBEE98E7060C0EC19CF3546DE4B40E2D5133F117160C0687479E054DE4B408E41BEE9857260C04C3CCF3552DD4B40E0D5133F217460C054877AE0F4DD4B4085B3133FB57460C04C3CCF3552DD4B40F938BEE9227660C0F019CF3546DA4B40BC52BEE98B7660C040D2258BD7DA4B40EB63BEE9B17660C02CB979E0ACDE4B406E05BEE9407660C04B877AE034E04B40535BBEE93E7560C00317268B6FE14B40FC7F133F237460C0E4FD79E044E24B402891133F697060C0FC80CF352AE34B40E763BEE9716F60C094F7CE353AE44B406F05BEE9B06F60C03CD5CE356EE54B4020036994687060C00B17268B6FE64B40535BBEE98E7060C00881CF356AE74B406E05BEE9B07060C0780AD035DAE84B40BD52BEE9FB7060C0204FD035B2E94B409E5D133F477160C093427AE09CE94B402A91133F697160C0EC93D0354AE84B40CF6E133FBD7160C08371D0353EE64B40F1F16894827260C0204FD03572E54B4085B3133F657360C02804258B0FE54B40F638BEE9127460C094F7CE353AE44B404C1469949E7460C018E8CF358EE54B409041BEE9B57560C0FFCB7AE04CE64B40311FBEE9097660C00FE8CF35CEE74B40EA63BEE9017660C07871D0357EEA4B408C41BEE9757560C054877AE074EB4B40CD6E133F0D6F60C07871D0357EEA4B4056A2133FEF6D60C0B8C5CF3542EC4B40F738BEE9A26E60C000CC7AE00CED4B4039AD68941A7160C010E8CF350EED4B40B4C4133F7B7160C024B979E0ECED4B40B952BEE9EB7160C05FBF248BF7EF4B40545BBEE94E7260C05F7479E054F24B408E41BEE9857260C0985ECF351EF44B406D05BEE9807060C038D5CE356EF44B40EA63BEE9E16F60C0503CCF3512F54B40AF7DBEE99A6F60C00081CF35AAF54B40F838BEE9126F60C00C81CF352AF74B40321FBEE9C96E60C0A05ECF359EF74B40C3E068944C6E60C07C557BE0BCF74B40535BBEE9EE6C60C0483CCF35D2F64B406130BEE9AF6B60C054877AE0F4F74B40B17DBEE95A6A60C0B0107BE024FA4B401775BEE9F76860C0EC93D0358AFB4B4057A2133F8F6760C0543CCF3552FA4B4058A2133FAF6660C02F4FD035F2F84B400103000000010000000B00000084B3133F151D64C0C0107BE0A4024C40E2D5133FB11D64C02C04258B4F024C40826CBEE9D41D64C0D3B2CE35A2024C40FA7F133F131E64C0EC93D0354A024C40FA7F133F731E64C06C7479E0D4014C40D4B568947D1E64C0284FD035F2014C40CA27BEE9EC1D64C0700AD0351A034C40E2D5133F411D64C08026258B1B034C409388133F961C64C07771D0357E034C40C6E068947C1C64C0BFE1248BC3024C4084B3133F151D64C0C0107BE0A4024C40010300000001000000090000009088133F861A64C088DB79E0B8034C40EFAA133FF21964C0386B258BF3024C409E5D133FF71964C06C7479E0D4014C40B80B69944B1A64C02B04258BCF024C40B80B6994DB1A64C0386B258BF3024C40F638BEE9721B64C0436B258B73034C403CAD6894BA1B64C08026258B1B034C40030EBEE9A31B64C0CCE1248BC3034C409088133F861A64C088DB79E0B8034C4001030000000100000019000000F3F16894B29563C02804258B4F054C408E41BEE9C59563C08471D035FE044C409A16BEE9C69563C098F7CE35BA044C40C927BEE9AC9563C008CC7AE04C044C40040EBEE9B39563C0C82CD035E6034C402ED86894C99563C050D2258B17034C406C05BEE9D09563C0888D258B7F024C4022036994C89563C02C04258B4F024C40F638BEE9C29563C0E0B2CE3522024C406ABE6894E09563C054D2258B97014C40CA27BEE93C9663C02F4FD03532014C403AAD68949A9663C04B3CCF35D2014C40AE7DBEE9FA9663C0E019CF35C6024C40D0B568947D9763C0780AD0355A034C4067BE6894E09763C073BF248B77044C4095CF6894D69763C078557BE03C054C40F838BEE9829763C0A05ECF351E054C407E256994349763C0E893D0354A054C4067BE6894F09663C02C4FD035B2054C4095CF6894B69663C0E093D0358A064C40806CBEE9A49663C01804258BCF074C406C05BEE9709663C064BF248B77084C408BFA6894159663C078557BE0BC074C402FD86894B99563C0E0B2CE35E2054C40F3F16894B29563C02804258B4F054C400103000000010000003C0000006E05BEE990AC60C0EB93D0358A144C40B3C4133FFBAA60C0985ECF35DE124C40525BBEE9AEA960C008E8CF354E134C40E1D5133F21A960C048D2258BD7124C405F30BEE91FA960C0E493D0350A114C40EB63BEE9E1A960C00317268B2F0D4C40826CBEE904AA60C000CC7AE0CC0B4C40B4C4133FFBA960C093F7CE353A0A4C40836CBEE9A4A960C027B979E02C084C4056A2133F8FA960C08071D035FE064C409F5D133F87A960C05FBF248B37044C408E41BEE995A960C0D793D0358A014C40816CBEE9F4A960C090F7CE35BAFF4B4056A2133FDFAA60C02804258B8FFF4B409A16BEE976AB60C0E093D035CA004C402003699408AC60C007E8CF358E024C401875BEE9A7AC60C0B87A248B5F034C40E863BEE911AE60C040D2258B57004C40CB27BEE90CAF60C054A3CF3536024C40F938BEE9B2AF60C01BE8CF354E014C401F03699458B060C040877AE074FE4B40F1F1689492B060C068557BE0BCFD4B40BC52BEE9EBB160C0F419CF3546FC4B4058A2133FDFB260C038B6D03556FA4B4085B3133F25B460C008E8CF35CEFA4B4095CF689486B460C0985ECF355EF94B404D1469946EB460C014E8CF350EF84B401675BEE9C7B360C0E893D035CAF64B40525BBEE9DEB360C0A85ECF35DEF54B406C05BEE930B460C044B6D03596F54B40A15D133FB7B560C0503CCF3512F54B406030BEE91FB660C0B47A248B9FF44B406E05BEE950B660C030B6D035D6F34B40C4E068947CB660C00BE8CF358EF34B40EA63BEE921B760C067BF248B77F54B40545BBEE96EB760C070557BE0BCF54B40F2F1689442B860C0A85ECF35DEF54B405D30BEE96FB960C0F835248BC7F84B40C4E06894ACB860C09C8D258B7FFD4B40D5FCBDE90DB660C07C0AD0359A054C401775BEE9E7B560C0680AD035DA064C401775BEE9E7B560C0908D258BFF074C403BAD6894CAB560C0740AD035DA084C40555BBEE96EB360C008CC7AE00C0A4C407F25699454B160C0483CCF3592094C404D1469944EB060C09C8D258BFF094C408E41BEE975AF60C000CC7AE0CC0B4C40555BBEE96EB060C05CA3CF35760C4C4096CF689416B360C028B979E0EC0C4C40525BBEE9DEB360C00881CF356A0E4C404F146994BEB360C03BB6D035D6104C407D25699494B260C0E3B2CE35E2104C40E3D5133F41B060C0EC93D0354A0F4C4095CF6894D6AF60C0284FD035720F4C407D25699454AF60C0C82CD035E60F4C401775BEE9D7AE60C050D2258B97104C40A05D133F27AE60C018E8CF354E124C40D5FCBDE94DAD60C0F8CB7AE04C134C40816CBEE9F4AC60C0BC107BE024144C406E05BEE990AC60C0EB93D0358A144C4001030000000100000013000000264ABEE9C89863C09C427AE09C134C4020036994589963C030B6D03596134C40816CBEE9C49963C040D2258B17154C4098CF6894E69963C0C42CD035E6164C408D41BEE9E59963C040B6D03556184C40EB63BEE9D19963C0B4C5CF3542194C40D7FCBDE9AD9963C00417268BAF194C4096CF6894969963C01CE8CF354E1A4C40806CBEE9949963C0740AD0351A1B4C40CA27BEE95C9963C09B8D258B3F1C4C401675BEE9E79863C0E0FD79E0041D4C401675BEE9C79863C0204FD035B21C4C409C16BEE9F69863C0B7107BE0E41B4C40E41C6994119963C0B0C5CF35C21A4C408BFA6894159963C00C17268B6F194C40806CBEE9F49863C0F019CF3546184C4022036994889863C0700AD035DA164C40A2A46894879863C050A3CF3576154C40264ABEE9C89863C09C427AE09C134C4001030000000100000074000000B2C4133F7B8F60C0D048258BE7184C40826CBEE9A48E60C0B0107BE0E4174C40545BBEE9BE8D60C0D048258BE7174C40B07DBEE9EA8C60C0F019CF35C6184C4067BE6894808B60C0B7107BE0E41B4C40F738BEE9D28A60C0CF2CD035261B4C40FC7F133F238A60C00C17268B6F194C40F738BEE9528960C088427AE01C184C408F41BEE9258760C07C557BE07C174C408D41BEE9258660C0770AD0359A164C40F97F133F438560C0BC107BE024144C40D7FCBDE9BD8460C018E8CF354E124C40FB7F133FF38260C0B47A248B9F0D4C40816CBEE9148360C090F7CE35BA0C4C40C6E068943C8360C077557BE0FC0B4C40B4C4133F6B8360C0A05ECF355E0B4C40806CBEE9A48360C040B6D035D60A4C402A91133F298460C0B8C5CF35020C4C40F738BEE9628460C0F019CF35460B4C402A91133F898460C00C81CF35EA094C4094CF6894D68460C018B979E02C094C40BB52BEE93B8560C0483CCF3592094C409F5D133F078660C050D2258B570B4C409E16BEE9768660C000CC7AE0CC0B4C401775BEE9478660C060BF248BF7094C405E30BEE99F8560C04C3CCF3512084C4056A2133F5F8560C010E8CF358E064C40F2F16894828560C048D2258B57064C407F256994D48560C07C0AD0359A054C402991133F698560C050A3CF35B6044C40535BBEE91E8560C07771D0357E034C40A25D133FE78460C0F419CF3506024C401875BEE9B78460C07C0AD0355A004C40F1F16894D28460C0DBB2CE35E2FF4B405F30BEE9DF8460C018E8CF358EFF4B40806CBEE9F48460C0F716268BAFFE4B407F256994248460C0274FD03532FC4B40C3E06894EC8360C0F019CF3506F94B4087B3133F458460C0F880CF35EAF64B40A15D133F278560C0A05ECF359EF74B40E2D5133F618560C04C877AE0B4F84B404D146994AE8560C0908D258B7FFB4B40D8FCBDE9ED8560C04C3CCF3512FC4B406D05BEE9208660C02FD5CE356EFB4B40A05D133FC78660C0948D258B7FF84B40040EBEE9238760C0A05ECF359EF74B40F838BEE9928760C068557BE07CF74B4020036994D88760C08B71D035BEF74B40E1D5133F118860C04CD2258BD7F74B4068BE6894B08860C027D5CE356EF64B40C4E068942C8960C030D5CE35AEF54B4085B3133FB58960C00081CF352AF54B40F838BEE9328A60C0503CCF3512F54B40CB27BEE9BC8A60C00436248B87F54B40AE7DBEE90A8B60C02C04258B4FF64B406E05BEE9A08B60C033D5CE35EEF84B40244ABEE9288C60C0D42CD035E6F94B4095CF6894568D60C07C0AD0359AFA4B409C16BEE9B68D60C04C3CCF3512FC4B40E2D5133F318D60C0BFC5CF35C2FF4B40F638BEE9F28C60C07C0AD0355A004C404C1469948E8C60C0908D258BBF004C40CF6E133F4D8C60C070BF248BB7014C40BA52BEE93B8C60C0B8107BE0E4024C40A05D133F678C60C028D5CE35EE034C40E0D5133F418D60C07871D0357E044C40B4C4133F3B8E60C040B6D03516044C402891133FC98E60C0204FD035B2044C40535BBEE95E8E60C0F7CB7AE04C084C40F638BEE9E29160C018B979E02C094C40D5FCBDE93D9260C0780AD0359A094C40CA27BEE99C9260C01F4FD035720A4C406C05BEE9009360C0677479E0140B4C403BAD68946A9360C040B6D035D60A4C40301FBEE9999360C0700AD035DA094C40E863BEE9A19360C0D0FD79E084084C4021036994B89360C0F835248B47074C40EA63BEE9119460C010E8CF358E064C40A15D133FA79460C00417268B6F074C409C16BEE9A69560C02C4FD035720C4C401775BEE9279660C0B47A248B9F0D4C4056A2133F8F9660C00436248B070F4C40F2F16894D29660C0C4107BE0E4114C4097CF6894C69660C0A85ECF351E144C40E1D5133F419660C00881CF35AA134C40D6FCBDE92D9660C060BF248B77164C40555BBEE9FE9560C0B8C5CF3502194C406130BEE9FF9560C044B6D035161B4C404D1469947E9660C094F7CE357A1C4C40D7FCBDE9CD9560C03CB6D035561D4C404F1469944E9360C097F7CE353A1E4C404E146994DE9260C03FD2258B971F4C40CA27BEE91C9260C0680AD0359A254C40C5E068948C9160C068BF248BF7264C406D05BEE9509160C0F419CF3586274C40A05D133F379160C0483CCF35D2284C4086B3133F259160C018E8CF354E2A4C40D7FCBDE9FD9060C00481CF356A2B4C40CD6E133FAD9060C033D5CE35EE2B4C40D6FCBDE9AD8D60C06C7479E0142D4C40B07DBEE9CA8C60C0740AD035DA2C4C4039AD68949A8C60C00481CF356A2B4C407E256994548C60C0E0FD79E0842A4C404C1469942E8C60C0E048258B27294C406F05BEE9308C60C0A45ECF359E274C40A05D133F678C60C024B979E02C264C407F256994148C60C02BB979E06C244C406030BEE90F8C60C0E0FD79E0C4224C40F738BEE9528C60C0B0C5CF3582214C40A15D133FD78C60C030D5CE35EE204C40EA63BEE9618C60C04B877AE0B41F4C403AAD68947A8C60C0B0107BE0241E4C40CD6E133FDD8C60C02CB979E0AC1C4C409B16BEE9468D60C0FF16268BAF1B4C404D1469940E8F60C0A35ECF351E1A4C40B2C4133F7B8F60C0D048258BE7184C400103000000010000008D0200009B16BEE9C6B260C00881CF352A2D4C40C827BEE90CAE60C0E093D0358A2A4C40D4FCBDE9EDAA60C03CD5CE35AE2A4C40826CBEE904AA60C02CB979E0AC294C40826CBEE904AA60C008CC7AE0CC284C406030BEE98FAA60C00BCC7AE04C274C40F638BEE982AA60C08771D035FE244C40D7FCBDE9FDA960C07C557BE07C234C405F30BEE91FA960C050D2258B57244C40A05D133F47A960C0988D258B7F244C4087B3133F65A960C0948D258BBF244C404C1469947EA960C0543CCF3512254C407E25699494A960C02C4FD03572254C402A91133F69A960C00081CF352A284C40816CBEE944A860C0D848258BE7294C401775BEE9D7A660C03CD5CE35AE2A4C40020EBEE9D3A560C0E093D0358A2A4C40321FBEE959A560C0B07A248B9F294C40321FBEE9D9A460C0D893D0350A284C4084B3133F75A460C0E019CF3546264C40C5E068944CA460C0FF35248BC7244C40D6FCBDE95DA460C0204FD035F2234C40B07DBEE97AA460C00017268BEF224C405F30BEE97FA460C03CB6D03516224C40321FBEE949A460C088F7CE35BA214C40C2E068940CA460C04B3CCF3592214C40D4FCBDE95DA360C0C4C5CF35C2204C40CA27BEE90CA360C040D2258B17204C40E3D5133F31A260C00C17268BAF1F4C405E30BEE9DFA160C07B0AD0351A1F4C402A91133FB9A160C0C0C5CF35021E4C409B16BEE9B6A160C064A3CF35F61C4C40BA52BEE9BBA160C0B7107BE0E41B4C40C727BEE9ACA160C06F557BE0BC1A4C408F41BEE9B5A160C0284FD035721A4C40545BBEE9CEA160C0B7C5CF35021A4C40FD7F133FE3A160C08BF7CE357A194C405E30BEE9DFA160C0D048258BE7184C401875BEE9B7A160C00881CF356A184C40321FBEE949A160C0E793D0350A184C40535BBEE91EA160C018B979E0AC174C40301FBEE9F9A060C018E8CF350E174C40BA52BEE9CBA060C0DBFD79E004164C409A16BEE9C6A060C00CCC7AE00C154C40535BBEE91EA160C0A85ECF359E144C40B3C4133F7BA160C08871D035BE134C407E25699414A260C02FD5CE35AE0F4C40826CBEE954A260C00881CF356A0E4C402A91133FF9A260C08771D035FE0D4C4095CF6894F6A360C00817268BEF0F4C40535BBEE97EA460C0EC93D0354A0F4C409D16BEE9F6A260C0740AD035DA084C401875BEE987A260C02FD5CE356E074C40F2F1689402A260C02C4FD035B2064C40545BBEE98EA160C0B7C5CF35C2064C4085B3133F95A060C02FD5CE356E074C401875BEE907A060C0D8FD79E044074C40264ABEE9989E60C07C0AD0359A054C406F05BEE9909E60C0C3107BE0E4064C40E0D5133F719E60C0D02CD035E6074C40B3C4133F3B9E60C0DB48258BA7084C406C05BEE9F09D60C018B979E02C094C407E256994649D60C00417268B6F084C40EA63BEE9319D60C0C0107BE064074C402991133F199D60C0B0107BE024064C404D146994BE9C60C0A05ECF351E044C4068BE6894C09C60C050D2258B97034C40B07DBEE9AA9C60C0BBC5CF3542034C408D41BEE9059C60C0E048258B27034C4058A2133FCF9B60C0E893D0354A034C404E1469949E9B60C0CF2CD035A6034C40254ABEE9689B60C09C5ECF355E044C4084B3133FF59A60C0948D258BFF044C40D7FCBDE97D9A60C0B4107BE024044C40CA27BEE90C9A60C0770AD035DA024C40BB52BEE9AB9960C030D5CE352E024C405F30BEE93F9960C0D8B2CE35E2014C406C05BEE9909760C02804258B8FFF4B40F838BEE9E29660C0E893D0358AFD4B40816CBEE9349660C0C0107BE0E4FA4B401F036994789560C050D2258B97F84B40F3F16894429460C0BBC5CF3542F74B40C827BEE9DC9360C04B3CCF3552F64B40BB52BEE98B9360C008E8CF350EF54B403BAD68946A9360C034D5CE35AEF34B409D16BEE9369360C0700AD0355AF24B40B2C4133F3B9260C0DCFD79E004F14B40D6FCBDE9DD9160C044B6D035D6EF4B40AF7DBEE91A9260C0E0B2CE35E2EE4B40030EBEE9039160C09C427AE09CEC4B40806CBEE9449060C00717268BEFE94B404D146994CE8E60C00017268B6FE34B40E1D5133F218F60C077557BE0BCE14B40D6FCBDE9FD8E60C0607479E014E04B409C16BEE9A68E60C0B87A248B5FDE4B40535BBEE95E8E60C0F419CF3586DC4B406E05BEE9408E60C0DCB2CE3562DA4B40535BBEE94E8E60C040B6D035D6D84B404D146994CE8E60C050877AE074D54B40B3C4133F5B8E60C0C4107BE0E4D44B403AAD68940A8E60C007CC7AE0CCD34B40F3F16894E28D60C098F7CE353AD24B40321FBEE9E98D60C054A3CF3536D04B4068BE6894A08D60C0D02CD03526D14B402A91133F998C60C01BE8CF358ED54B40B3C4133FDB8B60C050877AE074D54B40F0F16894B28B60C0E093D0350AD54B40F838BEE9328B60C0DFFD79E004D34B401875BEE9178B60C0483CCF3552D24B40CE6E133F0D8B60C0A85ECF355ECF4B40AF7DBEE9FA8A60C0E819CF3586CE4B40B07DBEE9DA8A60C0B8C5CF3582CD4B40E963BEE9818960C0F019CF3506C64B40826CBEE9348960C0EC19CF35C6C44B4068BE6894908760C07C557BE0BCC44B406030BEE9DF8660C07771D035FEC34B40B17DBEE90A8560C0687479E094BF4B401675BEE9A78460C06F7479E0D4BD4B406030BEE97F8460C010E8CF358EBB4B406D05BEE9D08460C0F019CF3586B94B40B07DBEE98A8560C064A3CF35F6B94B40BB52BEE9EB8660C0E048258BE7BC4B40020EBEE9038860C0C02CD03566C04B40AD7DBEE97A8960C073557BE0BCC14B40555BBEE9AE8A60C0D3B2CE3522C44B401E036994F88C60C0EC19CF3546C54B40321FBEE9E98D60C0F816268B6FC64B4096CF6894B68F60C0F019CF3546CD4B4068BE6894C09060C00436248B07D04B40B17DBEE9AA9160C0B0C5CF3542CF4B40B17DBEE96A9160C060A3CF35B6CE4B40F3F16894429160C0680AD0351ACE4B40D7FCBDE9FD9060C0E4B2CE35A2CC4B40EA63BEE9619160C0204FD03572CC4B40545BBEE9AE9160C0D848258BA7CB4B40B07DBEE9EA9160C0AFC5CF3582CA4B40AF7DBEE91A9260C068BF248B37C94B403BAD68949A9160C0CC2CD03526C94B409A16BEE9E69060C0AB5ECF359EC84B40040EBEE9639060C034B6D03596C74B409C16BEE9769060C0E493D0350AC64B40BB52BEE9FB9160C000CC7AE0CCC04B4038AD6894EA9260C03CB6D03516BF4B40CE6E133F1D9560C0DFB2CE35E2BC4B40E3D5133FD19560C0F835248B47BA4B4087B3133F559560C07C557BE0BCB94B40F838BEE9F29460C0344FD035F2B84B40A15D133FC79460C08071D035BEB74B40E863BEE9F19460C00781CF35EAB54B40545BBEE98E9460C0FC80CF356AB74B40EA63BEE9319460C0B4107BE024B94B404D146994BE9360C02004258B8FBA4B407E256994C49160C050877AE0F4BB4B405F30BEE97F9160C08071D0357EBC4B406030BEE96F9160C048877AE0B4BD4B40D5FCBDE96D9160C0D02CD035E6BE4B407B256994549160C01F4FD03572BF4B40301FBEE9199160C0334FD035B2BF4B40C4E068949C9060C07C0AD035DAC04B40B4C4133F5B9060C0304FD03532C14B40274ABEE9089060C090F7CE353AC14B40545BBEE9DE8F60C08871D035FEC04B40B2C4133FBB8F60C0D32CD035A6C04B40B2C4133F7B8F60C0C02CD03566C04B406E05BEE9E08E60C00036248B47C04B40555BBEE92E8E60C04B877AE074C04B4039AD68947A8D60C0E819CF3506C14B40A15D133FD78C60C0D42CD03526C24B40244ABEE9488C60C007CC7AE00CC04B40E963BEE9018C60C00CCC7AE00CBE4B40E863BEE9918B60C0EC93D0358ABC4B40535BBEE9AE8960C038B6D03556BB4B40C3E06894DC8860C0344FD035F2B94B40FC7F133F938860C07771D0357EB84B40F738BEE9528960C00081CF35AAB74B409B16BEE9C68960C0F880CF35EAB74B40545BBEE95E8A60C098F7CE353AB94B40B07DBEE9DA8A60C0687479E054B94B409C16BEE9368B60C0E793D035CAB84B40274ABEE9788B60C0D748258BE7B74B40A05D133FC78B60C0503CCF3512B74B40244ABEE9488C60C05FA3CF35B6B64B4057A2133F1F8E60C00081CF35AAB64B4096CF6894068F60C028B979E0ECB54B40B2C4133F7B8F60C038B6D03516B44B40D4FCBDE94D8F60C08C71D035FEB14B40D6FCBDE99D8E60C0E893D0358AB24B40B3C4133F2B8D60C05CA3CF35F6B44B40826CBEE9D48C60C023B979E0ACB44B4058A2133F6F8C60C03CD5CE35EEB34B40AE7DBEE91A8C60C00017268BEFB24B4097CF6894D68B60C0D893D035CAB04B40C5E068948C8B60C01CE8CF350EB14B401875BEE9178B60C040B6D03556B24B403AAD6894EA8A60C0F880CF35AAB24B4067BE6894A08A60C0F780CF35AAB34B40AF7DBEE96A8A60C038B6D03516B44B40FC7F133F638A60C06BBF248BF7B34B406E05BEE9008860C05CA3CF35F6B44B407E256994C48760C0BC7A248B5FB44B405F30BEE9CF8660C0284FD03532B04B404F1469946E8660C0B7C5CF3542AF4B407C256994048660C0B0107BE024AF4B408F41BEE9958560C05CA3CF3536AF4B40A15D133F278560C048D2258BD7AE4B40806CBEE9F48460C048D2258BD7AE4B4094CF6894168560C0403CCF3592AD4B40A15D133F278560C050D2258B17AD4B4059A2133FCF8460C03CB6D03556AC4B402A91133FA98460C00081CF352AAB4B40B4C4133F9B8460C0740AD0359AA94B4068BE6894408460C07C0AD0355AA94B40311FBEE9F98360C050877AE0B4A84B407005BEE9E08360C040B6D035D6A74B405E30BEE90F8460C0C02CD035E6A64B4020036994488360C0A45ECF35DEA44B40A05D133FE78260C030D5CE356EA34B40C4E068940C8360C00C17268B2FA24B401975BEE9D78360C0FC35248BC7A04B40D7FCBDE9BD8460C0483CCF35D29F4B405E30BEE9BF8560C0A85ECF355E9F4B40331FBEE9C98660C0D0B2CE35A29F4B409A16BEE9C68760C0FC35248BC7A04B406130BEE98F8760C0780AD0355A9F4B40B07DBEE9BA8760C057A3CF35F69D4B40B07DBEE9FA8760C02C4FD035729C4B40020EBEE9038860C0F880CF35AA9A4B406130BEE9AF8760C07771D0353E994B404D1469943E8760C0A05ECF35DE984B401975BEE9F78660C0CF2CD03566994B40040EBEE9238760C0F880CF35AA9A4B406030BEE97F8660C030B6D035569D4B40816CBEE9848560C000CC7AE0CC9C4B40806CBEE9A48360C0E393D035CA994B40B07DBEE9AA8260C0B0107BE0E49A4B4058A2133F9F8160C0B0107BE024A14B40F0F16894E28060C09C427AE09CA24B4086B3133F158060C007E8CF35CEA24B40E3D5133FD17F60C0543CCF3552A24B402A91133F797F60C0FC35248BC7A04B40A05D133F477F60C0F780CF356A9F4B40FA38BEE9227F60C08071D035BE9D4B40BD52BEE90B7F60C04C877AE0F49B4B407E256994047F60C094F7CE353A9A4B40B3C4133F3B7F60C0CC2CD035A6964B40CA27BEE9BC7F60C0BCC5CF3542944B40EA63BEE9518060C0A45ECF351E924B40040EBEE9C38060C0FFCB7AE04C8F4B40C3E06894AC7F60C0FFCB7AE04C8F4B40BC52BEE90B8060C0B07A248B5F8D4B40B4C4133F9B8060C0284FD035B28B4B406030BEE93F8160C0AFC5CF35828A4B40D6FCBDE9DD8160C01F04258B0F8A4B40CE6E133F1D8260C040D2258B978A4B40321FBEE9998260C00017268BEF8C4B401E036994F88260C098F7CE357A8D4B408E41BEE9358360C04FA3CF35F68C4B40B2C4133F1B8360C054D2258BD78B4B40EB63BEE9D18260C037D5CE35AE8A4B40FD7F133F838260C01F04258B0F8A4B40CC27BEE9CC8260C037B6D03556894B406D05BEE9208360C0C0C5CF3502894B40B17DBEE97A8360C060A3CF35F6884B401975BEE9D78360C07B0AD0351A894B401975BEE9D78360C097F7CE353A884B4020036994E88260C03BD5CE352E874B408F41BEE9758260C08C71D0353E864B40311FBEE9698260C0E0B2CE3522854B407C256994C48260C00817268B6F844B40E863BEE9C18360C0304FD03532844B405F30BEE9DF8460C017E8CF350E824B40525BBEE9AE8660C040B6D03556804B40040EBEE9238760C0A85ECF359E7E4B4020036994B88560C0A85ECF359E7E4B4020036994588560C0A45ECF355E7E4B40FC7F133F138560C0F7CB7AE0CC7D4B405F30BEE9DF8460C04C877AE0347D4B404E1469944E8460C038D5CE352E7C4B40F938BEE9128460C0F835248B477C4B40B5C4133F7B8360C028B979E02C7E4B40FC7F133F438360C07F71D0357E7E4B4096CF6894168360C098427AE01C7E4B40FB7F133FF38260C0985ECF35DE7C4B40CE6E133F3D8260C0B8107BE024804B40EC63BEE9218160C00881CF35EA824B408D41BEE9E57F60C00881CF356A844B40E1D5133FD17E60C0AC5ECF35DE834B40CC6E133F2D7F60C0E348258B27834B4095CF6894667F60C0C4107BE024824B406F05BEE9707F60C0AF7A248BDF804B40E1D5133F417F60C00081CF356A7F4B4020036994E87F60C0908D258BFF7D4B403BAD68942A8060C0AF107BE0247D4B40020EBEE9538060C00481CF35EA7B4B40E1D5133F417F60C0BC7A248B1F7C4B407E256994047F60C00481CF35EA7B4B40A15D133FC77E60C03FB6D035967A4B40F638BEE9E27E60C04CD2258BD7794B404E1469941E7F60C0908D258B3F794B40E1D5133F417F60C028B979E06C784B40BA52BEE93B7F60C07871D0353E744B40FD7F133F837F60C03F877AE0F4734B40020EBEE9538060C0E4B2CE3522744B40F938BEE9128160C00C81CF35EA734B40E3D5133F818160C0D0FD79E004734B40040EBEE9738160C02C04258B8F714B40040EBEE9C38060C038D5CE35AE6F4B402991133F897F60C05FBF248B376E4B40535BBEE9FE7E60C09C8D258B3F6D4B407C256994947E60C01BE8CF354E6B4B402B91133FB97E60C0AFC5CF35C26A4B406E05BEE9E07E60C08871D0357E6A4B40CD6E133F0D7F60C00781CF356A6A4B40E1D5133F417F60C00C17268B6F6A4B4086B3133FA57E60C0988D258BFF694B404F1469949E7E60C0680AD0359A684B405F30BEE9AF7E60C0E493D035CA664B40C4E068945C7E60C0A85ECF351E654B40E963BEE9D17E60C0E093D0358A644B40545BBEE94E7F60C0543CCF3552644B40020EBEE9538060C0543CCF3552644B40040EBEE9E37F60C02F4FD03572634B40030EBEE9138060C094F7CE35FA614B40B4C4133F0B8060C07C557BE0BC604B40545BBEE9EE7F60C0E4FD79E0845F4B40040EBEE9E37F60C0985ECF351E5E4B40F2F16894028060C0B7C5CF35825C4B40D7FCBDE92D8060C0C0C5CF35425B4B40FC7F133F438060C098427AE01C5A4B406D05BEE9208060C008E8CF35CE584B402A91133F298260C09CF7CE357A594B40EA63BEE9A18260C0274FD035325A4B40FB7F133F138360C094F7CE353A5B4B40D6FCBDE98D8360C068557BE0BC5B4B4080256994C48360C06F0AD0355A5B4B401875BEE9678360C0C4C5CF35C2594B40C6E06894CC8460C020B979E06C594B40CB27BEE96C8660C0607479E0D45C4B402A91133FE98760C0C0107BE0245F4B40FD7F133FE38860C09C8D258B7F5B4B40B2C4133F5B8960C0985ECF351E5D4B408C41BEE9858960C0EB93D0354A5F4B40BC52BEE96B8960C014E8CF358E614B4096CF6894168960C02F4FD03572634B405E30BEE97F8860C00417268B6F644B4056A2133F2F8760C0707479E054654B40BB52BEE9EB8660C09F5ECF35DE664B40E0D5133F018760C074BF248BB7674B40B3C4133F3B8760C00036248B47684B40BA52BEE98B8760C0680AD0359A684B4086B3133FE58760C0F716268BAF684B40B17DBEE94A8860C04FD2258B57684B40826CBEE9848860C018E8CF358E674B40545BBEE9AE8860C028D5CE35AE664B40FD7F133FE38860C04C3CCF3512664B401675BEE9978960C027B979E0AC654B407E256994C48A60C03FB6D035D6664B40F2F16894828B60C09F5ECF35DE664B40826CBEE9C48A60C014E8CF354E684B404C1469940E8960C0AC5ECF355E6A4B40274ABEE9788860C0730AD0351A6C4B40040EBEE9D38860C0EB19CF35466D4B40D6FCBDE9ED8960C0503CCF35126E4B40AF7DBEE96A8A60C0E3B2CE35E26E4B40515BBEE90E8A60C0304FD035726F4B4067BE6894B08960C00881CF35AA6F4B40FD7F133FE38860C038D5CE35AE6F4B40FD7F133FE38860C010E8CF358E704B40BC52BEE91B8A60C0E019CF3506714B40D7FCBDE9BD8A60C0CC2CD035A6714B406C05BEE9308B60C07871D035BE724B407E256994448B60C0E493D035CA734B406C05BEE9308B60C0F019CF35C6744B40F1F16894328B60C0B8C5CF3582754B40816CBEE9848B60C000CC7AE0CC754B40836CBEE9D48B60C00781CF35EA754B40CE6E133F1D8C60C0E0FD79E044764B40555BBEE95E8C60C030B6D035D6764B4039AD68949A8C60C0B47A248B9F774B40264ABEE9188C60C02FB6D03556784B40040EBEE9D38B60C0E4FD79E084784B40F2F16894828B60C028B979E06C784B4096CF6894C68B60C09BF7CE35BA794B407D256994648C60C0344FD035727B4B4039AD68949A8C60C0985ECF35DE7C4B4069BE6894A08C60C07F71D0357E7E4B40F838BEE9828C60C0B87A248B1F804B4038AD68942A8C60C08871D035FE824B40F838BEE9E28C60C04C877AE0F4814B4056A2133F2F8D60C0284FD035327F4B409B16BEE9468D60C0680AD0355A7C4B4067BE6894608D60C0E493D0350A7B4B40AF7DBEE94A8D60C0A85ECF355E7A4B40C4E068945C8D60C04C3CCF35D2784B408F41BEE9858D60C01804258B0F774B409C16BEE9B68D60C000CC7AE0CC754B40816CBEE9F48D60C03F3CCF3552754B40F2F16894228F60C0E4B2CE3522744B402F1FBEE9898F60C0B8107BE024744B402A91133FD98F60C040B6D03556744B40BC52BEE90B9060C04FA3CF35F6744B404E1469941E9060C0EF19CF3546764B40CA27BEE9EC8F60C038D5CE356E774B40321FBEE9798F60C0F035248BC7774B40264ABEE9F88E60C028B979E0EC774B40BC52BEE99B8E60C028B979E06C784B4094CF6894368E60C0DCFD79E0447B4B4020036994788E60C0B0C5CF35827D4B406F05BEE9108F60C00717268B2F7F4B404C146994AE8F60C0A05ECF355E804B40B07DBEE9DA8F60C010E8CF358E7B4B4039AD68949A9060C0780AD035DA784B40B3C4133F9B9160C0770AD0355A784B4038AD68948A9260C00C81CF352A7A4B40CD6E133FFD9260C0F816268BEF7B4B40040EBEE9239360C034D5CE35EE7C4B40F2F16894329360C0BC107BE0247E4B40F1F16894129360C0780AD0359A7E4B402891133F699260C03F3CCF35127D4B40AF7DBEE91A9260C0985ECF35DE7C4B409D16BEE9C69160C0C3C5CF35427E4B40264ABEE9A89160C03CB6D03516804B40CA27BEE97C9160C0975ECF359E814B40D7FCBDE9FD9060C0975ECF351E824B404F1469947E9160C038B6D03596824B407E256994249260C08471D035BE824B40B4C4133F8B9260C05BA3CF3576834B40CC6E133F4D9260C094427AE09C854B408B41BEE9B59160C050A3CF35B6864B40816CBEE9F49060C0F880CF356A864B40B4C4133F2B9060C05FBF248BB7854B40B2C4133F7B8F60C094427AE09C854B406E05BEE9E08E60C07871D0357E864B40D7FCBDE9FD9060C028D5CE356E874B405F30BEE95F9160C074557BE0FC884B406E05BEE9409160C048877AE0B48A4B40B4C4133F5B9060C03CD5CE356E8E4B406130BEE9EF9060C0FF35248BC78E4B406030BEE96F9160C00CE8CF358E8F4B40311FBEE9E99160C0DCB2CE35E28F4B40BC52BEE96B9260C0AC5ECF35DE8E4B403BAD68944A9360C0D42CD035E6884B40C827BEE99C9360C097F7CE353A884B40CE6E133F0D9460C060A3CF35F68A4B402991133F799360C0C0C5CF35428F4B401875BEE9879260C0A85ECF355E934B40D6FCBDE9DD9160C08471D0357E954B40CB6E133F6D9260C0D32CD03566964B403AAD6894DA9260C054D2258BD7974B40040EBEE9839360C0680AD0351A9B4B40FB7F133F439460C008E8CF358E9D4B40C4E068947C9460C0EB93D035CA9E4B40EA63BEE9819460C0FC35248BC7A04B40311FBEE9099560C048877AE0F49E4B40C3E06894FC9460C0F835248B079C4B40545BBEE98E9460C02404258B4F994B408D41BEE9F59360C0A75ECF351E984B40A05D133FB79360C0D793D0354A974B4066BE6894B09360C060A3CF3576954B40B07DBEE9DA9360C0D0B2CE35A2934B4068BE6894309460C008CC7AE0CC924B4094CF6894469660C008CC7AE0CC924B404D1469949E9660C0700AD0351A934B406C05BEE9909760C08471D0357E954B40BC52BEE9CB9860C030D5CE356E974B40CE6E133F1D9960C0A75ECF351E984B40E2D5133F919960C0C0C5CF35429A4B40C827BEE9DC9960C060A3CF35369D4B408F41BEE9E59960C08B71D0353EA04B40F2F16894929960C09C427AE09CA24B407D256994749A60C0B8C5CF3542A34B40816CBEE9E49A60C00817268B2FA34B40806CBEE9149B60C0DCB2CE3522A24B406E05BEE9209B60C064A3CF35F6A04B40CE6E133F3D9B60C0EC19CF35C69F4B40E2D5133F619B60C0DF19CF35C69E4B40826CBEE9849B60C0DF48258B279E4B409916BEE9369C60C0DC48258BE79C4B401875BEE9B79D60C034B6D035D69B4B406E05BEE9609E60C0F880CF35AA9A4B402891133FF9A060C0CF48258B679B4B40535BBEE91EA160C0DCB2CE35E29C4B40E2D5133FD1A060C057A3CF35769D4B40264ABEE9789F60C0DF48258B279E4B40CC6E133F3D9D60C0E0B2CE35E2A14B4096CF6894F69C60C02B4FD035B2A24B402991133FD99C60C0B47A248BDFA34B40C827BEE91C9D60C0B0C5CF3582A44B407D256994B49D60C0E3FD79E044A44B40836CBEE9B49E60C0D02CD03566A34B40806CBEE9C4A260C0D02CD03566A34B40D6FCBDE9ADA260C00481CF35EAA24B401875BEE987A260C0D048258BA7A14B40FA7F133FF3A260C00881CF35AAA24B40FD7F133F53A360C01804258BCFA34B40A05D133FB7A360C0C4C5CF35C2A44B4068BE689430A460C0D848258B27A54B408F41BEE9B5A460C0C0107BE0E4A44B40EB63BEE991A560C078557BE0BCA34B40B4C4133F0BA660C0D02CD03566A34B4069BE6894D0A660C078557BE0BCA34B40EA63BEE9F1A660C0FF80CF35EAA44B4068BE6894E0A660C008CC7AE08CA64B40C2E068940CA760C0948D258B3FA84B4068BE689470A760C070BF248B37A94B40B3C4133FDBA760C0CC2CD035E6A94B40321FBEE939A860C08071D035BEAA4B401775BEE977A860C060BF248B37AC4B40E0D5133FF1A760C0FC16268B6FAC4B406C05BEE9B0A760C0C82CD03566AD4B40C4E068948CA760C0C02CD035A6AE4B40B4C4133F5BA760C068BF248BB7AF4B40301FBEE9F9A660C038D5CE35AEB04B40C4E068949CA660C057A3CF3536B14B408E41BEE935A660C020B979E06CB14B401675BEE9B7A560C050A3CF3576B14B40FB7F133F93A560C0503CCF3552B14B40F3F1689432A560C02C04258B8FB04B40E2D5133FE1A460C0DC48258BA7AF4B4039AD6894CAA460C0C0107BE0E4AF4B403AAD6894BAA460C0C0107BE064B04B40CE6E133F9DA460C027B979E0ACB04B406F05BEE9F0A160C038D5CE352EAF4B40C727BEE9ACA160C048D2258BD7AE4B40E1D5133F11A160C017E8CF354EAD4B4086B3133F05A160C050D2258B17AD4B40E2D5133F91A060C04CD2258BD7AC4B40B07DBEE9EA9B60C05FA3CF35F6AD4B40806CBEE9149B60C050D2258B17AD4B408E41BEE9D59B60C0607479E094AE4B40264ABEE9989E60C068BF248BB7AF4B406030BEE93FA060C028D5CE35AEB14B40B2C4133FEBA060C0F019CF3546B34B401E036994C8A060C05CA3CF35F6B44B404F146994FEA060C0543CCF3512B64B40CD6E133F4DA160C0E048258BA7B64B40D4FCBDE9ADA160C030B6D035D6B64B401775BEE917A260C05FA3CF35B6B64B404E1469947EA160C0284FD035F2B74B40F738BEE9C2A060C0A85ECF35DEB84B40C827BEE9FC9F60C09C5ECF355EB94B408D41BEE9459F60C0687479E054B94B40FC7F133F43A060C010E8CF358EBA4B40244ABEE968A260C08C71D035BEB94B40C3E068946CA360C0CF48258B27BB4B409A16BEE906A460C0D02CD035E6BD4B40545BBEE9FEA360C00036248B47C04B40F2F1689492A360C0B8C5CF3582C24B40C827BEE9FCA260C0EC19CF35C6C44B40264ABEE9C8A260C07871D035FEC54B40D6FCBDE97DA260C060A3CF35F6C84B40826CBEE954A260C0D0FD79E004CA4B40CC6E133F0DA260C098427AE09CCA4B401E036994C8A060C0E4B2CE35A2CC4B40E0D5133F01A060C070BF248BB7CE4B40E2D5133F919F60C044B6D03596CF4B40244ABEE9089F60C054A3CF3536D04B4095CF6894869D60C030B6D03556D04B40E2D5133F119D60C0C4C5CF3502D14B40264ABEE9889D60C06F7479E094D14B409D16BEE9069E60C0E3B2CE35E2D14B40244ABEE9089F60C0E3B2CE35E2D14B40F638BEE9729F60C0E493D0358AD14B409B16BEE976A060C054A3CF3536D04B40816CBEE904A260C01CE8CF35CECF4B40040EBEE983A660C0B87A248B1FCB4B4039AD68940AA860C0700AD035DACA4B40C827BEE96CAB60C0BC7A248BDFCE4B40E1D5133F21AC60C094427AE09CD04B40BA52BEE96BAC60C097F7CE353AD34B4068BE689460AC60C08871D035BED44B40B17DBEE93AAC60C0284FD035B2D54B408E41BEE9F5AB60C037D5CE352ED64B40CC6E133FEDAA60C0888D258BBFD64B40E0D5133FF1AA60C068557BE0BCD74B40A05D133F87AB60C08471D035BED94B401875BEE9C7AB60C018E8CF350EDA4B40CD6E133F1DAC60C034D5CE352EDA4B40020EBEE953AC60C0E093D035CADA4B40264ABEE938AC60C0F419CF3586DC4B403AAD6894DAAB60C0A85ECF35DEDD4B406F05BEE970AB60C0E4FD79E084DD4B404D1469940EAB60C02C04258B4FDC4B40FA7F133FC3AA60C0E0B2CE3522DB4B40D7FCBDE95DAA60C0E093D035CADA4B40CA27BEE92CAA60C087F7CE35FADC4B401775BEE907AA60C0C4107BE0E4DF4B401775BEE9C7A960C0E819CF35C6E14B40FC7F133F63A960C08471D035FEE04B40C2E068947CA860C078557BE0BCDF4B40F838BEE992A760C0985ECF355EDF4B401E03699428A760C0D893D0354AE14B40244ABEE9D8A660C0E0FD79E044E44B406030BEE91FA660C0E893D0350AE64B4068BE689450A560C00FE8CF354EE74B40BB52BEE9BBA460C0B0C5CF35C2E84B40FC7F133F93A460C00036248B87EA4B40331FBEE979A460C0E0B2CE3562ED4B402B91133F79A460C048877AE034F04B40CE6E133F9DA460C0C02CD035E6F14B406E05BEE900A560C06FBF248BB7F24B4087B3133F15A560C0204FD035F2F14B40FD7F133F03A560C068557BE0BCF04B40040EBEE9F3A460C088F7CE353AF04B401875BEE927A560C008E8CF35CEEE4B40311FBEE999A560C008E8CF35CEEE4B40A05D133FF7A660C098427AE01CF14B408E41BEE945A760C08C71D035FEF14B40FC7F133F93A760C08471D0353EF34B4084B3133FB5A760C087F7CE357AF44B40836CBEE9F4A760C018E8CF35CEF74B40EA63BEE921A860C08471D0357EF84B405F30BEE94FA860C0948D258BFFF84B40F838BEE902A860C0E093D0350AFA4B40040EBEE993A760C0740AD035DAFA4B40B4C4133F5BA760C058A3CF35B6FA4B403AAD68946AA760C048877AE034FC4B406030BEE9CFA760C02804258B8FFF4B406E05BEE9E0A760C013E8CF358E044C40EA63BEE901A860C00881CF352A074C404F146994EEA860C00036248BC7094C4094CF6894E6A860C0985ECF351E0D4C401775BEE977A860C0985ECF35DE124C40F838BEE922A960C020B979E06C154C402B91133F99AA60C03CB6D03516164C40CA27BEE99CAD60C08071D0357E154C406F05BEE930AE60C067557BE0BC154C408D41BEE9A5AE60C0D02CD03566164C4066BE6894B0AF60C0B8C5CF3582184C407E25699444B060C0E793D0358A184C40B2C4133FFBB160C0EB19CF3586174C409D16BEE956B260C018B979E0AC174C404E1469946EB260C038B6D03516184C40311FBEE9F9B260C09B427AE0DC194C4095CF689466B360C0B87A248BDF1A4C40CE6E133F8DB360C088F7CE35FA1A4C409C16BEE996B360C02FD5CE352E1B4C40BA52BEE9ABB360C094F7CE357A1C4C40E1D5133FB1B360C07871D0357E1D4C406E05BEE9A0B360C0DBB2CE35A21F4C40BA52BEE9ABB360C030D5CE35EE204C4058A2133FCFB360C04F3CCF3552214C40E1D5133F11B460C0F8CB7AE0CC214C40254ABEE948B460C09C8D258B7F224C404D1469944EB460C017E8CF358E234C40040EBEE9D3B360C018E8CF350E254C40E1D5133F71B260C04C877AE074254C4059A2133F1FB260C068BF248BF7264C40FA7F133F53B260C07F71D0353E284C4056A2133FCFB260C0C72CD035E6294C40BA52BEE9ABB360C05CA3CF35362C4C40BA52BEE9ABB360C00881CF352A2D4C409B16BEE9C6B260C00881CF352A2D4C4001030000000100000012000000CA27BEE94CBA63C0C0107BE0A4284C403AAD6894AABA63C0D02CD03526284C402DD8689429BB63C00717268BEF284C40E963BEE9C1BB63C0AF107BE0242A4C406B05BEE950BC63C02C4FD035B22A4C405CE96894BFBC63C0D32CD035662B4C40A5A46894B7BC63C070BF248B772C4C40264ABEE968BB63C0730AD0355A2E4C406230BEE96FBA63C0D893D0354A2E4C409A16BEE9F6B963C030B6D035962D4C408E41BEE9F5B963C0F419CF35462D4C40E863BEE901BA63C028B979E0AC2C4C4050146994FEB963C0C4107BE0E42B4C4050146994FEB963C0B4F4258BE32B4C408AFA6894D5B963C08471D035FE2A4C40B07DBEE9CAB963C040B6D035162A4C405CE96894FFB963C0E4B2CE3562294C40CA27BEE94CBA63C0C0107BE0A4284C4001030000000100000020000000EA63BEE9819460C07C0AD0359A384C40545BBEE93E9460C0B07A248B1F374C40F938BEE9F29360C04C3CCF3552344C40C827BEE99C9360C0F035248B47334C40B07DBEE9FA9360C088427AE09C314C40BB52BEE91B9560C0D8B2CE35222F4C40EA63BEE9619560C00881CF352A2D4C40525BBEE93E9560C0B8C5CF35C22B4C40555BBEE94E9460C068BF248BF7264C408C41BEE9B59460C0C82CD03526244C405E30BEE95F9560C0C82CD03526234C40E963BEE9219660C0C82CD035A6224C40F1F16894729760C058A3CF3536204C4038AD68943A9A60C097F7CE353A1E4C40D4FCBDE9CD9B60C00881CF352A1F4C4086B3133FB59F60C01CB979E0EC274C404F1469943EA160C018E8CF354E2A4C407E256994C4A160C0DCB2CE35222C4C406C05BEE990A160C00017268B6F2E4C4084B3133FC59F60C0707479E094354C40244ABEE9089F60C0D048258BA7374C40B5C4133F4B9E60C02004258B0F394C40FC7F133F939D60C0730AD035DA394C40321FBEE9F99B60C0F419CF35463A4C40E0D5133F719B60C0D0FD79E0043A4C40B2C4133F6B9A60C0985ECF35DE384C40E0D5133FE19960C07C0AD0359A384C40545BBEE97E9960C0543CCF35D2384C40D5FCBDE93D9860C0F419CF35463A4C404D1469947E9660C0C82CD035263B4C407E256994E49460C030D5CE356E394C40EA63BEE9819460C07C0AD0359A384C40010300000001000000380000002C91133FD98460C01BE8CF350E2D4C409C16BEE9F68360C033D5CE35EE2B4C40BB52BEE94B8360C00717268BAF2C4C4097CF6894968260C0888D258B3F2E4C4069BE6894B08160C054D2258B572E4C40D6FCBDE9CD8060C0F8CB7AE04C2D4C406D05BEE9208060C00481CF356A2B4C407D256994C47F60C0BCC5CF3542294C402991133F497F60C0E893D0358A244C4085B3133F157E60C0687479E0D41D4C40F1F16894B27D60C0284FD035F21A4C40826CBEE9B47D60C0D048258BE7184C4020036994787E60C0E093D035CA174C40F2F16894427F60C00C17268B6F184C406D05BEE9E07F60C0E4B2CE3522184C406D05BEE9208060C0BC107BE024144C40C4E068946C8060C050D2258B17124C40254ABEE9188160C017B979E06C104C4084B3133FD58160C0D848258B670F4C4068BE6894508260C0EC93D0354A0F4C401F036994B88260C0F880CF35EA104C40A05D133FE78260C00FE8CF350E134C40C4E068942C8360C0740AD035DA144C401975BEE9D78360C08071D0357E154C409C16BEE9C68360C02C04258B0F144C40545BBEE91E8460C08871D0353E144C406E05BEE9A08460C0D4B2CE3562154C40D5FCBDE90D8560C003CC7AE0CC164C405E30BEE99F8560C0948D258B3F184C409A16BEE9C68760C09B427AE0DC194C40A05D133FA78860C0BC107BE0641B4C404F146994CE8960C0F019CF35061E4C40F738BEE9D28A60C0908D258BFF204C40B17DBEE94A8B60C017E8CF358E234C401975BEE9778A60C0EC19CF35462A4C406E05BEE9908A60C0747479E0D42B4C401875BEE9178B60C0EC93D0350A2E4C4094CF6894168B60C00C81CF356A2F4C407D256994F48A60C07871D0353E304C40254ABEE9C88A60C0483CCF3512314C401775BEE9A78A60C0D048258B67324C40AE7DBEE9AA8A60C064BF248B37344C4020036994D88A60C0503CCF3512364C40C5E068942C8B60C050877AE0F4374C406E05BEE9A08B60C044B6D035D6394C40CC6E133F0D8C60C0C42CD035663C4C40F938BEE9028C60C0E819CF35863E4C408C41BEE9958B60C010E8CF354E3F4C40B07DBEE9DA8A60C07C0AD035DA3D4C402A91133F598860C07771D035BE3A4C40CE6E133FAD8760C08F8D258BFF384C4020036994488760C0344FD035F2364C40E2D5133FB18660C0985ECF359E324C407D256994448660C0F880CF35AA304C40FC7F133FB38560C08C71D035FE2E4C402C91133FD98460C01BE8CF350E2D4C4001030000000100000013000000A5A46894973C63C0C0C5CF3582444C4000C76894B33D63C0D0B2CE3522424C409C16BEE9E63E63C054D2258B97404C40010EBEE9B33F63C0DC48258BE7404C406E05BEE9304063C00081CF35AA414C40321FBEE9C94063C0F780CF356A414C4089FA6894E54163C067BF248B77404C408E41BEE9354363C01BE8CF354E404C40BC52BEE9DB4363C00436248B87404C40264ABEE9684463C04BD2258B57414C405DE96894CF4363C0E393D0350A434C40AE7DBEE9FA4263C02B4FD035B2444C408AFA6894354263C0F8CB7AE04C454C402991133FC94163C0E4B2CE35E2434C408AFA6894654163C040D2258B17464C40A2A46894A74063C0780AD0351A474C40E71C6994113C63C040B6D03556484C40E71C6994113C63C00881CF35AA464C40A5A46894973C63C0C0C5CF3582444C400103000000010000001D00000068BE6894F0A163C0E819CF35864A4C404E1469946EA163C04FD2258B57494C401875BEE947A063C00817268B2F484C40E61C6994C19F63C02C04258B0F474C40D3FCBDE94D9F63C028B979E0AC444C406ABE6894A09F63C00481CF35EA434C40FFC6689433A063C0F835248B47444C407E256994D4A063C0C0107BE064464C406D05BEE990A163C0F419CF35C6464C4096CF689476A463C00881CF35AA464C401775BEE9A7A463C0C4C5CF3542464C40C827BEE9FCA463C0E348258B67444C404F1469941EA563C0E4B2CE35E2434C40826CBEE964A563C0948D258BFF434C40E41C6994B1A563C034B6D03596444C40EA63BEE901A663C0304FD035F2444C40F738BEE992A663C088427AE0DC434C406C05BEE9E0A963C024B979E0EC434C402DD8689499AA63C050D2258B17434C40A4A4689477AA63C05FA3CF3576444C402ED8689429AA63C047877AE034464C40020EBEE9D3A963C048877AE0B4474C40D6FCBDE99DA963C040B6D03556484C40311FBEE929A963C0E493D035CA484C40BD52BEE94BA863C023B979E0AC4A4C40F3F16894C2A763C05CA3CF35F64A4C40BA52BEE97BA663C0B8C5CF35824A4C40A3A4689427A363C0F835248B074C4C4068BE6894F0A163C0E819CF35864A4C4001030000000100000028000000040EBEE9C34E63C068557BE07C4D4C40B07DBEE99A4D63C0F8647AE0E84B4C40B07DBEE99A4D63C0DC48258BE74B4C40C927BEE94C4D63C0304FD035324B4C40D2B568940D4D63C088427AE01C4A4C40D3FCBDE9DD4C63C02304258BCF484C4068BE6894C04C63C050A3CF3576474C40030EBEE9234D63C040D2258B17464C40E963BEE9914D63C0F8CB7AE04C454C408BFA6894154E63C034D5CE35EE444C40AE7DBEE94A4E63C0304FD035F2444C40A5A46894E74D63C0680AD0355A454C401875BEE9974D63C0CB2CD03526464C4021036994684D63C050A3CF3576474C40816CBEE9C44D63C0E4FD79E044474C403AAD68941A4E63C02FD5CE35EE464C403BAD68946A4E63C02FD5CE356E464C401775BEE9B74E63C068BF248BB7454C40B70B69942B4E63C0AF107BE0644A4C40EA63BEE9314F63C007E8CF358E4C4C40264ABEE9885063C0D893D0358A4B4C40C5E06894EC5063C00881CF35AA464C405AE96894EF4F63C024B979E0EC434C40311FBEE9994F63C0D02CD03526424C4021036994285063C04BD2258B57414C40D6FCBDE9FD5063C0F419CF3506414C40244ABEE9E85163C0304FD03532404C40B60B69948B5363C07C0AD035DA3D4C4096CF6894765563C090F7CE357A384C40806CBEE9645663C0AF107BE0A4364C406C05BEE9F05663C054D2258B97344C405AE968949F5763C088F7CE35FA324C40EA63BEE9915863C0F035248B47334C40EA63BEE9515963C0C02CD03526374C401875BEE9A75863C0E0FD79E0443C4C401975BEE9675763C0F8CB7AE00C414C40A2A46894675663C0E4B2CE35E2434C402DD86894295163C08871D0357E4C4C403CAD6894FA4F63C0888D258B7F4D4C40040EBEE9C34E63C068557BE07C4D4C400103000000010000001F0000007C256994A44263C0707479E0944D4C403AAD68947A4263C0908D258BBF4B4C4067BE6894304263C00FE8CF354E4A4C40BB52BEE9DB4163C098F7CE35FA484C40E863BEE9914163C050A3CF3576474C408AFA6894954263C040B6D035D6494C40D1B56894FD4263C038B6D035164A4C40040EBEE9534363C038B6D03596494C40040EBEE9434363C060BF248B77484C403AAD6894FA4263C008E8CF354E474C407C256994A44263C00881CF35AA464C408C41BEE9E54263C090F7CE35FA454C40E963BEE9714463C010E8CF350E444C40A5A46894874463C0E4B2CE35E2434C406C05BEE9104563C0680AD0355A434C405F30BEE91F4663C0C4C5CF3502414C40244ABEE9B84663C067BF248B77404C409A16BEE9F64863C040D2258BD7404C40525BBEE94E4A63C028D5CE35EE414C404E146994AE4A63C0BFC5CF3582424C404F146994EE4A63C0700AD0359A434C40040EBEE9334B63C068BF248BB7454C40545BBEE9CE4A63C028D5CE352E484C40525BBEE9EE4963C090F7CE35BA4A4C40D2B56894ED4863C0E4FD79E0844C4C40C727BEE9EC4763C0707479E0944D4C40C827BEE93C4763C0A75ECF35DE4D4C40D3B568944D4563C0707479E0944D4C401F036994F84363C0F880CF356A4E4C40BB52BEE94B4363C068557BE07C4E4C407C256994A44263C0707479E0944D4C400103000000010000001100000097CF6894C63765C0D848258B674F4C40826CBEE9743365C09CF7CE353A4D4C4097CF6894963265C0E4FD79E0044E4C40F538BEE9D23165C0A05ECF351E4F4C40D1B56894BD3065C0E4B2CE35E24E4C403AAD6894BA2F65C00017268BAF4D4C40D5FCBDE92D2F65C0DC48258BE74B4C40B90B69947B3065C007CC7AE00C4A4C40B07DBEE99A3165C0D893D0354A474C401975BEE9C73265C0F8CB7AE04C454C40545BBEE93E3465C068BF248BB7454C408AFA6894E53465C02FD5CE35EE464C408F41BEE9B53565C08471D035BE494C406C05BEE9303665C05CA3CF35F64A4C40826CBEE9843865C030D5CE35AE4D4C406130BEE93F3965C0D848258B674F4C4097CF6894C63765C0D848258B674F4C4001030000000100000007000000FC7F133F53ED63C0E893D0350A564C40050EBEE903EE63C0FC647AE0E8544C4097CF689496ED63C0A87A248B1F564C408D41BEE9C5EC63C0403CCF35D2574C40501469941EEC63C08071D0353E584C402DD8689459EC63C0406B258BB3574C40FC7F133F53ED63C0E893D0350A564C4001030000000100000009000000A4A4689427EB63C017337BE0F0584C400855133FA4EB63C0C0E1248B43584C402891133FA9EB63C0DCB2CE3562584C404CCD133F2EEB63C068BF248B77594C4086B3133FA5EA63C064EE7AE0185A4C40040EBEE913EA63C068EE7AE0D85A4C40264ABEE908EA63C0D0FD79E0445A4C404CCD133F8EEA63C044B6D03596594C40A4A4689427EB63C017337BE0F0584C40010300000001000000130000002CD86894994063C0FC35248BC75A4C40CA27BEE9CC4063C0A0A97AE0C0584C40E61C6994414163C0543CCF3592574C40FEC66894A34363C0CC2CD035E6584C402891133FB94363C09CF7CE353A594C406B05BEE9A04363C0E019CF35C6594C406030BEE99F4363C0707479E0145A4C406D05BEE9F04363C0BC107BE064594C409A16BEE9264463C030D5CE35AE594C40BD52BEE92B4463C0F880CF356A5A4C402A91133F094463C05858248BD35A4C403366133FDA4363C0B0A97AE0005B4C40E61C6994514363C040877AE0B45A4C402A91133FD94263C00036248B075B4C40C099133FCC4163C057EE7AE0D85C4C406477133FB04163C00036248B875D4C40AD7DBEE98A4163C08871D035BE5D4C40F638BEE9D24063C0089D248BEB5B4C402CD86894994063C0FC35248BC75A4C4001030000000100000042000000B2C4133F3B9C60C0F8CB7AE08C664C40B2C4133FDB9B60C0B47A248B1F664C40CE6E133FAD9A60C0EC93D0354A664C4058A2133F1F9A60C01704258B0F664C406030BEE90F9860C027D5CE352E614C40D5FCBDE9CD9760C097427AE09C5F4C409C16BEE9769760C024B979E0EC5C4C4096CF6894B69660C0A85ECF35DE5A4C408D41BEE9F59560C038D5CE356E594C40545BBEE99E9560C043B6D03596584C40C2E068947C9560C0F835248B87574C40B3C4133F2B9560C08871D035FE564C40EA63BEE9819460C0C02CD03566564C40EB63BEE9219460C0E4B2CE35A2554C40F2F16894F29360C0D848258B27554C401975BEE9779360C0304FD035F2524C40C4E068942C9360C0BC7A248B1F514C403AAD6894FA9260C02B4FD03532504C404C146994AE9260C0A05ECF351E4F4C401F036994789260C0700AD0359A4E4C40D6FCBDE9DD9160C0707479E0944D4C40CD6E133F8D9160C0F035248B474D4C4086B3133F459160C08F8D258B3F4D4C40EA63BEE9119160C040D2258BD74C4C40D7FCBDE9FD9060C037D5CE356E4B4C40EA63BEE9119160C00036248B474A4C40FA7F133F439160C00036248BC7494C40010EBEE9839160C03F877AE074494C407E256994C49160C0F019CF35C6484C40BA52BEE95B9260C098427AE09C474C40040EBEE9E39360C0D8B2CE3522474C401E036994689460C0284FD03532464C4068BE6894D09460C08771D035BE444C40E0D5133F519560C017E8CF35CE434C40FC7F133FE39560C094F7CE357A434C404D1469947E9660C0E4B2CE35E2434C4021036994F89660C08771D0353E454C40CA27BEE96C9760C09BF7CE35FA464C401575BEE9E79760C0A85ECF359E474C408F41BEE9759860C068BF248BB7454C40CF6E133F5D9760C04FA3CF35B6424C406E05BEE9209760C04BD2258B57414C40F1F16894B29760C007E8CF350E414C40EA63BEE9C19860C0D8B2CE35E23F4C4086B3133F559960C0740AD0359A3F4C4086B3133F659D60C0CC2CD035E6404C405F30BEE9FF9D60C09C8D258B3F424C40535BBEE93E9E60C038D5CE35AE444C40B4C4133F8B9E60C01F04258BCF4B4C4020036994789E60C0C4C5CF35024D4C40264ABEE9289E60C054877AE0744E4C40F2F16894B29D60C0473CCF35524F4C40E863BEE9819C60C02004258B8F504C40EB63BEE9319C60C0304FD035F2514C40545BBEE95E9C60C0F319CF3546534C40E3D5133F819D60C0D42CD03526584C40F2F16894929D60C0D7B2CE35E2594C40C2E068948C9D60C0B7107BE0E45B4C40EA63BEE9719D60C0FCCB7AE0CC5D4C407F256994449D60C057A3CF35365F4C40816CBEE9949D60C060BF248BF7604C40836CBEE9B49E60C09B427AE0DC644C4057A2133FCF9E60C0B77A248B5F664C40F838BEE9729E60C07C557BE0BC674C40E3D5133F819D60C04C877AE0B4694C40B2C4133F3B9C60C0F8CB7AE08C664C4001030000000100000008000000AE7DBEE9EAD663C0AC5ECF359E764C40C727BEE91CD763C048D2258BD7754C404E146994EED663C03C6B258B33774C40F838BEE962D663C0C4C5CF3542784C400955133F34D663C0C8777BE048784C402003699428D663C0908D258BFF774C4058A2133F7FD663C0149D248B6B774C40AE7DBEE9EAD663C0AC5ECF359E764C400103000000010000005F010000F938BEE992BF60C004CC7AE0CC6E4C40826CBEE9B4BF60C0938D258B7F6A4C407E25699414BF60C01F04258B0F6B4C40321FBEE9D9BE60C0DFB2CE35626A4C40CE6E133F9DBE60C0B47A248B1F664C40F3F1689472BE60C040877AE0B4664C40CA27BEE91CBE60C0D848258B67674C4068BE6894F0BD60C064A3CF35F6674C40FE7F133FC3BD60C0740AD0359A664C403AAD68946ABD60C048D2258B97624C407C25699434BD60C0BFC5CF35C2614C40816CBEE9F4BC60C090427AE05C614C407D256994F4BC60C08071D0357E604C402791133F19BD60C097427AE09C5F4C402A91133F89BD60C01804258BCF5E4C401675BEE987BD60C038B6D035D65D4C40A05D133F77BD60C00B81CF35AA5C4C408E41BEE985BD60C0B3107BE0A45B4C40C5E06894ACBD60C00C81CF352A5B4C4039AD68940ABE60C0B8107BE0645A4C40CC6E133F2DBE60C0CB2CD035E6594C406030BEE98FBE60C040B6D035D6564C409916BEE9B6BE60C02CB979E0EC554C406030BEE91FBF60C09C8D258B7F544C409C16BEE996BF60C093427AE0DC534C40C827BEE9CCC060C0284FD035B2534C40CA27BEE9CCBF60C0533CCF35D2514C40BD52BEE9DBBE60C044B6D03556524C40826CBEE904BE60C0D02CD03566544C40F838BEE952BD60C0304FD03532574C40E963BEE951BD60C05CA3CF35F6574C4058A2133F6FBD60C0770AD035DA584C409C16BEE976BD60C044B6D03596594C407C25699434BD60C0CB2CD035E6594C409A16BEE9E6BC60C0E3FD79E0045A4C408E41BEE955BC60C02404258B8F5A4C40826CBEE914BC60C0204FD035B25A4C40CD6E133FDDBB60C0C0C5CF35825B4C404E1469949EBB60C0D42CD035665D4C40301FBEE969BB60C09CF7CE357A5F4C40E3D5133F51BB60C0D0B2CE35E2604C4096CF689476BB60C0BB7A248BDF634C4086B3133FB5BB60C0F419CF3586664C401E03699498BB60C00C81CF35AA674C402991133FA9BA60C0B47A248B1F664C407E25699404BA60C0F835248B07644C40FB7F133FA3B960C04C877AE074634C409E16BEE996B860C0543CCF3592644C40E2D5133F01B860C0403CCF3552644C406C05BEE970B760C0680AD0359A634C40F838BEE9F2B660C064A3CF35B6624C40D5FCBDE9CDB860C047877AE074594C4021036994F8B860C09C427AE0DC574C40CD6E133FBDB860C037B6D03596564C40F3F1689452B860C0888D258BBF554C40D5FCBDE96DB760C0D0B2CE35E2544C406C05BEE950B760C03FD2258B97534C404F1469945EB760C0CB2CD03526524C40CE6E133F5DB760C0C02CD03526514C40806CBEE994B660C06C7479E0544D4C407D256994B4B660C0B47A248B1F4C4C40C4E068948CB760C04CD2258B97484C4039AD6894DAB760C030D5CE35EE474C40264ABEE938B860C04C3CCF3592474C40F2F16894B2B860C050A3CF3576474C40FA7F133FF3B860C097427AE01C484C40254ABEE958B960C07C0AD0355A4B4C40EA63BEE991B960C0E0B2CE35A24C4C40CA27BEE95CBA60C0EC93D035CA4D4C4095CF6894F6BC60C0D848258B674F4C408E41BEE985BD60C028D5CE35EE4E4C40EB63BEE921BD60C06C557BE0FC4C4C40F3F1689472BB60C0304FD035324B4C404E1469941EBB60C040B6D03556484C40FC7F133F43BB60C028D5CE352E484C4094CF6894E6BB60C07C0AD0359A444C402A91133FF9BB60C0E4B2CE35E2434C404D1469945EBC60C0B07A248B1F434C402003699418BD60C0503CCF3592424C40C4E068946CBD60C08B71D035BE414C40F1F1689472BD60C00081CF35AA404C406030BEE91FBD60C00417268BAF3F4C40BA52BEE9ABBC60C08871D035FE3E4C4056A2133F4FBC60C090F7CE35BA3E4C40E2D5133FD1BB60C02004258B4F3E4C40CA27BEE99CBB60C0C0C5CF35423D4C40EA63BEE981BB60C0503CCF35D23B4C40E3D5133F51BB60C0F419CF35463A4C40E2D5133F21BB60C038D5CE35AE394C40C5E068946CBA60C07C0AD0359A384C40BC52BEE90BBB60C07C0AD0359A374C402A91133F69BC60C0747479E054384C408D41BEE915BD60C0D048258BA7374C40A05D133FB7BC60C02804258B4F364C408F41BEE945BC60C02404258B8F354C40F838BEE902BC60C008E8CF358E344C406E05BEE930BC60C0D048258B67324C402A91133F69BC60C0B3C5CF3542324C40F738BEE9C2BC60C08871D0357E324C40B4C4133F1BBD60C0E719CF3506324C40F838BEE952BD60C0E393D035CA2F4C406130BEE97FBB60C064BF248BF72D4C405E30BEE9FFBA60C00717268BAF2C4C404D146994EEBA60C05CA3CF35362B4C4068BE689450BB60C08071D035BE274C404E1469941EBB60C024B979E02C264C404F146994CEBB60C02B4FD03572244C40F3F16894C2BC60C060A3CF3536274C407E256994C4BD60C034D5CE356E2B4C40CE6E133F9DBE60C0EC93D0350A2E4C40545BBEE91EBF60C0BC107BE0242E4C40010EBEE933BF60C08FF7CE35FA2C4C40321FBEE919BF60C00036248B072B4C40CE6E133F0DBF60C008CC7AE0CC284C40B17DBEE93ABF60C00881CF35EA254C4096CF689466BF60C040B6D03556244C405E30BEE94FBF60C028D5CE35AE234C409916BEE9B6BE60C017E8CF358E234C40321FBEE989BD60C0204FD035F2234C4059A2133F0FBD60C0B07A248B5F234C403AAD68948ABC60C0F880CF356A1D4C401F036994A8BC60C0DF48258B271C4C40040EBEE933BE60C0E0B2CE35221B4C40AE7DBEE93ABE60C010E8CF35CE194C40020EBEE9A3BD60C054877AE034164C40F1F1689472BD60C093427AE05C154C40E1D5133F51BD60C0740AD0355A144C40C4E068946CBD60C0D8FD79E044134C40EA63BEE901BE60C0E093D0358A114C40C3E068941CBE60C00C81CF35AA104C4068BE6894F0BD60C0EC93D0354A0F4C4066BE689420BE60C02F4FD035320D4C4059A2133F5FBE60C0403CCF35D20B4C40F1F16894C2BE60C0483CCF35120B4C40545BBEE95EBF60C040B6D035D60A4C404E146994CEBF60C0938D258B3F0B4C40311FBEE9F9C060C0DC48258B670D4C40EA63BEE941C160C00881CF356A0E4C40C4E068942CC160C0DCFD79E0C40F4C40BE52BEE94BC060C0344FD035B2174C40CD6E133F8DC060C05FA3CF3536194C4097CF6894F6C060C0F419CF35861A4C40EA63BEE941C160C0FF16268BAF1B4C409F5D133F37C160C00FE8CF358E1E4C40826CBEE904C160C0B8107BE024234C40B07DBEE90AC160C0E019CF3546274C40C4E06894ACC160C008CC7AE0CC284C408E41BEE935C260C0B0C5CF35C2264C403BAD68942AC260C0483CCF3512234C40E1D5133F51C260C0543CCF35D21F4C406D05BEE970C360C07B0AD0351A1F4C40FC7F133FE3C260C00481CF35AA184C40A15D133FE7C360C0BBC5CF3502174C40264ABEE958C560C02404258B4F174C4085B3133F15C660C003CC7AE0CC164C4067BE689430C560C00481CF35EA114C40EB63BEE9D1C460C00036248B87114C40A05D133FA7C460C00481CF35EA114C40F838BEE982C460C0DF93D0358A124C40F0F1689432C460C0985ECF35DE124C4069BE689450C360C050877AE0F4114C406D05BEE930C360C0780AD035DA0F4C409C16BEE936C360C088F7CE357A0D4C40040EBEE9C3C260C000CC7AE0CC0B4C40E2D5133FF1C260C03CB6D035960A4C40A05D133F37C360C067557BE0BC094C406E05BEE9E0C360C0F7CB7AE04C084C407C25699474C360C0D893D035CA064C40B4C4133F3BC360C0D0B2CE3522044C409A16BEE946C360C0B87A248B5F014C40264ABEE9A8C360C02804258B8FFF4B40050EBEE923C460C038D5CE35EEFF4B40E2D5133FC1C460C08871D0357E014C403CAD68940AC560C0700AD0359A034C402003699488C460C07C0AD0359A054C402A91133F39C560C087427AE0DC064C40D6FCBDE9BDC660C0EC93D0350A084C40C827BEE92CC760C008CC7AE00C0A4C4020036994B8C660C0F880CF352A0B4C408E41BEE9A5C660C0975ECF359E0C4C40B4C4133FEBC660C0B87A248BDF0D4C404E1469947EC760C00881CF356A0E4C407F25699494C760C0A45ECF351E0F4C4097CF689436C760C00C81CF35AA104C409A16BEE966C660C0D8FD79E044134C4059A2133F4FC660C07B71D035BE144C404E146994CEC660C00CCC7AE08C154C4096CF689466C760C0F419CF35C6154C401775BEE997C760C08071D0357E154C40301FBEE9E9C760C0707479E0D4164C406C05BEE900C860C038B6D03516184C40C4E068940CC860C0FF16268BAF1B4C403CAD68942AC860C08C71D0353E1D4C40B07DBEE96AC860C0E419CF35861F4C40A05D133F77C860C0707479E054214C40B5C4133F3BC860C0E0FD79E0C4224C40E0D5133F31C760C09CF7CE35FA204C40806CBEE9F4C660C048877AE034224C40FC7F133FF3C660C0E4B2CE3522244C404F146994DEC660C0E093D0354A254C40CB27BEE99CC660C048D2258B17264C4085B3133F15C660C068BF248BF7264C40F838BEE942C560C02FD5CE352E274C4058A2133F1FC560C068557BE0FC274C40CE6E133F6DC560C0E093D0358A2A4C40040EBEE9E3C560C09C8D258BBF294C40826CBEE964C760C01CB979E0EC274C40030EBEE9D3C760C053D2258B97264C40C4E068940CC860C024B979E02C264C40FC7F133F63C860C0FFCB7AE0CC254C40826CBEE9B4C860C0985ECF359E254C408F41BEE905C960C070BF248BB7254C40C4E068945CC960C024B979E02C264C40C4E068945CC960C068BF248BF7264C40E1D5133F51C860C00817268B6F284C40F838BEE982C860C02804258B4F2A4C40BB52BEE90BC960C0975ECF355E2C4C408F41BEE905C960C00017268B6F2E4C4088B3133FA5C860C02404258BCF2E4C40B2C4133F9BC760C0E393D035CA2E4C40826CBEE964C760C02404258B4F2F4C40A05D133FA7C760C0E019CF35C6334C401775BEE997C760C00436248B07354C4057A2133F4FC760C0E893D035CA354C40D6FCBDE9FDC660C04BD2258B57354C4086B3133FA5C660C0F7CB7AE08C344C401775BEE947C660C070557BE03C344C408E41BEE9C5C560C00CCC7AE0CC344C40BB52BEE9ABC560C04FD2258B97354C407F256994C4C560C00017268BAF364C4021036994D8C560C0DCB2CE3522384C4086B3133FB5C560C08471D0357E384C401F03699468C560C0DCB2CE35A2374C40B5C4133F1BC560C0B4107BE024364C401E036994F8C460C0D4B2CE35A2344C401E036994F8C460C040B6D035D62E4C40D7FCBDE9ADC460C0707479E0D42F4C40264ABEE9A8C360C0D048258B67324C40E1D5133FB1C360C0304FD035B2324C40274ABEE9B8C360C04C3CCF3552334C40F638BEE9A2C360C0284FD035F2334C40816CBEE954C360C070557BE03C344C40E2D5133F91C260C0F035248B47334C402A91133F39C260C0AC5ECF35DE314C404F146994EEC160C09C5ECF351E304C406D05BEE9A0C160C0483CCF35122F4C40EA63BEE941C160C0E393D035CA2F4C409C16BEE926C160C0F835248B07314C409F5D133F27C160C02CD5CE356E344C40826CBEE904C160C0D848258BE7354C4057A2133F4FC160C0D32CD03566374C40535BBEE9EEC160C0730AD0355A394C40E0D5133F21C260C0C82CD035263B4C401875BEE927C260C0E4B2CE35223D4C401D036994F8C160C08871D035FE3D4C408E41BEE995C160C0BC7A248BDF3D4C40826CBEE904C160C0B0107BE0E43C4C40321FBEE919C160C0304FD035323E4C408E41BEE945C160C0DF48258BA73F4C40F2F1689482C160C0780AD035DA404C40B07DBEE9CAC160C04BD2258B57414C40A05D133FE7C160C054877AE0F4414C40D6FCBDE90DC260C0FBCB7AE0CC444C40E0D5133F21C260C068BF248BB7454C40D4FCBDE99DC260C0780AD0359A464C409B16BEE9F6C260C07C0AD0359A444C40816CBEE954C360C0BF107BE0A4414C406E05BEE9E0C360C0740AD0359A3F4C40040EBEE973C460C030B6D035D63F4C40B5C4133FFBC460C0707479E094414C40F838BEE982C560C088427AE0DC434C4085B3133F15C660C068BF248BB7454C40331FBEE9F9C660C0E4FD79E044474C409C16BEE9E6C760C097427AE01C484C40254ABEE9D8C860C0344FD03532484C40BD52BEE9CBC960C050A3CF3576474C40BD52BEE9CBC960C040B6D03556484C402103699448C760C08F8D258BBF4D4C40040EBEE9E3C560C03CB6D035D64E4C40B17DBEE91AC560C0DCB2CE35A2504C402003699488C460C0C02CD03526514C4086B3133F65C360C0C0C5CF3582504C40C4E06894FCC260C038B6D035D6504C40040EBEE9C3C260C0503CCF35D2524C40CA27BEE9BCC360C00817268BAF534C40BA52BEE99BC460C0234FD03572534C407005BEE930C760C0687479E0D44F4C4095CF6894E6C760C0AC7A248B5F4F4C40FB7F133F83C860C078557BE03C504C407F25699424C960C0503CCF35D2524C404F1469946EC860C0C0107BE0E4534C401F036994B8C760C09CF7CE35FA534C40C827BEE92CC760C0334FD035B2544C40806CBEE9F4C660C00381CF35AA574C4066BE689420C760C0D7B2CE35E2584C406E05BEE980C760C060A3CF3536594C40E2D5133FE1C760C0C4C5CF3502594C40C4E068940CC860C043B6D03596584C40CE6E133F1DC860C0483CCF3592564C406E05BEE950C860C040B6D035D6554C406C05BEE9D0C960C074BF248B37554C406030BEE9AFCA60C007CC7AE08C554C40E2D5133F71CB60C0670AD0359A564C40FB7F133FC3CB60C043B6D03596584C40321FBEE989CC60C0E493D0350A5C4C40816CBEE9B4CC60C0E0B2CE35625D4C40826CBEE9A4CC60C030D5CE35EE5E4C40B2C4133F6BCC60C0D0B2CE35E2604C407E25699484CC60C07C0AD035DA634C40274ABEE9F8CC60C028D5CE35EE684C40F738BEE912CD60C0BF107BE0E46B4C40B4C4133FFBCC60C0B8107BE0246D4C40545BBEE9BECC60C098427AE01C6E4C404E1469946ECC60C094F7CE35BA6E4C40311FBEE919CC60C040877AE0F46E4C404F1469948ECB60C0E793D0358A6E4C40B6C4133F3BCB60C08B71D0357E6D4C40BC52BEE9ABCA60C0938D258B7F6A4C40545BBEE99EC960C03CB6D035D6664C40C827BEE9FCC860C088F7CE357A654C407E256994B4C860C0740AD0359A664C40545BBEE9DEC860C0D0B2CE3522694C408E41BEE945C960C0670AD035DA6A4C40826CBEE9C4C960C04F3CCF35526C4C409C16BEE936CA60C0483CCF35126E4C406E05BEE980CA60C0B0C5CF35C2714C40BD52BEE9CBC960C02CD5CE35EE724C404E1469947EC760C0274FD03572724C40C927BEE90CC760C00881CF35EA714C4021036994D8C560C0483CCF35126E4C4096CF689456C560C02404258B4F6D4C4068BE6894B0C460C0FC80CF35AA6C4C407E25699404C460C0D793D0354A6C4C406D05BEE970C360C0707479E0546C4C406D05BEE970C360C0284FD035326D4C409D16BEE9E6C360C040B6D035566E4C4095CF689486C460C0E019CF3546714C401E036994F8C460C0274FD03572724C40555BBEE94EC660C07F71D0353E734C407C256994D4C660C090427AE01C744C40CA27BEE9BCC660C0E0FD79E004764C4096CF689426C760C00381CF35EA764C40A05D133F77C860C02C04258B8F784C40B07DBEE9AAC760C070BF248B77784C4068BE6894A0C560C0E0FD79E004764C40B3C4133F1BC460C0E4B2CE3562754C40030EBEE963C360C0DBFD79E0C4744C40040EBEE9C3C260C07F71D0353E734C401875BEE9A7C160C044B6D03596724C401575BEE967C060C000CC7AE04C714C40F938BEE992BF60C004CC7AE0CC6E4C40010300000001000000D40000001575BEE977B860C0607479E0D4894C4068BE689480B560C064A3CF35B6874C409C16BEE9A6B260C0E048258B67864C409F5D133F77B160C0B47A248BDF844C40F938BEE9B2AF60C08F8D258BFF834C40555BBEE9DEAE60C0B0107BE024834C40B4C4133F3BAD60C018B979E06C804C40BA52BEE96BAC60C0D4B2CE35A27F4C402B91133FB9AA60C00081CF35AA7F4C40BC52BEE91BAA60C06B7479E0D47E4C4056A2133F8FA960C018E8CF350E7C4C40B3C4133F4BA960C0284FD035B2794C40826CBEE9F4A860C070BF248B77774C40C4E068946CA860C0F816268B6F764C40FC7F133F93A760C00717268BAF774C40535BBEE9CEA860C028D5CE35AE7B4C40EFF1689462A960C0C3C5CF35827E4C4056A2133F8FA960C018E8CF354E814C409D16BEE9A6A760C0D893D0358A7F4C40D4FCBDE97DA360C03CB6D035D67F4C40C727BEE9ACA160C00FE8CF35CE7D4C40F638BEE962A160C0A77A248B9F7B4C404E146994CEA060C0F880CF35AA794C408E41BEE915A060C078557BE03C784C4059A2133F5F9F60C00717268BAF774C40301FBEE9099F60C0EF19CF3586764C409B16BEE9969E60C0780AD035DA734C406C05BEE9F09D60C040877AE0F46E4C40BC52BEE9FB9D60C043B6D035D66C4C40B3C4133F5B9E60C0747479E0D46A4C40545BBEE9EE9E60C038B6D03556694C409D16BEE9969F60C0BCC5CF35C2684C409D16BEE9B69F60C094F7CE357A674C408E41BEE9559F60C05FA3CF35B6644C40264ABEE9989E60C0D0B2CE35E2604C40CA27BEE97C9E60C06B7479E0945F4C40525BBEE95E9E60C0BCC5CF35C25A4C40CC6E133F6D9E60C0780AD035DA594C406E05BEE9609E60C0E4FD79E004594C40A15D133F479E60C048877AE074584C40EA63BEE9219E60C0D7FD79E004584C405F30BEE9FF9D60C0F835248B87574C406C05BEE9F09D60C000CC7AE0CC564C40F638BEE9E29D60C0BC7A248B1F524C405F30BEE91F9E60C02B4FD03532504C406F05BEE9D09E60C054877AE0744E4C409C16BEE9269F60C0C4C5CF35024E4C402991133FF99F60C0C4C5CF35824D4C402103699458A060C0707479E0944D4C40321FBEE9C9A060C028D5CE356E4E4C403AAD68949AA160C0533CCF3552514C40BA52BEE9FBA160C0304FD035F2514C40C927BEE9BCA260C048877AE0B4524C40C2E068948CA360C018E8CF358E544C406E05BEE9F0A560C0985ECF355E5C4C409C16BEE956A660C008E8CF354E5E4C40FC7F133FA3A660C028D5CE35AE624C40CF6E133FFDA660C0403CCF35D2644C40331FBEE979A760C0C0107BE0A4664C40F838BEE902A860C064A3CF35F6674C4066BE689440A860C068557BE07C664C40816CBEE9D4A860C07871D035FE664C40331FBEE999AA60C0F7CB7AE0CC6A4C408F41BEE915AB60C058A3CF35366B4C402A91133F39AB60C0F335248B876A4C40B4C4133F5BAA60C0F035248B47664C40E0D5133F51AA60C0304FD035B2644C40C5E068946CAA60C00036248B47634C407C25699474AA60C0BFC5CF35C2614C40B07DBEE93AAA60C0F035248B07604C40FC7F133FC3A960C0DCB2CE35225E4C40CA27BEE92CA960C0403CCF35125D4C4096CF689496A860C0747479E0D45D4C402103699408A860C04C3CCF35125F4C405F30BEE97FA760C090F7CE35FA5E4C40234ABEE918A760C0C02CD035A65D4C4069BE6894F0A660C00C81CF352A5B4C4069BE6894F0A660C000CC7AE0CC564C40E2D5133F11A760C0F019CF35C6554C409D16BEE9A6A760C0B8107BE024544C406030BEE9CFA760C0503CCF35D2524C40E1D5133FC1A760C00881CF352A514C409D16BEE986A760C0680AD0355A514C409E5D133F47A760C0E819CF3546524C401E03699428A760C0503CCF35D2524C40D6FCBDE9CDA660C078557BE0BC524C409C16BEE926A660C07C0AD0351A524C404C1469942EA560C028B979E0AC514C4067BE689440A460C0680AD035DA504C40CE6E133F6DA360C068557BE07C4F4C40C827BEE9FCA260C0707479E0944D4C40C3E068946CA360C0E0B2CE35A24C4C409F5D133FD7A360C0284FD035724D4C402B91133F59A460C02404258B0F4E4C40F938BEE9E2A460C028D5CE356E4E4C40040EBEE963A560C054877AE0744E4C40040EBEE963A560C0707479E0944D4C4096CF6894A6A360C0DC48258BE74B4C402991133F39A360C05CA3CF35F64A4C40E0D5133F01A360C03BD5CE356E494C4020036994C8A260C02FB6D03596454C401875BEE987A260C0E4B2CE35E2434C40C5E068944CA460C0E4B2CE35E2434C40B4C4133FFBA360C0B87A248B5F414C4095CF6894F6A360C02C4FD035F23E4C402003699438A460C004CC7AE0CC3C4C40BB52BEE9BBA460C0C82CD035263B4C40525BBEE91EA560C030B6D035963A4C40244ABEE988A560C044B6D035563A4C40F0F1689462A660C0F419CF35463A4C401E03699428A760C0C82CD035263B4C40F838BEE952A760C03CB6D035963B4C40806CBEE974A760C017B979E02C3C4C40F838BEE992A760C0B0107BE0E43C4C4086B3133F75A860C0403CCF35523D4C40CF6E133F3DAA60C00C81CF356A3C4C409F5D133F17AB60C0B0107BE0E43C4C40020EBEE973AB60C027B979E0EC3D4C40AE7DBEE99AAB60C0670AD0351A3F4C4058A2133FCFAB60C0503CCF3512404C40F2F1689452AC60C067BF248B77404C40FB7F133FF3AD60C067BF248B77404C409D16BEE9A6AD60C040D2258BD73F4C409E5D133F67AD60C01804258B0F3F4C408D41BEE935AD60C048D2258B173E4C40FC7F133F13AD60C0B0107BE0E43C4C40CA27BEE9BCAD60C02304258BCF3C4C40826CBEE984AD60C050D2258B573B4C4056A2133F1FAE60C02FB6D035163A4C404F146994DEB060C02B4FD03532384C40E2D5133FE1B360C07C0AD0359A384C40321FBEE919B560C00081CF356A3B4C40545BBEE9EEB460C0C4C5CF3542474C40D5FCBDE90DB660C064A3CF3536494C40D5FCBDE9BDB560C0BFC5CF35C24A4C40C4E06894ACB460C07C0AD035DA4B4C404D1469944EB460C0707479E0944D4C40F738BEE9F2B460C0C4C5CF35824D4C409A16BEE916B560C0FF16268BAF4E4C404C1469940EB560C00481CF356A504C40D7FCBDE92DB560C0304FD035F2514C40FA7F133F93B560C09BF7CE35FA524C40F2F16894F2B560C0E019CF3586534C40F838BEE942B660C0D02CD03566544C40D7FCBDE97DB660C0C02CD03566564C40F838BEE972B660C00881CF35EA584C40CA27BEE92CB660C0E393D0350A5B4C40F838BEE902B660C050877AE0745D4C40AE7DBEE94AB660C0D0B2CE35E2604C40020EBEE9D3B560C093F7CE353A614C40C4E06894ACB560C040877AE0F4614C40D5FCBDE9BDB560C02CB979E0EC624C40EA63BEE9F1B560C078557BE0FC634C403AAD68942AB660C088F7CE357A654C40BB52BEE90BB660C08071D0353E664C4057A2133FAFB560C00417268B2F664C40D7FCBDE92DB560C0B0C5CF3542654C406E05BEE970B560C09F5ECF351E684C40331FBEE989B560C037D5CE352E6B4C40C5E06894BCB560C0F419CF35466D4C40AE7DBEE94AB660C0284FD035326D4C40F2F1689452B660C07871D035BE6C4C40836CBEE944B660C0AFC5CF35026B4C40AE7DBEE94AB660C0938D258B7F6A4C409F5D133F77B660C00881CF352A6A4C40030EBEE9E3B660C00881CF35AA694C40545BBEE90EB760C097F7CE353A694C408C41BEE955B760C0EC19CF3546684C40F738BEE9B2B760C0E493D0358A674C401775BEE917B860C03BB6D03556674C403AAD68947AB860C064A3CF35F6674C4038AD68940AB860C0BCC5CF35C2684C4038AD68940AB860C04C877AE0B4694C40A05D133F87B860C04FD2258B97694C405F30BEE9FFB860C007CC7AE0CC694C40525BBEE96EB960C0DFB2CE35626A4C40555BBEE9CEB960C050877AE0746B4C401875BEE9B7B960C02F4FD035F26B4C40EA63BEE991B960C0284FD035326D4C40B07DBEE9FAB960C0B87A248B1F6D4C404F1469943EBA60C08B71D0357E6D4C4084B3133F55BA60C0A05ECF355E6E4C40331FBEE939BA60C08471D035BE6F4C40FC7F133FC3BA60C0680AD0359A6F4C408E41BEE935BB60C0A87A248B1F6F4C40E1D5133FA1BB60C0473CCF35126F4C40826CBEE914BC60C034D5CE352E704C404D1469947EBC60C0780AD0355A724C40BB52BEE96BBC60C0D8B2CE3562734C40C4E068940CBC60C0503CCF3592734C40501469948EBB60C07F71D0353E734C40826CBEE974B960C05F7479E0D4704C4038AD68946AB860C0D42CD035A6704C403AAD68949AB760C0274FD03572724C402003699428B860C0E019CF3546734C403AAD6894DABA60C02C4FD035B2754C40D6FCBDE96DBC60C013E8CF354E7A4C40806CBEE994C060C0988D258B3F824C40806CBEE994C060C000CC7AE00C834C40BD52BEE96BC060C08871D035BE834C40BB52BEE95BC060C0B87A248B9F844C40CB27BEE95CC060C02804258B0F874C40030EBEE923C060C0C72CD03526884C404D1469949EBF60C0B7C5CF3582884C40AE7DBEE99ABE60C0A05ECF355E884C406ABE689440BE60C02704258B8F884C40B3C4133FDBBD60C018E8CF350E894C40C4E068947CBD60C0D4FD79E0C4894C407C25699434BD60C054D2258B978A4C40F2F16894D2BC60C00717268B6F8B4C40F0F1689462BC60C0F419CF35868B4C401575BEE977B860C0607479E0D4894C40010300000001000000490000002CD86894C92563C0C02CD03566964C40B80B6994CB2663C098427AE01C914C406C05BEE9F02463C02804258B0F954C408E41BEE9F52363C033B6D035D6954C40BE52BEE93B2363C0B8C5CF3502974C40C927BEE9DC2263C090F7CE353A974C40C4E068948C2263C028B979E0EC964C406C05BEE9302263C010E8CF35CE954C404F146994DE2163C02804258B8F954C408F41BEE9551F63C0747479E094964C40244ABEE9781E63C07C0AD0355A964C4068BE6894E01D63C08471D035BE944C40F638BEE9721D63C074BF248B37944C40CC6E133F0D1D63C038B6D03516954C40C4E06894CC1C63C038B6D03516954C4067BE6894701C63C0647479E054944C40D4FCBDE94D1C63C0344FD03532934C40F738BEE9221D63C0E0B2CE35E2904C40F738BEE9A21D63C0BC7A248B1F904C4022036994382063C0403CCF35928E4C40F4F16894822063C0E093D0350A8F4C40806CBEE9A42063C0DC93D035CA8F4C402DD86894C92063C0985ECF355E904C4021036994182163C01804258B4F904C40FEC66894E32163C03CD5CE35AE8E4C40B07DBEE9AA2263C04FD2258B978C4C40B80B69948B2363C0A85ECF355E8B4C40E71C6994A12463C01CE8CF354E8C4C40B07DBEE91A2563C027D5CE356E8C4C408E41BEE9352663C0A45ECF359E8A4C40EA63BEE9B12663C0985ECF351E8A4C4098CF6894E62663C08471D0353E894C406030BEE9FF2663C004CC7AE04C874C4020036994082763C00417268B6F844C40321FBEE9892763C0BCC5CF3542814C408BFA6894B52863C02C04258BCF7F4C409041BEE9052A63C0204FD035B27F4C40A4A46894F72A63C0C0C5CF3582804C40AF7DBEE96A2A63C0543CCF35D2824C405AE968944F2A63C000CC7AE00C834C408AFA6894752A63C02004258B0F844C40D2B56894AD2A63C04C3CCF3592844C40A4A46894F72A63C0B47A248BDF844C40C6E06894EC2A63C0F019CF35C6864C40545BBEE99E2A63C0F880CF35AA874C409B16BEE9462A63C0F019CF3546884C40C727BEE91C2A63C03F3CCF3552894C401775BEE9872A63C08071D0353E8A4C405F30BEE97F2B63C0DFFD79E0C4884C402F1FBEE9892C63C0F019CF35C6874C40BB52BEE92B2D63C0985ECF351E8A4C40806CBEE9A42C63C00081CF35AA8A4C409C16BEE9962B63C0D8B2CE35628C4C4000C76894D32A63C0F019CF35068D4C408D41BEE9D52A63C0D348258BA78D4C409A16BEE9062B63C0EB19CF35468E4C4068BE6894502B63C0403CCF35928E4C40F838BEE9922B63C0975ECF355E8E4C401F036994282C63C0A05ECF359E8D4C40040EBEE9832C63C0A05ECF359E8D4C406ABE6894202C63C010E8CF350E8F4C40A4A46894F72A63C02C04258B0F924C402FD86894E92963C000CC7AE0CC954C40BB52BEE98B2963C07C0AD0355A964C40D7FCBDE94D2963C0AC5ECF35DE964C40826CBEE9A42863C0B87A248B5F994C408C41BEE9552863C0473CCF35529A4C40EA63BEE9D12763C0C0C5CF35029B4C408E41BEE9552763C064A3CF35F69A4C4001C76894132763C004CC7AE00C9A4C40B80B69943B2763C0730AD0351A984C404E146994FE2563C030D5CE35AE974C402CD86894C92563C0C02CD03566964C400103000000010000002600000068BE6894604465C08871D035BE9C4C409A16BEE9A64465C017E8CF35CE9A4C40264ABEE9C84465C03CB6D035569A4C405CE96894EF4465C040B6D03596994C404D1469940E4565C0D02CD035A6984C4068BE6894304565C0BC7A248B5F964C40816CBEE9644565C0DFB2CE35A2954C405CE968947F4665C0C0C5CF35C2934C40AE7DBEE92A4865C02C04258B0F924C40E61C6994214865C0FFCB7AE08C904C40254ABEE9684865C06CBF248B378F4C4022036994D84865C040877AE0348E4C40A3A46894474965C0A05ECF359E8D4C405CE96894CF4865C0E819CF3546904C408F41BEE9B54865C09BF7CE357A914C40F3F16894D24865C00017268BEF924C40050EBEE9034965C0C0107BE0E4924C40C4E068943C4A65C004CC7AE0CC934C40C827BEE91C4B65C090427AE0DC924C408F41BEE9B54B65C0DCFD79E004934C40FFC66894534C65C0D848258BA7934C4098CF6894C64C65C087427AE09C944C409B16BEE9064D65C0D048258BE7954C405E30BEE92F4D65C0E048258BA7974C40D5FCBDE91D4D65C0204FD03532994C40C827BEE9AC4C65C0780AD035DA994C409B16BEE9764B65C0780AD035DA994C40EA63BEE9214B65C0B4107BE0249A4C40254ABEE9A84A65C0C4107BE0649B4C40C4E068945C4A65C038D5CE35AE9B4C40254ABEE9684865C0C4107BE0649B4C40B07DBEE9BA4765C038D5CE35AE9B4C40A4A46894B74465C060A3CF35F69D4C40A4A46894574465C04C3CCF35129F4C405E30BEE9EF4365C0DBFD79E004A04C40A5A46894574365C008CC7AE00CA04C4068BE6894A04365C048877AE0B49E4C4068BE6894604465C08871D035BE9C4C4001030000000100000032000000F838BEE932F260C0B47A248BDF9E4C4021036994B8F160C02FD5CE356E9D4C407B25699444F260C0E093D0358A9C4C40311FBEE9E9F260C05CA3CF35B69C4C403AAD68941AF460C0F7CB7AE04C9E4C40244ABEE9A8F360C0AC5ECF359E9C4C4095CF689466F360C02804258BCF9A4C40A05D133F47F360C01FB979E0AC984C405E30BEE93FF360C05CA3CF35F6954C40535BBEE90EF360C0E493D035CA934C4094CF689496F260C050A3CF35F6924C40EB63BEE901F260C0F880CF35AA924C40B4C4133F7BF160C02C04258B0F924C407D25699414F260C0A87A248B5F8E4C4066BE689440F360C00CCC7AE08C844C403AAD68941AF460C018E8CF354E814C40BB52BEE98BF460C003CC7AE00C814C40F738BEE992F560C0888D258B7F814C40AF7DBEE9FAF560C0C82CD035E6804C40B4C4133F4BF660C0D0B2CE3522804C40030EBEE9A3F660C00CCC7AE0CC7F4C4039AD6894EAFA60C030D5CE35AE7E4C40BD52BEE99BFA60C050A3CF3576864C40A15D133F57FA60C060A3CF35368A4C40F738BEE9D2F960C08B71D035BE8C4C40F838BEE952F960C0707479E0948D4C40F738BEE962F860C08F427AE09C8E4C4084B3133F45F760C07871D0353E924C408E41BEE9F5F660C0B8107BE0A4934C40555BBEE9BEF660C02804258B8F954C40FB7F133FF3F860C060A3CF3536954C402891133FE9F960C0C4107BE024964C40F838BEE942FA60C014E8CF350E994C40826CBEE914FA60C040B6D035969A4C409C16BEE986F960C0D893D0354A9D4C40AE7DBEE99AF960C0F7CB7AE04C9E4C4059A2133FFFF960C0EC93D0358A9E4C407A256994F4FA60C08071D035FE9C4C4058A2133F5FFB60C010E8CF358E9C4C40B07DBEE9DAFA60C0204FD035729F4C40C927BEE9CCFA60C054877AE0B4A04C40F4F1689422FB60C0BC7A248BDFA14C402003699468FA60C098427AE05CA44C405E30BEE9AFFA60C04FA3CF3536A74C406030BEE9FFFA60C02004258B8FA94C40545BBEE95EFA60C0EC93D0358AAA4C40E2D5133F31F760C0780AD0351AAA4C406030BEE9AFF360C00881CF356AA44C401875BEE927F360C010E8CF35CEA24C40F838BEE932F260C0B47A248BDF9E4C400103000000010000000A0000009088133FD68863C0A313248BBBAD4C40E963BEE9318963C0B0A97AE040AD4C40BB52BEE99B8963C0948D258BBFAD4C406277133FC08963C0F019CF3546AE4C40806CBEE9948963C0680AD0359AAF4C404ACD133F2E8963C09B427AE05CAF4C4086B3133FE58863C02B4FD035F2AE4C401DBC133F088963C03B6B258B73AE4C40CC6E133FFD8863C0B8C5CF3502AE4C409088133FD68863C0A313248BBBAD4C4001030000000100000008000000097DBFB78A0963C0688D3ADA7BAE4C40D629607F150A63C07FD0A9C17AAE4C40F13FC111990963C07BA13815E3AF4C4000A981D7380963C00C256763D0B24C401F42D548680863C0BFB3D42600B24C40447EB383300863C0E78B9CE32EB14C40D0BC325B910863C0603BCBD802B04C40097DBFB78A0963C0688D3ADA7BAE4C40010300000001000000100000002DD86894893A63C068557BE0BCB94C404F146994FE3A63C043B6D035D6B74C40806CBEE9C43B63C03BD5CE35EEB94C40826CBEE9343C63C0284FD035F2BC4C40F838BEE9623C63C0770AD0355ABF4C40244ABEE9683C63C0BF2CD03526C14C40BB52BEE92B3C63C0304FD035F2C14C409C16BEE9063C63C0F935248BC7C24C408C41BEE9053C63C068557BE03CC44C408D41BEE9C53B63C009CC7AE08CC54C4020036994183B63C0344FD03532C54C40B80B69949B3A63C0D793D0354AC34C40D6FCBDE99D3A63C0F735248B47C14C404D146994AE3A63C0BCC5CF3542C04C40816CBEE9943A63C093427AE01CBE4C402DD86894893A63C068557BE0BCB94C4001030000000100000052010000CA27BEE91CED60C060BF248B77B94C40C4E06894ACEC60C0F880CF35AAB84C406E05BEE940EC60C09C8D258BFFB84C402103699458EB60C06FBF248B37BB4C406D05BEE920EA60C09BF7CE353ABD4C406C05BEE970E960C0D02CD035A6BD4C40020EBEE923E960C0E719CF3586BC4C4068BE6894E0E860C008CC7AE00CBB4C40040EBEE943E860C0F716268BAFBB4C40F2F1689492E760C06F7479E014BD4C4068BE689410E760C031B6D035D6BD4C40826CBEE9C4E560C00336248B87BD4C40CE6E133F8DE460C037B6D03516BC4C401875BEE9E7E460C098F7CE35FAB94C404E1469941EE660C094F7CE35BAB84C407E25699484E660C0730AD035DAB64C40F838BEE9D2E560C0DF48258BE7B74C406030BEE9FFE460C07C557BE07CB84C40B4C4133F2BE460C04FA3CF3576B84C404E146994EEE160C0DBB2CE3522B64C406E05BEE9B0E160C05F7479E094B54C40EA63BEE971E160C00781CF35AAB44C40F2F1689442E060C0AF107BE0A4B34C4084B3133FD5DF60C0F880CF35EAB24C403AAD68941ADD60C08071D0357EAB4C403AAD68941ADD60C0EC93D0358AAA4C403AAD68947ADE60C040B6D035D6AB4C40E0D5133FF1DF60C090427AE05CAC4C40E0D5133FF1DF60C08071D0357EAB4C40331FBEE969DE60C00781CF35AAA94C40331FBEE969DE60C0985ECF35DEA84C40F838BEE912DF60C08371D035FEA74C40F2F1689452DF60C0EC19CF3546A74C40E3D5133F81DF60C00B81CF352AA64C402A91133FE9DE60C03BD5CE352EA64C403AAD6894AADE60C064A3CF3576A64C40331FBEE969DE60C0A05ECF351EA74C40CB27BEE90CDE60C03CB6D03556A64C40AE7DBEE9DADD60C0EF35248B47A54C408D41BEE9C5DD60C0284FD035F2A34C40F1F16894C2DD60C0EF19CF3546A24C40D06E133F8DDD60C028D5CE352EA14C40040EBEE913DD60C02404258BCFA04C403BAD68944ADB60C03F3CCF3552A14C40264ABEE9D8DA60C09C8D258BFFA04C40244ABEE9A8DA60C0483CCF35929F4C4095CF6894A6DA60C0F8CB7AE0CC9D4C4068BE6894B0DA60C0985ECF355E9C4C40FC7F133FE3DA60C0403CCF35929B4C40B07DBEE95ADB60C038D5CE35AE9B4C406030BEE96FDA60C0EB19CF3546994C40CE6E133FDDD960C070BF248B37974C40CE6E133FDDD960C08871D035FE944C40244ABEE9A8DA60C02C04258B0F924C407005BEE9F0D960C0CB2CD03526914C40AE7DBEE92AD960C07C0AD0351A8F4C406230BEE9CFD860C014E8CF358E8C4C402C91133F59D960C0985ECF351E8A4C40264ABEE9C8D860C0DFB2CE35228A4C40BC52BEE95BD860C03F3CCF3552894C40CA27BEE90CD860C0E893D0350A884C409E16BEE9D6D760C0B77A248B9F864C402C91133FC9D760C0A85ECF359E854C408C41BEE9E5D760C0E019CF3506844C409E16BEE9D6D760C000CC7AE00C834C40030EBEE9B3D760C05CA3CF35B6824C406D05BEE980D760C0D048258BA7824C40D8FCBDE94DD760C0670AD0355A824C40311FBEE929D760C018E8CF354E814C4039AD68942AD760C07871D0357E7F4C406E05BEE970D760C0E719CF35067D4C409C16BEE966D760C0C0C5CF35427B4C40A05D133F27D760C09CF7CE35FA794C409B16BEE9D6D660C040D2258B17794C40F838BEE9B2D660C08FF7CE35FA774C409F5D133FF7D660C0E0FD79E004764C40E963BEE931D660C0EC19CF3546744C4085B3133FF5D560C0A85ECF355E724C40F2F1689412D660C0C4C5CF35C26C4C40C3E06894DCD560C060A3CF35F66A4C408D41BEE985D460C0B47A248B1F664C40C5E06894DCD460C047D2258B97634C40CF6E133FADD460C04FA3CF35F6614C40EA63BEE941D460C027D5CE35AE604C40FC7F133FE3D360C057A3CF35365F4C409F5D133FB7D360C08871D0353E5D4C40FC7F133F73D360C0DF19CF35464C4C402B91133F99D360C06F7479E054484C40B07DBEE9AAD360C050A3CF3576474C402991133FF9D360C04C3CCF3512464C40AE7DBEE91AD460C068BF248B37464C40AE7DBEE93AD460C057A3CF3536474C408D41BEE985D460C040B6D03556484C406030BEE98FD460C0DBFD79E004494C4057A2133FCFD460C0F735248B874A4C4095CF689416D560C0E419CF35464B4C401975BEE937D560C0C72CD035A6494C403AAD68946AD560C047D2258BD7444C402103699408D460C074557BE03C3E4C4056A2133FFFD360C09C8D258B7F3C4C40EB63BEE951D460C008E8CF354E3A4C40555BBEE93ED460C04C877AE034384C407E25699404D460C0EC19CF3546364C40FC7F133FE3D360C0D4B2CE35A2344C40B4C4133FEBD360C0D8FD79E004324C40BC52BEE90BD460C0E4B2CE35A22F4C406030BEE94FD460C02F4FD035722D4C40F838BEE9C2D460C00481CF356A2B4C4086B3133F15D460C0E893D0354A2A4C409E5D133F37D460C044B6D03596274C401975BEE937D560C030D5CE35EE204C40545BBEE94ED460C0EC19CF3586224C40B4C4133F0BD460C063BF248B77214C40E2D5133F41D460C0747479E0D41E4C40F838BEE9C2D460C0FF16268BAF1B4C408D41BEE985D460C06F557BE0BC1A4C406030BEE9FFD460C090427AE05C164C40BC52BEE95BD560C02404258BCF154C40F2F1689412D660C068557BE03C174C408F41BEE985D560C04C3CCF35521A4C403AAD68946AD560C0FF16268BAF1B4C4056A2133F8FD560C03FB6D035161C4C4038AD6894DAD560C06B0AD0355A1D4C403CAD68943AD660C0985ECF35DE1D4C40F638BEE962D660C07871D0357E1D4C402003699478D660C03BB6D035D61C4C406E05BEE9A0D660C094F7CE357A1C4C40B07DBEE98AD760C0B7107BE0E41B4C406030BEE9FFD760C04C3CCF35D21B4C40535BBEE97ED860C094F7CE357A1C4C40331FBEE909D860C097F7CE353A1E4C4086B3133FB5D860C087427AE05C1E4C40EA63BEE931D960C037B6D035561F4C40CA27BEE97CD960C09CF7CE35FA204C4093CF689496D960C0A85ECF351E234C4084B3133FB5D960C0E793D0350A244C40B2C4133FFBD960C098F7CE357A244C40A05D133F47DA60C0C0C5CF35C2244C4096CF689476DA60C070BF248B37254C402003699488DA60C040D2258B57264C40244ABEE988DA60C00081CF35AA274C4096CF689476DA60C02CB979E0AC294C4058A2133F1FDB60C0A05ECF351E2A4C40F0F16894C2DB60C0C32CD035A6294C40CB27BEE93CDC60C00017268B2F2A4C40CE6E133F6DDC60C0770AD0359A2D4C40C927BEE98CDC60C068BF248B372E4C4039AD68942ADD60C094F7CE353A304C402991133F69DD60C0F880CF35AA304C4059A2133F9FDD60C0FFCB7AE04C314C40B07DBEE9CADD60C06FBF248BB7324C403AAD6894FADD60C00436248B07354C401875BEE927DE60C063A3CF35F6354C40E0D5133FF1DF60C09C8D258B7F3C4C405E30BEE91FE060C02004258BCF3E4C40F4F1689492E060C0E048258B27414C407C25699424E160C0BCC5CF3542434C406E05BEE9B0E160C047D2258BD7444C40040EBEE963E160C0E419CF3506454C40B27DBEE91AE160C0E348258B67454C401775BEE9D7E060C050877AE0F4454C404E1469949EE060C00881CF35AA464C4068BE689410E160C068BF248BB7474C40FA7F133F33E160C0F019CF35C6484C40B4C4133F0BE160C040B6D035D6494C404E1469949EE060C05CA3CF35F64A4C40F1F16894F2DF60C040D2258B574B4C40D6FCBDE94DDE60C024B979E02C4B4C403AAD6894FADD60C0DF19CF35464C4C40535BBEE9AEDD60C0F880CF356A4F4C4080256994F4DC60C0274FD035B2524C40D4FCBDE91DDB60C0D42CD03526584C40B3C4133FCBDB60C038B6D03516584C401675BEE947DC60C08471D035BE574C40806CBEE9B4DC60C01F04258BCF564C40030EBEE933DD60C008CC7AE00C554C406C05BEE9E0DD60C00481CF35EA514C407B25699444DE60C02C4FD035B2504C4068BE6894C0DE60C02B4FD03532504C406D05BEE950DF60C0C4107BE0E4504C4038AD68947ADF60C00BCC7AE08C524C402A91133F69DF60C0687479E094544C40301FBEE919DF60C0D02CD035A6584C40C827BEE9DCDE60C01CB979E0EC594C40E863BEE981DE60C0BCC5CF35C25A4C403AAD6894FADD60C0B3107BE0A45B4C40D6FCBDE9CDDE60C018E8CF354E5C4C40F738BEE982DF60C064A3CF35765B4C405F30BEE9FFDF60C0EC93D0354A594C40816CBEE964E060C087F7CE353A534C402891133FE9E060C02704258BCF504C40C4E068948CE160C0A85ECF35DE4E4C406E05BEE920E260C0707479E0944D4C401875BEE9F7E260C0D793D0358A4C4C40FD7F133F83E360C0F419CF35064D4C40545BBEE9CEE360C07771D035FE4E4C4085B3133FE5E360C0E0B2CE3562524C40F738BEE9D2E360C004CC7AE0CC544C409F5D133F97E360C0BC7A248BDF564C40D5FCBDE92DE360C0F035248BC7584C406C05BEE990E260C0204FD035B25A4C40836CBEE974E060C0BC107BE0A45E4C4084B3133FD5DF60C0204FD03572604C4094CF6894F6DF60C08B71D0357E614C401875BEE977E060C0344FD035B2624C407D25699404E160C070BF248B37634C408C41BEE945E160C07871D0353E624C4067BE689470E160C027D5CE352E614C40F1F1689462E460C0CC2CD035E6584C4068BE689440E560C050877AE0B4574C406030BEE99FE560C00781CF35EA564C40FA7F133F03E660C0A87A248B9F564C40B07DBEE96AE660C00381CF35AA574C40254ABEE978E660C028B979E0EC584C408C41BEE935E660C058A3CF35F6594C403CAD6894DAE560C0780AD035DA5A4C406030BEE99FE560C0B3107BE0A45B4C40CA27BEE9ACE560C024B979E0EC5C4C409E16BEE9E6E560C03F3CCF35125E4C406030BEE9EFE560C0D02CD035E65E4C40FD7F133FF3E460C09CF7CE357A5F4C40D4FCBDE9DDE460C058A3CF3536604C407D256994F4E460C0503CCF3552614C408E41BEE915E560C0D7B2CE3562654C40050EBEE913E560C02BD5CE356E664C40FC7F133FE3E460C0F019CF3586674C408E41BEE995E460C0C72CD03566684C4086B3133F55E460C0A87A248BDF684C40CA27BEE91CE460C0E448258B67694C4085B3133FE5E360C0938D258B7F6A4C40FC7F133F93E560C0E819CF35C6694C40D7FCBDE99DE860C08771D035FE644C4085B3133F45EA60C0B47A248B1F664C408F41BEE9D5E960C0403CCF3512694C40BC52BEE96BEA60C00881CF35AA694C404E1469944EEB60C08471D0357E694C40F738BEE9C2EB60C07B0AD0351A6A4C40826CBEE9C4EB60C0BC7A248BDF6F4C409F5D133F87EB60C094427AE09C714C4020036994E8EA60C0985ECF359E704C40F838BEE962EA60C0E3FD79E004724C40311FBEE9C9E960C0C4C5CF3502724C40C5E068946CE960C0304FD03532724C40264ABEE998E960C00017268B2F744C4037AD68940AEA60C0670AD035DA754C40EA63BEE9B1EA60C028B979E02C774C4097CF689466EB60C0770AD0351A784C406030BEE9FFEB60C02C04258B8F784C4059A2133FCFEB60C01804258BCF784C40030EBEE9A3EB60C0B87A248B1F794C402103699458EB60C013E8CF354E7A4C40FC7F133F33EB60C060A3CF35367C4C4096CF689496EA60C0B3C5CF35427D4C40F938BEE9E2E960C060A3CF35B67D4C40F1F1689442E960C00FE8CF35CE7D4C40264ABEE908E960C0A45ECF351E7E4C40321FBEE969E860C0740AD0359A7F4C40264ABEE948E860C04F3CCF3512804C4068BE689420E860C093F7CE357A804C401E03699458E760C0707479E094804C40EA63BEE981E660C098F7CE35BA814C406030BEE93FE560C08B71D035BE814C40EFF1689402E560C0BF2CD035A6824C403AAD68944AE560C054D2258B57854C40F838BEE9F2E560C053D2258BD7854C402003699448E760C0B47A248BDF844C40F838BEE992E860C0780AD0351A854C40D4FCBDE9EDE960C02C04258B0F864C40030EBEE923EB60C028D5CE352E884C406030BEE9FFEB60C0A85ECF35DE8B4C40331FBEE919EC60C090F7CE357A904C4086B3133F35EB60C0A85ECF351E934C401875BEE9D7E960C0443CCF3552944C4095CF689486E860C087427AE09C944C4095CF689486E860C02804258B8F954C40826CBEE944E960C07C0AD0355A964C40C4E06894ECE960C07F71D035BE964C402003699488EA60C0D893D0358A964C4087B3133F25EB60C02804258B8F954C4059A2133F0FEC60C064A3CF3536934C40CA27BEE99CEC60C090427AE0DC924C4096CF689436ED60C064A3CF3536944C40030EBEE933ED60C060A3CF35B6954C40321FBEE9B9EC60C01BE8CF354E974C40B07DBEE91AEC60C007E8CF358E984C402A91133FA9EB60C014E8CF350E994C409E5D133FA7EB60C0A05ECF351E9A4C4067BE6894B0EA60C008CC7AE00CA04C409A16BEE936ED60C0707479E0549F4C4058A2133FBFED60C0483CCF35929F4C40A05D133F97EE60C02CB979E06CA04C401E03699468EF60C0A05ECF35DE9F4C40E3D5133F31F060C0740AD035DA9E4C4057A2133FEFF060C0F7CB7AE04C9E4C40545BBEE95EF160C0780AD0351A9F4C40C4E068947CF260C0780AD035DAA44C407A25699474F460C00FE8CF358EA84C40F0F16894C2F460C0780AD0351AAA4C40B17DBEE98AF560C0BFC5CF35C2AC4C402B91133F99F560C0CF48258BE7AD4C40F2F1689432F560C02804258B8FAE4C403AAD6894AAF460C0BB7A248BDFAE4C408F41BEE955F360C0533CCF3512AF4C403AAD68948AEF60C03DD5CE35EEAC4C408C41BEE935EF60C06F0AD0355AAD4C40040EBEE913EF60C0E793D0358AAE4C4068BE689450EF60C0C3107BE024AF4C40F97F133FD3F060C09C427AE0DCAF4C4086B3133F25F260C0780AD035DAB14C4057A2133FBFF260C09C8D258B3FB24C40CA27BEE97CF360C094427AE09CB14C4086B3133F45F360C028D5CE35EEB24C404D146994EEF260C038B6D035D6B34C40545BBEE99EF160C08771D0353EB64C408F41BEE985F160C058A3CF35B6B64C407C25699484F160C0E3FD79E044B74C402003699448F160C0770AD0359AB84C405F30BEE90FF160C07771D0353EB94C409C16BEE986F060C0F780CF352ABA4C401875BEE947F060C0403CCF35D2BA4C4095CF689426F060C060A3CF35B6BB4C408E41BEE935F060C057A3CF3576BC4C40826CBEE954F060C0D02CD03526BD4C40FC7F133F63F060C031B6D035D6BD4C40244ABEE968F060C0FC35248BC7BE4C40EB63BEE991F060C040877AE034C04C40BA52BEE99BF060C0F816268BEFC04C40D6FCBDE97DF060C0948D258BFFC14C409F5D133F37F060C0E719CF3546C24C40050EBEE9E3EF60C007E8CF354EC24C405F30BEE99FEF60C00817268BAFC24C401675BEE9F7ED60C0C02CD03566C64C40F1F1689432EC60C090427AE0DCC64C409E5D133F77EA60C00081CF35EAC44C406D05BEE9F0E860C00481CF356AC14C406030BEE9EFE960C0677479E0D4BE4C401875BEE937EC60C0607479E054BC4C40CA27BEE91CED60C060BF248B77B94C4001030000000100000021000000A4A46894870D63C027B979E06CFB4C40020EBEE9930D63C0AC5ECF35DEF94C40264ABEE9580D63C0607479E0D4F84C401675BEE9570D63C017B979E02CF84C40244ABEE9880D63C04CD2258B97F74C40264ABEE9580D63C03DB6D03516F74C40C827BEE96C0C63C04CD2258B97F64C40BA52BEE98B0B63C0B77A248B9FF64C40501469945E0B63C0E019CF3586F64C40E0D5133F010B63C00817268B2FF64C4000C76894C30A63C09CF7CE35FAF54C402FD86894690A63C0988D258B3FF54C406ABE6894900A63C0D048258B27F44C408E41BEE9650B63C017B979E06CF24C403AAD68948A0B63C0FC35248BC7F14C40E963BEE9D10B63C063A3CF3576F14C40F4F16894320C63C0483CCF35D2F14C409B16BEE9B60C63C02C4FD035B2F24C40C727BEE98C0F63C02B04258B0FF54C40A4A46894271063C08071D0357EF64C4001C76894C30F63C0C02CD03566F84C409041BEE9750F63C0CF48258B67F94C40C5E068949C0F63C0E0B2CE35A2F94C4096CF6894A60F63C087427AE01CFA4C4068BE6894B00F63C04D877AE074FA4C404E146994BE0F63C0E819CF3586FA4C40F4F16894D20F63C0D42CD035A6FA4C407D256994C40F63C0747479E014FB4C40C6E068947C0F63C0F035248B47FB4C4068BE6894300F63C08771D035FEFA4C407D256994D40E63C03F3CCF35D2FA4C408AFA6894D50D63C008E8CF350EFC4C40A4A46894870D63C027B979E06CFB4C400103000000010000001F00000020036994582863C0B3107BE0A4F14C40EA63BEE9512763C0FFCB7AE04CED4C406ABE6894D02663C00336248B47EA4C40B80B6994CB2663C0DF19CF3506E84C40BB52BEE92B2763C0E0B2CE35E2E74C406230BEE9FF2863C0503CCF35D2E84C408D41BEE9152963C0BC107BE024E94C40F738BEE9322963C0F319CF35C6E94C406130BEE95F2963C0B07A248B5FEA4C401875BEE9A72963C0C82CD035A6EA4C403CAD68943A2A63C0503CCF35D2EA4C40C4E068947C2A63C02804258B0FEB4C405CE96894BF2A63C0204FD03572EB4C401775BEE9972A63C0F716268BAFEB4C409A16BEE9762A63C09B8D258BFFEB4C40EA63BEE9512A63C0E1FD79E044EC4C40C727BEE91C2A63C0C02CD03566EC4C4020036994682A63C0D048258BE7ED4C408D41BEE9F52A63C0AB5ECF355EEE4C40D4B568942D2C63C0C4107BE024EE4C40FEC66894B32C63C0533CCF3592EE4C401975BEE9B73063C0E0B2CE35E2F54C40A4A46894573163C0C0C5CF35C2F74C40A1A46894E73063C0B7C5CF3502FA4C4096CF6894363063C0DFB2CE3522FC4C40501469946E2F63C0E048258B27FD4C4020036994B82E63C0B37A248B1FFC4C4020036994D82D63C030B6D03556FB4C40050EBEE9732A63C0780AD0359AF64C4000C76894F32863C0403CCF3592F34C4020036994582863C0B3107BE0A4F14C400103000000010000001100000000C76894731863C008CC7AE00CF74C4096CF6894261963C05FBF248B77F64C403CAD6894EA1963C020B979E0ECF64C40A5A46894771A63C03CD5CE35EEF74C408AFA6894451B63C050D2258BD7F84C40AE7DBEE98A1B63C02F4FD03532FA4C406C05BEE9501B63C06B7479E0D4FB4C401F036994A81A63C0908D258BBFFC4C40D3B568941D1863C0F019CF3586FD4C40EA63BEE9D11763C027D5CE35EEFD4C40C827BEE95C1763C098F7CE35BAFD4C408AFA6894551763C0DF48258BA7FC4C408F41BEE9A51763C087F7CE35FAFB4C40B70B6994BB1763C060A3CF3536FB4C40C927BEE9AC1763C02004258BCFF94C405DE96894EF1763C064A3CF3536F84C4000C76894731863C008CC7AE00CF74C40010300000001000000D302000020036994682063C020B979E0ECF64C4020036994C81F63C0D0B2CE35E2F64C4098CF6894262063C00781CF356AF94C40E863BEE9711F63C0DF93D035CAF94C401875BEE9971B63C0A85ECF359EF74C405CE968949F1A63C088F7CE353AF64C40D2B56894DD1963C0B8C5CF3542F44C40244ABEE9581B63C0A05ECF359EF24C408BFA6894151C63C028D5CE356EF14C40E61C6994811C63C0BC107BE0E4EF4C40C5E06894EC1B63C0D4B2CE3522F04C40311FBEE9691B63C030D5CE35AEF04C40311FBEE9691B63C0BC107BE0E4EF4C40A2A46894971C63C0E1B2CE3522EE4C40B07DBEE9EA1C63C064A3CF3536EB4C407E256994F41C63C0E0B2CE35E2E74C40B80B69949B1D63C030B6D03556E24C40BC52BEE94B1D63C073557BE0BCE04C40A4A46894C71C63C050A3CF3576DF4C40E61C6994811C63C090427AE0DCDD4C4097CF6894561C63C0F419CF3546DD4C409041BEE9F51B63C050A3CF3576DD4C4088FA6894951B63C0687479E014DE4C40311FBEE9691B63C0F019CF35C6DE4C40F4F16894721B63C08971D035FEDF4C402FD86894991B63C078557BE0FCE14C40EA63BEE9A11B63C0740AD0351AE34C403CAD68947A1B63C08871D0353EE84C405CE96894FF1A63C0344FD03532EC4C40C827BEE92C1A63C0E1B2CE3522EE4C40D6FCBDE9FD1863C0EF19CF3546ED4C40826CBEE9841863C041877AE0F4EB4C40EB63BEE9211863C018E8CF358EEA4C40C827BEE9BC1763C055D2258BD7E94C404F1469943E1763C0C82CD035A6EA4C40264ABEE9D81663C0C02CD03566EC4C4096CF6894561663C053D2258B17F04C4050146994EE1563C0B3107BE0A4F14C4096CF6894661563C08C71D035BEF04C4096CF6894561463C01704258B8FEF4C40A4A46894F71363C0C4107BE024EE4C40BA0B69949B1363C069557BE0FCEF4C40020EBEE9B31363C094F7CE35FAF14C40244ABEE9081463C00CE8CF35CEF34C40E863BEE9611463C0D7B2CE3522F54C40C5E06894FC1363C0DF48258B67F74C40030EBEE9731363C0FB16268BAFF74C407E256994E41263C0CF2CD035E6F64C403AAD68946A1263C031D5CE35EEF54C406D05BEE9401263C0E4FD79E044F54C407C256994141263C0F835248B47F44C40F3F16894E21163C09C427AE09CF34C409A16BEE9A61163C0975ECF35DEF34C40BC52BEE95B1163C027B979E0ACF44C40BA52BEE90B1163C00CCC7AE00CF54C40264ABEE9381063C0D7B2CE3522F54C406030BEE98F0F63C0403CCF3592F44C406ABE6894200F63C08871D0353EF34C405BE96894BF0E63C0B3107BE0A4F14C40E41C6994410E63C0EB93D0354AF04C40826CBEE9B40D63C094427AE01CEF4C40A4A46894870D63C078557BE0FCED4C40A4A46894A70D63C0680AD0359AEC4C409B16BEE9060E63C0C82CD035A6EA4C40311FBEE9790D63C057A3CF3536E94C40525BBEE9DE0C63C0E048258B67E94C40D6FCBDE93D0C63C0D748258BA7EA4C406030BEE99F0B63C0C02CD03566EC4C409A16BEE9660B63C0E393D0354AEB4C40806CBEE9240B63C03F877AE074EA4C40AE7DBEE9DA0A63C00181CF35EAE94C401875BEE9870A63C0284FD035B2E94C40525BBEE96E0B63C0E719CF3546E64C406130BEE9AF0E63C04C3CCF3552E24C40816CBEE9E40F63C0C82CD035A6DF4C40545BBEE91E1163C0D8B2CE3522DC4C40F738BEE9A21163C0F019CF3506DA4C40F638BEE9521163C03FB6D03516D94C40244ABEE9A81063C0F816268BEFD94C406030BEE9EF0F63C0DBB2CE35A2DB4C40FEC66894230F63C030D5CE35EEDC4C40E61C6994D10E63C0F035248B87DC4C40D7FCBDE9FD0E63C0C4107BE064DB4C4096CF6894E60E63C0A05ECF359ED84C40EA63BEE9010F63C0B77A248BDFD64C40F2F16894420F63C0E3FD79E004D64C40501469948E0F63C0AFC5CF3542D54C40B70B6994CB0F63C07B0AD035DAD34C401875BEE9F70E63C0975ECF351ED44C40A6A46894770D63C0EC93D0354AD74C40A3A46894B70C63C0D1B2CE3522D84C40BC52BEE94B0D63C0BC107BE064D64C407E256994B40D63C05CA3CF35F6D34C40F2F16894F20D63C03FB6D03556D14C409B16BEE9060E63C08F8D258BFFCE4C407C256994A40D63C0F435248B87CE4C401975BEE9F70A63C0C72CD03526D14C408E41BEE9250563C0F419CF3546D04C40826CBEE9B40463C0284FD035B2CF4C402DD86894F90463C02F4FD03572CE4C407C256994B40563C0EB19CF35C6CC4C40D0B56894FD0763C02304258B4FC54C40264ABEE9A80863C0CB2CD035A6C34C4068BE6894500963C0E093D0358AC24C40F2F16894E20963C0D048258B27C14C405F30BEE94F0A63C050A3CF35B6BE4C406030BEE97F0A63C0543CCF3592BB4C40EA63BEE9910A63C0677479E014B94C4096CF6894D60A63C0234FD03572B74C40D3B568949D0B63C0730AD035DAB64C405DE968945F0D63C068BF248BB7B74C405BE968949F0D63C08171D035FEB74C40BC52BEE9DB0D63C04FA3CF3576B84C40254ABEE9180E63C028D5CE35AEB84C40CFB568945D0E63C0F880CF352AB84C40806CBEE9840E63C058A3CF35B6B74C4020036994B80E63C0D793D0354AB74C404E146994EE0E63C06FBF248BF7B64C40525BBEE91E0F63C0730AD035DAB64C40501469948E0F63C0730AD035DAB64C40D5FCBDE92D0F63C0DF48258BE7B74C408D41BEE9B50E63C028D5CE35AEB94C40244ABEE9780E63C07C0AD0355ABB4C40AE7DBEE9CA0E63C037B6D03516BC4C40AF7DBEE99A0F63C0CC2CD03566BC4C40B07DBEE90A1063C037B6D03516BC4C40B60B69943B1063C0403CCF35D2BA4C401F036994481063C0E793D0358AB94C40D7FCBDE96D1063C0B07A248BDFB84C403BAD6894AA1063C0D7B2CE35A2B84C40C5E06894FC1063C0770AD0359AB84C40321FBEE9291163C051D2258BD7B84C40B80B6994BB1163C0EC19CF3506BA4C406030BEE9FF1163C02BB979E06CBA4C404F1469943E1263C02BB979E06CBA4C40254ABEE9681263C0687479E014BA4C40D1B568948D1263C017B979E0ACB94C40BB52BEE9BB1263C060BF248B77B94C402DD86894E91263C073BF248BB7B94C40C6E06894FC1263C0F019CF3546BA4C408AFA6894051363C09C427AE0DCBA4C40F4F16894121363C06FBF248B37BB4C40AE7DBEE93A1363C010E8CF35CEBB4C406C05BEE9601363C0FF80CF35AABC4C402ED86894991363C049877AE074BD4C40A4A46894F71363C031B6D035D6BD4C40AF7DBEE94A1463C0730AD0359ABD4C402ED86894E91463C0BC107BE064BC4C40EA63BEE9411563C037B6D03516BC4C40E963BEE9911563C0D42CD03526BC4C40A4A46894E71563C0AC5ECF355EBC4C401775BEE9371663C0F035248BC7BC4C40D5FCBDE91D1763C03CB6D03556BF4C405CE968941F1763C02CB979E0ACBF4C408CFA6894451763C0F716268BEFBF4C40D0B568947D1763C0E093D0358AC04C408E41BEE9C51763C0BF2CD03526C14C40D6FCBDE91D1863C00481CF356AC14C401875BEE9A71963C064A3CF3576C04C4069BE6894101A63C02B4FD035B2C04C4000C76894A31A63C038B6D035D6C14C40816CBEE9F41A63C0D793D0354AC24C40816CBEE9641B63C0543CCF3552C24C40E61C6994811C63C00481CF356AC14C40535BBEE92E1D63C0E0B2CE35E2C14C40C827BEE9DC1D63C068BF248BB7C24C409A16BEE9861E63C0A85ECF351EC34C408E41BEE9251F63C0D793D0354AC24C40BC52BEE9BB1E63C0E1FD79E084C14C40311FBEE9591D63C090427AE01CC04C407C256994241D63C050A3CF35B6BE4C40A4A46894B71D63C08071D035BEBD4C408BFA6894E52063C058A3CF35F6BC4C408BFA6894E52063C037B6D03516BC4C4050146994BE2063C06CBF248BF7BB4C40244ABEE9A82063C0FFCB7AE0CCBB4C408AFA6894752063C06FBF248B37BB4C4022036994282163C0888D258B3FB94C405DE968946F2163C0D02CD035E6B74C4089FA6894552163C0730AD035DAB64C403AAD6894EA2063C09BF7CE35FAB64C401875BEE9072063C073BF248BB7B94C405CE96894AF1F63C02BB979E06CBA4C4000C76894A31A63C058A3CF35F6BC4C40515BBEE99E1963C0AFC5CF3542BC4C404F1469943E1763C0730AD035DAB64C403AAD68944A1463C0F716268BEFB34C405CE96894BF1363C094427AE09CB14C406D05BEE9A01363C00017268BAFB14C40B50B69947B1363C068BF248B77B14C40C827BEE94C1363C0D8B2CE35E2B04C40F4F16894121363C09C427AE0DCAF4C408D41BEE9651363C0E793D0358AAE4C406D05BEE9301463C0EF19CF35C6AC4C40545BBEE99E1463C08071D0357EAB4C408E41BEE9951463C0E419CF3506A94C401875BEE9371563C04BD2258B57A64C4096CF6894261663C0B0C5CF3542A44C406C05BEE9001763C0D793D0358AA34C40B07DBEE9CA1663C0BDC5CF35C2A64C40321FBEE9691763C0670AD0355AA74C40545BBEE98E1963C04C3CCF3552A54C409B16BEE9261A63C050877AE0B4A34C40C6E06894CC1A63C0E448258BA7A24C40EA63BEE9A11B63C0D793D0358AA34C401F036994781B63C0DCFD79E0C4A54C40264ABEE9E81B63C0B8107BE064A64C403CAD68948A1C63C0F880CF35EAA64C4096CF6894F61C63C0985ECF35DEA84C40501469942E1C63C059A3CF3536AB4C40E863BEE9111C63C01FB979E0ECAB4C403AAD68943A1C63C09C5ECF351EAD4C40A2A46894971C63C06F7479E0D4AC4C40F838BEE9421D63C08071D0357EAB4C4059E968943F1F63C0EC93D0358AAA4C40BD52BEE93B2063C00CCC7AE08CAB4C4000C76894C32063C013E8CF35CEAB4C4088FA6894D52163C0D7FD79E0C4A94C40030EBEE9D32263C00BE8CF35CEA84C40D0B56894DD2363C00481CF356AA84C40BC52BEE99B2463C0985ECF35DEA84C405BE96894DF2463C0B37A248BDFA94C4000C76894132563C0A15ECF355EAC4C40264ABEE9482563C0D748258B27AD4C40A2A46894972563C098F7CE35FAAC4C403CAD6894AA2563C0C72CD035A6AB4C402ED86894992563C08F8D258BFFA94C40BB52BEE97B2563C0985ECF35DEA84C405EE96894DF2563C049D2258BD7A74C4020036994882563C003CC7AE00CA74C402ED86894192363C02FD5CE352EA54C40BB52BEE95B2263C00436248B07A54C40AF7DBEE90A2163C00036248B07A74C4022036994182063C0BCC5CF35C2A54C40CA27BEE93C1F63C0D0FD79E044A34C406B05BEE9B01E63C00C81CF35EAA04C401875BEE9F72163C010E8CF358E9C4C40806CBEE9142363C0F816268BEF9B4C405DE968943F2663C02FD5CE356E9D4C40BC52BEE97B2663C00817268B2F9D4C40826CBEE9B42663C08871D035BE9C4C40C5E06894EC2663C0E093D0358A9C4C40E863BEE9212763C08071D035FE9C4C40B07DBEE91A2863C0F7CB7AE04C9E4C4098CF6894762863C0F8CB7AE0CC9D4C402CD86894092963C010E8CF350E9C4C40BB52BEE98B2963C038D5CE35AE9B4C408AFA6894D52963C0D0B2CE35229B4C405CE968945F2A63C04FA3CF35B6984C405CE96894BF2A63C0730AD0351A984C407C256994342B63C068BF248B77984C40D0B568940D2C63C04CD2258B579A4C40040EBEE9832C63C017E8CF35CE9A4C40D6FCBDE91D2C63C02B04258BCF984C40E863BEE9F12B63C030D5CE35AE974C408BFA6894F52B63C0E093D035CA964C405F30BEE90F2D63C00017268BEF924C40F4F16894A22D63C00417268BEF914C40301FBEE9192E63C010E8CF350E904C40E51C6994912E63C050877AE0F48E4C40F638BEE9222F63C01804258B4F904C407C256994542F63C00017268B6F924C40C5E068945C2F63C0334FD035B2944C40D7FCBDE98D2F63C08871D0357E964C40AE7DBEE93A3063C090F7CE353A974C40F738BEE9023163C0B8C5CF3502974C409C16BEE9563163C0B8C5CF3582964C4039AD68948A3163C02804258B8F954C403AAD68946A3163C007CC7AE00C954C40B70B69946B3063C010E8CF35CE954C40F838BEE9023063C02804258B8F954C40264ABEE9C83063C030B6D03596914C40BC52BEE9DB3063C06CBF248B37904C40AE7DBEE99A3063C0F019CF35068F4C406030BEE93F3063C0C82CD035E68D4C40F838BEE9023063C08B71D035BE8C4C406E05BEE9F02F63C0B8C5CF3582894C40BB52BEE96B3063C027B979E0EC884C4002C76894E33163C0985ECF351E8A4C4000C76894C33663C0687479E094884C4039AD68945A3863C0B77A248B9F864C4039AD68945A3863C0888D258BBF854C40D2B568946D3363C0B77A248B9F864C40B80B6994EB3263C0F880CF352A864C40806CBEE9E43263C0A85ECF351E854C403BAD68942A3363C024B979E0EC834C40BB52BEE98B3363C000CC7AE00C834C40E61C6994113463C04C877AE0B4824C40040EBEE9933463C0D8FD79E0C4824C40545BBEE90E3563C0E093D0358A824C40D6FCBDE97D3563C018E8CF354E814C405CE968946F3263C0C0C5CF3582804C40FEC66894C33163C03CB6D035D67F4C402DD86894E93163C0E019CF35467E4C40321FBEE9D93263C0C0C5CF35427B4C40F2F16894F23263C0F880CF352A7B4C40816CBEE9343363C0647479E0547B4C40535BBEE94E3363C0C0C5CF35427B4C40FEC66894533363C02BB979E0EC7A4C40331FBEE9493363C0C4C5CF35C2794C40535BBEE94E3363C00017268B6F794C4097CF6894C63363C058A3CF3536784C404D1469940E3463C0747479E0D4774C40F2F16894823463C00717268BAF774C40A3A46894573563C0DF19CF3506784C40D2B568947D3563C0B0C5CF3502794C40F4F16894723563C028D5CE35AE7A4C408E41BEE9B53563C0B7C5CF35027D4C408E41BEE9D53663C02404258B0F754C40826CBEE9A43763C02C04258BCF714C40F4F16894923863C07F71D0353E734C40C4E06894EC3863C0C0C5CF3542704C4020036994383863C08771D035FE6F4C40C5E068947C3663C0533CCF3592714C4096CF6894363663C0E719CF3506714C40C927BEE93C3663C0403CCF35D26F4C40E963BEE9713663C09C5ECF359E6E4C409A16BEE9B63663C0483CCF35126E4C40F4F16894923863C0284FD035326D4C40B60B6994BB3863C094427AE0DC6C4C40EB63BEE9D13863C0284FD035B26B4C40CA27BEE9FC3863C050877AE0746B4C404F1469942E3963C0B87A248B9F6B4C40D5FCBDE97D3963C0F419CF35466C4C40EB63BEE9613A63C0E048258B676C4C404E146994CE3A63C01BE8CF350E6C4C404F146994FE3A63C090F7CE35FA6A4C407C256994343B63C0BCC5CF3542684C401775BEE9B73B63C0A45ECF359E664C408E41BEE9F53C63C05BA3CF3576644C40FEC66894233E63C0B87A248B1F614C40C827BEE9CC3E63C0F319CF35C65F4C40A5A46894973F63C057A3CF35365F4C40C3E068947C4063C008E8CF35CE5F4C405F30BEE91F4163C030D5CE35EE604C40F2F16894C24163C0770AD0359A614C407C256994A44263C0D0B2CE35E2604C40A4A46894774363C01804258B4F5F4C40C5E06894EC4363C0B37A248BDF5E4C40264ABEE9684463C057A3CF35365F4C40254ABEE9C84463C0A85ECF351E604C404D146994BE4463C004CC7AE0CC604C40264ABEE9884463C0C82CD035A6614C40264ABEE9684463C088427AE01C634C40321FBEE9294463C024B979E0AC644C403CAD68940A4263C063BF248B776C4C40806CBEE9044063C08471D035BE6F4C40EA63BEE9413F63C0908D258B3F724C403AAD6894FA3E63C0D848258BE7734C409A16BEE9963E63C07871D0357E744C406C05BEE9D03D63C02404258B0F754C40F2F16894723C63C030B6D03516774C405AE96894EF3963C0F019CF35467C4C403CAD6894CA3863C0D4B2CE35A27F4C40CA27BEE9FC3863C0C0C5CF3582804C404D146994AE3A63C02C4FD035727C4C40E41C6994313B63C018E8CF350E7C4C40E61C6994613B63C038D5CE35EE7C4C405F30BEE99F3A63C0204FD03532804C40E61C6994C13A63C0988D258B3F824C409A16BEE9463B63C0F019CF3506834C40244ABEE9983B63C018B979E06C814C40FFC66894D33B63C038D5CE35EE7E4C40E71C6994113C63C0B7C5CF35027D4C40FEC66894B33C63C0E3B2CE35A27B4C40806CBEE9843D63C0D848258B277B4C4089FA6894253F63C0C0C5CF35427B4C40EA63BEE9013F63C00C17268B6F7D4C40D4FCBDE9CD3E63C0B87A248B5F7F4C4096CF6894863E63C0700AD0351A814C4050146994BE3D63C070557BE07C844C408F41BEE9253D63C040B6D035D6874C40D5FCBDE9BD3C63C03F3CCF3552894C404E1469943E3C63C010E8CF354E8A4C409B16BEE9B63A63C098427AE05C8C4C40F638BEE9323A63C08B71D035BE8C4C405AE96894EF3963C0503CCF35128D4C401675BEE9773963C05CA3CF35B68E4C40321FBEE9393963C0985ECF355E8F4C40AE7DBEE9DA3863C0E0B2CE35E28F4C405AE968947F3863C00881CF352A904C40D0B56894AD3763C01804258B4F904C40D0B56894AD3763C098427AE01C914C40C4E068940C3963C094F7CE353A934C4020036994C83963C068557BE0BC934C40311FBEE9193A63C0B0C5CF3582924C40F738BEE9423A63C04C3CCF3512914C40FFC66894A33A63C05CA3CF3536904C40501469946E3B63C0985ECF355E8F4C40A4A46894273F63C02CB979E0EC874C40254ABEE9384063C0EF35248B07854C408F41BEE9954163C07871D0357E7F4C409C16BEE9664263C0BC7A248BDF7C4C405AE968942F4363C09B8D258B7F7B4C40D6FCBDE9AD4363C030D5CE352E7E4C403AAD68944A4463C0D8B2CE35627F4C40264ABEE9684463C0C0C5CF3582804C4068BE6894504463C0A05ECF351E814C408AFA6894E54363C0304FD03572824C406C05BEE9C04363C000CC7AE00C834C40264ABEE9884363C0B47A248BDF844C405BE968948F4263C0E719CF3586884C408BFA6894B53E63C0985ECF355E8F4C402ED86894A94263C01804258B4F904C40B80B6994EB4263C088F7CE35BA904C40806CBEE9844363C0F035248B87924C403CAD6894DA4363C00017268BEF924C40254ABEE9984563C068BF248BB7924C40806CBEE9B44763C02304258BCF934C40F638BEE9924963C00017268BEF924C403CAD68948A4B63C00017268BEF924C40F1F16894F24B63C06B7479E094924C40A4A46894B74C63C0B47A248BDF904C40B50B69942B4D63C01804258B4F904C40BD52BEE9FB4E63C034D5CE35EE8F4C4096CF6894D64F63C0E093D0358A8E4C40D5FCBDE97D4F63C067BF248B778B4C404E146994BE4E63C0680AD0351A894C40F2F16894024E63C06F7479E054874C409C16BEE9364D63C020B979E06C864C40B80B69944B4C63C0B77A248B9F864C406030BEE98F4B63C02704258B8F874C40F838BEE9124B63C040B6D035D6884C4089FA6894354A63C01CE8CF354E8C4C40F4F16894824963C0A05ECF351E8E4C40A1A46894B74863C0F019CF35068F4C406C05BEE9E04363C038B6D035D68F4C40E61C6994514363C0403CCF35928E4C40EA63BEE9514363C0E493D0358A8C4C40816CBEE9944363C03F3CCF35D2894C406C05BEE9304463C0888D258BBF854C409A16BEE9E64463C00036248B87824C406C05BEE9104563C018E8CF354E814C406D05BEE9204563C03CB6D035D67F4C40B07DBEE90A4563C00CE8CF350E7D4C406C05BEE9104563C018E8CF350E7C4C40816CBEE9844563C0FF16268BEF794C40060EBEE9334663C0E048258BE7784C40C727BEE9EC4763C02C04258B8F784C40535BBEE95E4763C033D5CE356E774C40244ABEE9184763C0304FD03572764C402F1FBEE9194763C018E8CF354E754C404F1469945E4763C050A3CF35B6734C40D2B568949D4763C0C0107BE024734C404E146994DE4763C0B87A248B5F734C405AE968941F4863C0C72CD035E6734C40525BBEE95E4863C00017268B2F744C407C256994044963C0533CCF3592714C40321FBEE9D94863C0FC80CF35EA724C40E963BEE9E14863C064A3CF35F6734C4022036994184963C00017268BAF744C402DD86894794963C02404258B0F754C40545BBEE99E4963C02004258BCF6F4C40F638BEE9924963C040877AE0F46E4C40AF7DBEE90A4963C010E8CF354E6F4C40D4FCBDE92D4863C08771D035FE704C40806CBEE9B44763C0533CCF3592714C40806CBEE9B44763C0985ECF359E704C40F638BEE9B24863C017E8CF358E6E4C407C256994044963C0483CCF35126E4C408E41BEE9954963C08B71D0357E6D4C40EB63BEE9C14963C0E893D0358A6D4C40E81C6994C14963C078557BE0FC6F4C40F4F16894C24963C07871D0357E734C401775BEE9074A63C0E093D0358A754C40E61C6994814A63C0948D258BFF764C4069BE6894704C63C0B07A248B5F7B4C40BA52BEE92B4D63C0E893D0358A7C4C40A3A46894574E63C0E319CF35467D4C40806CBEE9244F63C027B979E06C7E4C40D5FCBDE97D4F63C030D5CE35AE7E4C40301FBEE9795063C030D5CE35AE7E4C40321FBEE9E95063C038D5CE35EE7E4C40FEC66894035163C01804258B8F7F4C407C256994F45063C0D848258B67804C404F146994DE5063C058A3CF3536844C40020EBEE9A35063C0F880CF352A874C408E41BEE9855063C038D5CE35EE894C40E41C6994115163C048D2258B578E4C40EA63BEE9015163C0780AD0359A934C40525BBEE91E5163C07C0AD0355A964C40D3FCBDE98D5163C030D5CE35AE984C4095CF6894D65263C06C7479E0949D4C40B80B69941B5363C0483CCF35929F4C405CE968943F5363C0B8107BE024A14C409C16BEE9965363C038B6D03516A24C40826CBEE9045463C00CE8CF358EA24C4088FA6894855563C024B979E0ACA24C40D2B56894CD5563C037D5CE35EEA24C408F41BEE9E55563C0D7FD79E084A34C402DD86894E95563C0A35ECF351EA44C40F2F16894F25563C00881CF356AA44C40321FBEE9E95663C007E8CF350EA44C40B70B69940B5863C0F8CB7AE00CA34C4059E968940F5963C00C17268BEFA24C404E146994AE5963C0EC93D0354AA54C407E256994345963C04C3CCF3552A54C408E41BEE9955863C0BCC5CF35C2A54C40301FBEE9295863C07C557BE0BCA64C40F638BEE9425863C0C3107BE064A84C405BE96894AF5863C0CD2CD035A6A94C40CA27BEE98C5963C0D0FD79E004AB4C40BA0B6994EB5963C090427AE05CAC4C4000C76894335963C0E093D035CAAD4C404F1469946E5863C03FB6D03556AD4C40806CBEE9945763C018B979E02CAC4C405CE968949F5663C08071D0357EAB4C4068BE6894C05663C0BCC5CF3582AC4C40F4F16894F25663C0E493D0354AAD4C40F838BEE9325763C05F7479E0D4AD4C40515BBEE97E5763C088427AE01CAE4C40515BBEE97E5763C078557BE0FCAE4C40525BBEE9DE5663C0CC2CD03566B04C40B60B6994AB5663C0D02CD035A6B24C40F4F16894D25663C0F019CF3506B54C40F2F16894425763C0730AD035DAB64C40826CBEE9F45563C0214FD035F2B94C4020036994E85463C098F7CE35FABA4C40D6FCBDE99D5463C08371D035BEBB4C40F738BEE9125563C058A3CF35F6BC4C404F146994CE5463C07871D0357EBF4C40535BBEE94E5463C0B8C5CF35C2C14C40BE52BEE9AB5363C0CF2CD03566C34C40A4A46894A75263C094427AE05CC44C406130BEE9FF5163C0B87A248B9FC54C40040EBEE9935163C054877AE0B4C54C401975BEE9475163C018E8CF350EC54C405BE96894AF5063C0D793D0354AC24C406130BEE94F5063C0D7B2CE35A2C34C405F30BEE9BF5063C058A3CF35F6C84C40301FBEE9795063C0CF2CD03526CA4C40030EBEE9934E63C04B3CCF35D2C94C4068BE6894C04C63C077557BE07CC84C40D7FCBDE91D4D63C06B7479E054C94C40C827BEE94C4E63C0F419CF3506CB4C4068BE6894C04C63C0E319CF3586CE4C40244ABEE9A84B63C0F419CF3546D04C408AFA6894954B63C0F319CF35C6D04C401875BEE9674B63C09B5ECF359ED24C40BC52BEE96B4B63C098F7CE35FAD24C40D0B56894CD4A63C094F7CE353AD34C40545BBEE99E4963C0C82CD035A6D24C407C256994044963C098F7CE35FAD24C408AFA6894954863C0D048258BE7D34C4095CF6894264863C0D42CD03526D54C4022036994A84763C031D5CE352ED64C40CA27BEE90C4763C068BF248B77D64C40BC52BEE97B4663C08771D035FED54C40B07DBEE96A4563C0DCB2CE3562D44C4020036994D84463C07B0AD035DAD34C402DD86894C94163C07B0AD035DAD34C4020036994984063C04FD2258BD7D24C407C256994044063C0780AD0359AD04C4089FA6894253F63C0F035248B47C94C405BE96894FF3F63C0A77A248B1FC74C40264ABEE9884363C054877AE0B4C54C406030BEE92F4263C07871D035BEC44C40E71C6994313F63C0AF107BE064C64C405CE96894EF3D63C09CF7CE357AC44C40F638BEE9723D63C024B979E0ECC04C408BFA6894053D63C01CB979E0ACB74C406B05BEE9803C63C098F7CE353AB44C40F2F16894023C63C04FD2258B17B34C408AFA6894E53A63C07871D0357EB14C40B60B69946B3A63C0EC93D0354AB04C40040EBEE9E33863C0B9C5CF3542A94C40311FBEE9E93763C03BB6D035D6A64C404E1469942E3463C024B979E0ACA24C405E30BEE99F3463C0770AD0355AA44C402DD86894693563C013E8CF350EA64C409C16BEE9463663C0E3B2CE3562A74C40C927BEE9CC3763C0543CCF35D2A84C405E30BEE91F3863C01BE8CF350EAB4C4001C76894433863C03BD5CE35EEAD4C40F4F16894923863C06F557BE0BCB04C40C6E068941C3963C094F7CE357AB24C403AAD68949A3963C09C5ECF355EB34C4096CF6894F63963C0F835248BC7B44C40B80B69943B3A63C0503CCF3512BE4C406130BEE92F3A63C018E8CF35CEC04C40E863BEE9E13963C0D793D0354AC24C405BE96894FF3A63C0ED19CF3586C64C40E41C6994313B63C0F835248B87C74C40331FBEE9393B63C0BB107BE0E4C94C408C41BEE9F53A63C07871D0357ECA4C406130BEE98F3A63C048877AE0F4C94C40F638BEE9323A63C0DBB2CE35E2C84C40B90B69945B3963C00481CF352AC74C40C827BEE9FC3763C028D5CE35AEC54C403BAD68949A3663C09C8D258BFFC44C408E41BEE9B53563C054877AE0B4C54C40C827BEE91C3663C0D0B2CE35E2C64C4069BE6894903663C00781CF356AC74C40F838BEE9B23763C0F835248B87C74C406ABE6894203863C038D5CE35EEC74C40C3E06894CC3B63C053A3CF3576D04C404F1469944E3C63C098F7CE35FAD24C40311FBEE9493B63C02004258B4FD44C40F538BEE9F23963C07C0AD0355AD44C40CA27BEE95C3563C0D848258B27D24C40010EBEE9833463C0EB93D0358AD04C404E1469942E3463C0EB19CF35C6CC4C40F4F16894C23363C070BF248B77CD4C4030D86894E93263C094F7CE35FACC4C409C16BEE9A63263C077557BE0BCCD4C40806CBEE9B43263C070557BE0FCCE4C40C5E06894FC3263C021B979E06CD04C402ED86894593363C097427AE09CD14C40E61C6994313463C0E493D035CAD24C40D4FCBDE95D3663C04BD2258B57D74C40E763BEE9313863C098F7CE35BAD84C40B80B69940B3C63C08871D035BED94C40BB52BEE9FB3C63C0DF93D0350ADB4C40D7FCBDE99D3D63C0D5B2CE3562DD4C408E41BEE9053E63C0F035248B47E34C4098CF6894963D63C08871D035BEE74C405CE968949F3C63C064A3CF3536EB4C40D2B56894FD3A63C00917268B6FEF4C40E61C6994C13A63C0BC107BE0E4EF4C40D2B568948D3A63C00436248B07F04C4020036994183A63C0A85ECF35DEEF4C40E863BEE9E13963C0BC107BE0E4EF4C404E1469947E3963C0284FD03572F04C4097CF6894763863C0DFFD79E084F24C402ED86894293763C070BF248B77F34C408F41BEE9053763C018E8CF354EF34C40C5E068947C3663C0647479E014F24C402FD86894293663C0E493D0358AF14C40806CBEE9D43563C018E8CF35CEF14C40A4A46894873563C0483CCF3552F24C40B80B69944B3563C0DFFD79E084F24C407E256994A43463C090427AE01CF14C40CA27BEE96C3463C007E8CF350EEF4C409C16BEE9163463C050877AE034ED4C407D256994143363C0C02CD03566EC4C40E61C6994613263C050A3CF3576EB4C406C05BEE9103263C00781CF352AE94C40D2B56894FD3163C0F835248B47E64C405AE96894FF3163C06F7479E094E34C40D1B56894DD3163C0BBC5CF3582DE4C406ABE6894803163C065A3CF3576D94C406D05BEE9F03063C0D32CD035A6D44C40AE7DBEE93A3063C0F419CF3546D04C406E05BEE9F02F63C0888D258B3FD24C408AFA6894B53063C0E493D0350AD94C40F3F16894E23063C030B6D03596DC4C407D256994642F63C0304FD035F2D94C402FD86894792E63C0D748258BE7D84C4069BE6894102E63C0F019CF3586D94C402FD86894592E63C00881CF35AADB4C4095CF6894062F63C008E8CF354EDD4C40F638BEE9723063C064A3CF3536DF4C40264ABEE9F82F63C0B0107BE064E14C40D0B568942D2F63C0F419CF3506E34C40A6A46894472E63C0C3C5CF3582E34C405CE968947F2D63C08FF7CE353AE24C40321FBEE9192D63C070BF248B37E04C405CE96894BF2C63C01F4FD035F2DD4C40C827BEE94C2C63C090F7CE35FADB4C40525BBEE99E2B63C037B6D035D6DA4C40C6E06894AC2A63C0A87A248B5FDB4C401875BEE9472A63C01BE8CF358EDD4C40CA27BEE96C2A63C02BB979E0ECDF4C408C41BEE9152B63C0F735248B07E14C401A75BEE9872B63C037D5CE356EE14C406ABE6894202C63C02FD5CE352EE34C402DD86894992C63C0A85ECF35DEE34C405BE96894AF2C63C07871D0357EE44C40D5FCBDE9BD2C63C09F5ECF351EE54C401675BEE9D72C63C0D848258B67E54C4000C76894D32D63C0D848258B67E54C4050146994AE2E63C0B8C5CF35C2E64C406D05BEE9402F63C0D7B2CE3522E94C40525BBEE93E2F63C0B3107BE064EB4C405BE968945F2E63C0C02CD03566EC4C402DD86894992D63C0A15ECF35DEEB4C407C256994342B63C0DF19CF3506E84C40F738BEE9522963C08771D0353EE64C40311FBEE9592763C0D848258B67E54C406C05BEE9C02663C013E8CF358EE44C4022036994B82663C077557BE07CE24C40D1B56894DD2663C090427AE0DCDF4C40B80B6994CB2663C0D5B2CE3562DD4C40B90B69949B2663C0F419CF3546DC4C406D05BEE9602663C060A3CF3576DB4C409A16BEE9162663C06FBF248BF7DA4C40244ABEE9B82563C037B6D035D6DA4C405DE968943F2663C04C3CCF3512DD4C40030EBEE9532663C0C3107BE024E04C40030EBEE9232663C03F3CCF3512E74C40B90B69945B2663C060A3CF35B6ED4C40B80B69948B2663C0FF80CF352AEF4C40B50B69946B2763C0BCC5CF35C2F14C4069BE6894B02763C070BF248B77F34C4020036994C82663C033D5CE356EF34C403AAD6894FA2563C0A87A248B5FF24C40BC52BEE99B2463C053D2258B17EF4C409A16BEE9662263C0344FD03532EB4C401875BEE9F72163C0284FD035B2E94C40CA27BEE98C2163C0C82CD035A6EA4C4068BE6894F02163C093F7CE35BAEB4C40264ABEE9B82263C089427AE01CED4C40321FBEE9192363C0C4107BE024EE4C4069BE6894202363C0E019CF3546EF4C406C05BEE9802363C04F3CCF3512F14C401875BEE9072463C078557BE0BCF24C404E146994FE2463C04C877AE034F44C403AAD68947A2663C087427AE01CF94C40F2F16894122763C07B0AD0355AFA4C40264ABEE9682863C0D02CD035A6FB4C40EB63BEE9712963C0BBC5CF3542FE4C40264ABEE9982963C064A3CF35F6FE4C401875BEE9A72963C07C0AD0351A004D40C6E068947C2963C0E093D0350A014D4022036994182963C043B6D03556014D4021036994A82863C07C0AD0351A014D4020036994582863C0948D258B7F004D4021036994582763C08971D035BEFF4C40A4A46894572563C0FF80CF352AFC4C40CA27BEE9CC2363C039D5CE35EEFA4C40C3E06894AC2263C0975ECF351EF94C403CAD68947A2163C051D2258B57F84C4020036994682063C020B979E0ECF64C4001030000000100000031000000050EBEE9D30A61C0B57A248BDF014D409F5D133FC70A61C0D42CD035E6004D40A05D133FD70B61C08571D035FEFF4C401775BEE9170C61C098F7CE35BAFE4C402A91133F790C61C030B6D03556FB4C40E2D5133F210C61C074BF248BB7F74C4058A2133F8F0C61C00FE8CF350EF34C405E30BEE96F0D61C0EC93D035CAEE4C406D05BEE9700E61C0C02CD03566EC4C408E41BEE9850E61C088F7CE357AEE4C40331FBEE9D90E61C0244FD035B2EF4C40040EBEE9130F61C0E893D035CAF04C40B4C4133FDB0E61C0DFFD79E084F24C402991133F190F61C03F3CCF3512F34C40B07DBEE96A0F61C060A3CF3576F34C40301FBEE9C90F61C0AB5ECF359EF34C4067BE6894301061C070BF248B77F34C40E1D5133F011061C0403CCF3592F44C40E3D5133FD10F61C030D5CE356EF54C40264ABEE9980F61C0FB80CF352AF64C4068BE6894500F61C0D0B2CE35E2F64C4068BE6894500F61C0C0C5CF35C2F74C409B16BEE9E60F61C0E4B2CE3522F84C40020EBEE9531061C03DD5CE356EF74C40D4FCBDE9BD1061C0FF16268B6FF64C403AAD68944A1161C031D5CE35EEF54C406B05BEE9B01161C00081CF356AF64C4068BE6894B01161C0DCFD79E084F74C404E1469946E1161C074BF248BB7F84C406230BEE90F1161C0B8C5CF3582F94C40BC52BEE97B1161C0CF2CD03526FB4C401875BEE9571161C0204FD03532FD4C4097CF6894E61061C0D0B2CE3522FF4C401F036994681061C0948D258B7F004D40264ABEE9A81061C088F7CE35BA014D40545BBEE97E1161C02FB6D03596014D40806CBEE9F41161C07C71D0353E024D409D16BEE9C61161C0770AD0351A034D40020EBEE9A31161C0687479E014044D40CA27BEE98C1161C0E4B2CE3522054D40B4C4133F7B1161C091F7CE35BA074D40545BBEE95E1161C00717268B6F084D4022036994781061C0700AD0351A0B4D40B2C4133FDB0F61C0C02CD035260C4D408F41BEE9350F61C0F019CF35860C4D40020EBEE9A30E61C0F816268BEF0B4D407C256994040E61C0E019CF3546094D40806CBEE9940B61C08C71D035FE034D40050EBEE9D30A61C0B57A248BDF014D4001030000000100000028000000C5E068947C2663C0BF2CD035A60C4D40F4F16894D22563C0F816268BEF0B4D40E61C6994312463C0737479E0D40C4D40C5E06894BC2363C01B04258BCF0C4D408C41BEE9652363C09C427AE01C0C4D4068BE6894D02263C08C71D035BE094D4096CF6894862263C070557BE03C094D405E30BEE95F2263C054A3CF35B6084D404F146994DE2163C0D0B2CE3562054D408E41BEE9852163C07771D035BE044D4069BE6894002063C08C71D035FE034D40E61C6994811C63C04B877AE0B4FF4C402CD86894E91C63C017E8CF35CEFE4C407E256994541D63C064A3CF35F6FE4C408E41BEE9C51D63C073557BE07CFF4C406C05BEE9401E63C04B877AE0B4FF4C403AAD68947A1F63C02CB979E02CFE4C4069BE6894002063C053877AE0F4FD4C40C4E06894DC2063C02404258B8FFE4C40CA27BEE99C2263C024B979E0EC004D40F2F16894B22363C0988D258BBF014D4089FA6894652563C0FC16268B2F044D40C5E068947C2663C02304258BCF034D40331FBEE9E92663C05FBF248B77044D40F1F16894D22763C030D5CE352E094D40A5A46894672863C019B979E0EC0A4D401775BEE9372963C02404258B0F0B4D40BC52BEE96B2863C0533CCF3592074D40B07DBEE91A2863C0314FD035B2064D40030EBEE9E32A63C02C4FD035F2054D4089FA6894252C63C034B6D03556064D40FC7F133F632D63C0284FD03572084D405AE968944F2A63C013E8CF354E104D40C6E068948C2A63C0C0C5CF3542114D407C256994042A63C0D32CD03526124D407E256994742963C08471D035BE124D4001C76894E32863C0DF93D035CA124D4020036994582863C018E8CF350E124D40050EBEE9332763C0730AD0355A0E4D40C5E068947C2663C0BF2CD035A60C4D400103000000010000000D000000020EBEE913FB62C018B979E06C164D40D6FCBDE9CDFB62C050A3CF3536164D406030BEE96FFC62C0B7107BE0E4164D40806CBEE9B4FC62C00B17268BAF184D40321FBEE989FC62C08171D0357E1A4D409C16BEE9B6FB62C08871D035FE204D401775BEE977FA62C0898D258BFF214D403CAD6894EAF962C0E048258BA7214D40010EBEE963F962C0403CCF35521F4D403CAD6894CAF962C0CB2CD035261B4D40806CBEE914FA62C07D0AD0351A194D408D41BEE985FA62C007CC7AE04C174D40020EBEE913FB62C018B979E06C164D40010300000001000000A5010000E2D5133FE1F660C0D348258B671D4D4058A2133F0FF660C050A3CF35F61C4D40F838BEE932F560C01F4FD035721D4D40A15D133F57F460C08C71D0357E1D4D401675BEE9F7F360C004CC7AE0CC1C4D40525BBEE93EF360C08171D0357E1A4D402991133FE9F260C0908D258BFF194D40CE6E133FCDF160C0E419CF3586194D40B4C4133F7BF160C0BB7A248B1F194D4021036994B8F160C0988D258B3F184D4067BE689430F160C0FF16268B2F174D406030BEE90FF060C09C8D258B3F164D40020EBEE983EF60C0908D258BBF144D40826CBEE9E4EF60C010E8CF354E134D40F0F1689412F060C053877AE0B4114D406F05BEE930F060C02804258B0F104D40FC7F133F63F060C070557BE07C0E4D406130BEE9BFF060C09C427AE01C0D4D409D16BEE916F160C099F7CE35BA0C4D408E41BEE975F160C034B6D035960C4D4069BE6894F0F160C0F816268BEF0B4D406D05BEE9A0F260C0AF7A248B9F094D4096CF689446F360C00781CF35EA064D40F638BEE912F460C0FFCB7AE04C054D401975BEE927F660C02FB6D035D6064D40535BBEE99EF860C02C4FD035F2054D40535BBEE90EF960C0D0B2CE3562054D409B16BEE916F860C08B71D0357E034D40545BBEE92EF660C0E4B2CE3522054D40F2F1689432F560C08C71D035FE034D4059A2133F6FF560C0284FD03532034D401F03699408F560C01BB979E0AC024D409D16BEE976F460C0D893D0354A024D404E146994FEF360C00717268BAF014D40F1F16894E2F360C0948D258B7F004D4096CF689436F460C00881CF35AAFF4C40C3E06894CCF460C0F716268B6FFF4C4021036994B8F760C0DC93D0354A004D401875BEE997F860C0E819CF35C6FF4C40F938BEE962F960C053877AE0F4FD4C406030BEE9AFF660C060BF248B37FD4C40F838BEE932F560C021B979E02CFC4C4058A2133FFFF460C0B8C5CF3582F94C407005BEE980F460C0AC5ECF35DEF94C40020EBEE913F460C070557BE0BCFA4C40F638BEE9F2F360C098427AE0DCFB4C40A15D133F57F460C0888D258BFFFC4C40A15D133F57F460C053877AE0F4FD4C40244ABEE9A8F360C027D5CE35EEFD4C40264ABEE9F8F260C0B8107BE064FE4C409C16BEE956F260C0D32CD03566FF4C407D256994D4F160C08FF7CE35FA004D4059A2133F7FF060C08871D0357E074D40A15D133FF7ED60C0FF16268B2F0A4D4086B3133F95ED60C028B979E02C0C4D4067BE6894D0ED60C0533CCF35520D4D402A91133F49EE60C030D5CE356E0E4D40040EBEE9A3EE60C013E8CF354E104D40F638BEE912EE60C09C8D258B7F104D404C1469940EED60C074557BE0BC114D40806CBEE974EC60C018E8CF350E124D40CE6E133FCDEB60C03FB6D035D6114D409D16BEE916EB60C068557BE03C114D408F41BEE9D5E960C030D5CE356E0F4D40EB63BEE911EA60C0B87A248B1F0F4D4067BE6894B0EA60C038D5CE35AE0D4D40F838BEE922EA60C0975ECF35DE0C4D40B3C4133F9BE960C050877AE0F40C4D4095CF689486E860C038D5CE35AE0D4D4068BE6894E0E760C00381CF356A0D4D404E1469949EE660C05BA3CF35360C4D40274ABEE9F8E560C0F816268BEF0B4D409C16BEE9C6E360C01B04258BCF0C4D401875BEE937E360C0985ECF355E0C4D40D6FCBDE9DDE260C0F880CF356A0B4D40020EBEE9E3E260C0888D258B7F0A4D4086B3133F75E360C0FF16268B2F0A4D4086B3133F75E360C070557BE03C094D40BC52BEE95BDF60C02C4FD03572064D401775BEE997DD60C0DDFD79E084034D40CE6E133FDDDC60C01704258B8FFC4C401875BEE9F7DC60C0DFB2CE3522FC4C40E0D5133F31DD60C00536248B07FC4C40B07DBEE96ADD60C0EF35248BC7FB4C4085B3133F85DD60C0CC2CD035E6FA4C40E4D5133F71DD60C0FCCB7AE00CFA4C4066BE689420DD60C0344FD035B2F84C403AAD68941ADD60C0C0C5CF35C2F74C40D4FCBDE94DDD60C0C0107BE0E4F54C40826CBEE994DD60C07F71D035FEF44C40331FBEE969DE60C070BF248B77F34C40E863BEE9E1DE60C0F880CF356AF14C40AF7DBEE9BADE60C0503CCF3592EF4C40806CBEE924DE60C00881CF35EAED4C40CC6E133F4DDD60C0C02CD03566EC4C4084B3133F45DE60C00B17268BEFEC4C404E1469947EE160C070BF248B77F34C40D6FCBDE97DE360C0CC2CD035A6F54C40AE7DBEE91AE460C031D5CE35EEF54C40E0D5133FA1E460C0D02CD03566F64C40E863BEE951E660C0B8C5CF3582F94C407E25699484E660C064A3CF35B6F84C4086B3133FE5E560C063BF248BF7F54C40E0D5133F21E560C00C17268BAFF34C40BC52BEE94BE460C0D848258BE7F14C4086B3133F75E360C030D5CE35AEF04C401875BEE9C7E160C0EC93D035CAEF4C408C41BEE945E160C053D2258B17EF4C401F03699478E060C0E093D0354AEC4C40321FBEE909E060C0EB19CF3586EB4C40E3D5133F81DF60C0C02CD03566EC4C40C2E068946CDF60C098427AE01CEA4C4021036994F8DE60C070BF248BF7E84C40F1F16894C2DD60C0DF19CF3506E84C402003699428DE60C08771D0353EE74C40EA63BEE911DF60C027B979E0ACE64C40E3D5133F81DF60C02C4FD03532E64C4066BE689420E060C064A3CF35F6E44C406F05BEE970E060C051D2258B97E44C4056A2133F7FE660C07871D0357EE44C40CA27BEE94CE860C0E3B2CE35E2E54C4039AD68947AED60C0978D258B7FEE4C407C25699464EE60C0C3C5CF3582EF4C4086B3133F65EF60C0BC107BE0E4EF4C40B3C4133FBBEF60C00CCC7AE04CF04C404C1469942EF060C06F0AD0351AF24C402991133F49F660C0503CCF35D2F74C406E05BEE910FB60C0938D258BFFFE4C408C41BEE9B5FB60C0F019CF3586FF4C409F5D133F77FC60C04B877AE0B4FF4C409F5D133F77FC60C09D8D258BBFFE4C408E41BEE9E5FA60C0F780CF35EAFC4C40806CBEE924FA60C030B6D03556FB4C40F738BEE9D2F960C087427AE01CF94C40311FBEE959F960C0483CCF3592F74C40040EBEE9A3F360C03BD5CE35AEF24C406030BEE9CFF260C00C81CF352AF14C40264ABEE968F260C0C0107BE0A4F04C406F05BEE980F160C0740AD0351AF04C40EA63BEE9A1F060C010E8CF354EEE4C4059A2133F7FF060C0C4107BE024EE4C402891133F69F060C040D2258BD7ED4C40EA63BEE981F060C08371D0353EEC4C40FC7F133F63F060C0204FD03572EB4C4056A2133FFFEF60C0710AD035DAEA4C40A05D133FE7EC60C068BF248B37E84C406030BEE96FEC60C0DF19CF3506E84C403AAD6894EAEB60C03F3CCF3512E74C409C16BEE986EA60C0F419CF3586E24C4085B3133F45EA60C0F735248B07E14C402A91133F79EA60C00481CF352AE04C402991133F39EB60C0EB19CF3586DF4C406230BEE98FEB60C040B6D03556DE4C40826CBEE9A4EB60C044877AE0F4DC4C40C827BEE95CEB60C0E4FD79E0C4DC4C40B27DBEE97AEA60C0D5B2CE3562DD4C40EB63BEE9C1E860C060BF248B77DD4C40E863BEE901E860C0AFC5CF3502DD4C40C4E068942CE760C058A3CF35B6DB4C40F3F16894F2E660C0E419CF3506DB4C40CA27BEE9DCE660C0E093D0358ADA4C4020036994B8E660C034D5CE356EDA4C40E863BEE951E660C037B6D035D6DA4C4069BE689490E560C0A45ECF35DEDC4C40826CBEE934E560C0D5B2CE3562DD4C40836CBEE9B4E360C01F4FD035F2DD4C40D5FCBDE93DE360C040B6D03556DE4C406C05BEE990E260C0687479E014E04C40301FBEE959E260C0938D258B3FE04C40525BBEE9EEE160C0BFC5CF3542E04C408E41BEE9B5E160C018E8CF358EE04C40D5FCBDE93DE160C08471D035BEE04C40A05D133FC7E060C0D8FD79E004E04C4067BE689450E060C018E8CF358EDF4C40816CBEE974DF60C08BF7CE357AE14C408E41BEE9F5DE60C0607479E0D4E14C401675BEE9F7DD60C0607479E0D4E14C404E1469943EDD60C0948D258BBFE04C40826CBEE9E4DC60C0D7B2CE3522DE4C40E963BEE9B1DC60C0304FD035F2DA4C40CE6E133F6DDC60C0D1B2CE3522D84C40264ABEE988DC60C0CF2CD03526D64C40C1E068944CDC60C08471D035BED34C40CD6E133F3DDB60C034D5CE356ECD4C402B91133F09DB60C0473CCF3552CB4C404E146994EEDA60C044B6D03516C94C408C41BEE9E5DA60C0F880CF35AAC64C40CD6E133FFDDA60C0D893D0354AC44C40A25D133FF7DA60C0E148258BE7C24C40A05D133FC7DA60C0D793D0354AC24C405F30BEE9AFDA60C088427AE0DCC14C40B4C4133F0BDA60C02CB979E0ACBF4C40321FBEE939DA60C060BF248B37BE4C40B3C4133F6BDB60C0BBC5CF35C2BF4C40D7FCBDE9FDDB60C050A3CF35B6BE4C40D4FCBDE91DDB60C037B6D03516BC4C40F4F16894E2DB60C0B8C5CF3502BB4C40D6FCBDE9FDDC60C0F835248B87BA4C40CF6E133FEDE060C02B4FD035F2BA4C40EA63BEE9D1E160C090F7CE35BABB4C40C4E06894DCE560C070BF248B77C24C40040EBEE943EA60C0A85ECF35DECA4C40040EBEE9A3EE60C0C72CD03526D14C40FC7F133F63F060C098F7CE35FAD24C40D4FCBDE9BDF160C08771D035FED54C40321FBEE909F260C068BF248B77D64C40E963BEE9B1F260C0A45ECF351ED74C40264ABEE918F460C0A87A248B5FDA4C40806CBEE994F860C08371D0353EE14C408D41BEE905FA60C0607479E0D4E14C40CF6E133FCDF960C0D7FD79E084E04C40AF7DBEE97AF960C054877AE034DF4C40331FBEE919F960C04BD2258B17DE4C4094CF6894B6F860C0D5B2CE3562DD4C40030EBEE923F860C0274FD03532DD4C40311FBEE999F760C0707479E054DD4C40D6FCBDE92DF760C0740AD035DADC4C409A16BEE9F6F660C037B6D035D6DA4C401E03699458F760C023B979E0ECD94C407A25699434F760C0F980CF35EAD84C4086B3133FD5F660C0EB19CF35C6D74C409C16BEE986F660C068BF248B77D64C40D6FCBDE96DF860C00CCC7AE0CCD54C40E0D5133F51F960C08871D0357ED44C40F738BEE9D2F960C0770AD0351AD24C40846CBEE984F760C0700AD0355AD34C40555BBEE9BEF660C098F7CE35FAD24C4068BE6894A0F460C02FB6D03516CF4C40806CBEE9E4F360C0E319CF3586CE4C40AE7DBEE95AF360C04C877AE0B4CD4C409F5D133FB7F260C0C82CD035E6CB4C40F3F1689442F260C0740AD0351ACA4C40E3D5133F41F260C0F035248B47C94C406130BEE9DFF360C060A3CF35B6C94C4039AD68949AF460C0F735248B07C94C4058A2133FFFF460C0F880CF35AAC64C409E5D133FB7F360C0757479E014C84C4068BE689410F360C0B4C5CF3542C84C40C4E068947CF260C0670AD0351AC74C4086B3133F25F260C0F019CF35C6C54C40D06E133FDDF160C0F419CF3546C44C40BA52BEE9EBF160C070557BE0FCC24C401875BEE997F260C0D793D0354AC24C401875BEE997F260C00481CF356AC14C402A91133F09F260C0E093D0350AC14C40F2F16894B2F160C0677479E0D4BF4C409B16BEE986F160C067BF248BF7BD4C40B4C4133F7BF160C0E348258BA7BB4C40321FBEE9C9F160C0483CCF3512BA4C405F30BEE97FF260C050A3CF3576B94C40F1F16894E2F360C060BF248B77B94C401975BEE907F360C0730AD035DAB64C40BC52BEE92BF360C00781CF35AAB54C404C1469946EF360C0737479E054B54C40B1C4133FBBF360C06CBF248B37B54C404E146994FEF360C04C877AE0B4B44C403AAD68943AF460C05BA3CF35B6B44C40F838BEE9A2F460C043D2258B17B54C408E41BEE905F560C0E919CF3546B54C40F2F1689432F560C04C877AE0B4B44C408E41BEE925F560C050D2258B97B34C40030EBEE903F560C060BF248BB7B24C4066BE6894D0F460C02404258B0FB24C4056A2133F8FF460C094427AE09CB14C409F5D133FE7F460C0D02CD035A6B14C409B16BEE956F560C07871D0357EB14C4094CF6894B6F560C009E8CF350EB14C40AF7DBEE91AF660C098F7CE35FAAE4C40FC7F133FA3F660C00881CF35EAAE4C403AAD68945AFA60C02CD5CE356EB14C40F4F1689422FB60C094F7CE357AB24C4097CF6894E6FA60C010E8CF350EB54C40F838BEE952FB60C0E048258B67B64C40545BBEE9AEFC60C068BF248BB7B74C409A16BEE9E6FD60C0D0B2CE35E2B94C40545BBEE95EFE60C0995ECF351EBB4C402A91133F69FE60C037B6D03516BC4C40F3F16894C2FE60C0D8B2CE35E2BD4C409D16BEE946FF60C0D0B2CE35A2BF4C408C41BEE9650061C0D793D0354AC24C407005BEE970FF60C040D2258B17C34C40BA52BEE94BFE60C040D2258B17C24C409F5D133F77FC60C050A3CF35B6BE4C40254ABEE9D8FA60C073557BE03CBA4C40CF6E133FEDF960C014E8CF354EB84C40FB7F133FF3F860C068BF248BB7B74C406E05BEE9A0F960C0A87A248B9FBB4C4087B3133FC5FA60C015E8CF358EBE4C40F838BEE9420161C03FD2258BD7C94C40CE6E133F5D0261C077557BE0BCCD4C40040EBEE9F30161C0E719CF3546CE4C409A16BEE9860161C08371D0357ECE4C40D5FCBDE99D0061C0E319CF3586CE4C401875BEE9C70061C064A3CF35F6CC4C401675BEE9970061C0FF35248B07CC4C40EB63BEE9310061C0204FD035B2CB4C40264ABEE9B8FF60C0C82CD035E6CB4C40F938BEE9E2FF60C0B8C5CF35C2CD4C402891133F89FF60C08371D0357ECE4C402A91133F69FE60C0E319CF3586CE4C402A91133F69FE60C08FF7CE357ACF4C407B25699404FF60C08871D035BECF4C40535BBEE92E0061C020B979E0ECD04C40D5FCBDE99D0061C0C72CD03526D14C40CB27BEE99C0161C053A3CF3576D04C40040EBEE9D30161C058A3CF35B6D04C402B91133F190261C02404258BCFD14C40D5FCBDE96D0261C0443CCF35D2D24C40836CBEE9B40261C0BCC5CF3502D34C40F0F16894D20261C0A85ECF359ED14C401775BEE9170361C078557BE0BCCF4C40EA63BEE9B10361C04C3CCF3592CF4C40BB52BEE94B0461C0DC48258BA7D04C40EA63BEE9910461C0FB35248B87D24C404C1469945E0461C00481CF352AD44C40F838BEE9E20361C070557BE0BCD54C406030BEE94F0361C0DD48258BE7D64C40F0F16894D20261C04BD2258B57D74C40F0F16894D20261C0D1B2CE3522D84C40806CBEE9A40661C00136248BC7DF4C40254ABEE9380761C0B57A248B1FE24C406E05BEE9300761C054877AE074E44C406F05BEE9A00761C0D848258B67E54C40806CBEE9540861C03FD2258B57E34C4055A2133FDF0861C08071D0353EE34C40555BBEE95E0961C00036248B87E44C404F146994EE0961C0DBB2CE35A2E64C40C927BEE93C0A61C0E719CF3546E74C404B146994FE0A61C0DFB2CE3562E84C40826CBEE9240B61C0C4C5CF3542E94C408E41BEE9450B61C0F019CF35C6EA4C40274ABEE9980B61C0E893D0358AEB4C40A05D133F070C61C053877AE0B4EB4C402A91133F790C61C0204FD03572EB4C40555BBEE9BE0C61C0D7B2CE3522E94C40C927BEE9FC0C61C0DFB2CE3562E84C40020EBEE9530D61C0284FD035B2E94C40321FBEE9590D61C0D0B2CE35E2EA4C40CD6E133FFD0C61C0BB7A248B5FED4C40F2F16894A20C61C0A85ECF355EF14C4094CF6894760B61C02F4FD035F2F44C40826CBEE9240B61C0D0B2CE35E2F64C40BC52BEE93B0B61C0C0C5CF35C2F74C408C41BEE9B50B61C02C4FD035F2F94C40E863BEE9D10B61C030B6D03556FB4C40264ABEE9A80B61C0C72CD035E6FC4C40CA27BEE94C0B61C0770AD035DAFD4C40826CBEE9E40A61C0F019CF3586FE4C40254ABEE9980A61C097F7CE353AFF4C40B4C4133FFB0961C024B979E06CFF4C4087B3133F150961C0DF48258BA7FD4C40C927BEE92C0561C0C0C5CF3582F34C406030BEE9DF0161C07C0AD035DAEC4C40244ABEE9780161C06CBF248B77EC4C40D5FCBDE90D0161C0C02CD03566EC4C4069BE6894D00161C0DFB2CE3522EF4C40BC52BEE99B0461C02B4FD03532F44C405E30BEE90F0761C087F7CE35FAFB4C40836CBEE9840761C0888D258BFFFC4C4086B3133F050861C07B557BE0BCFD4C4069BE6894800961C0730AD0355A014D403AAD68946A0A61C0FB35248B07054D40BD52BEE91B0D61C097F7CE353A0A4D40264ABEE9C80D61C038D5CE35AE0D4D40F838BEE9920D61C018B979E0AC0F4D401675BEE9F70C61C0B7107BE024114D40B07DBEE92A0C61C06BBF248BF7114D40EA63BEE9610B61C018E8CF350E124D406E05BEE9B00A61C0433CCF3552114D40826CBEE9740961C0C4C5CF35C20E4D4020036994B80861C038D5CE35AE0D4D40F938BEE9020961C0770AD0351A0F4D407D256994640961C0A85ECF351E104D40321FBEE9990961C093F7CE353A114D4069BE6894600961C037D5CE35EE124D40F738BEE9A20A61C054877AE0F4164D403AAD68942A0B61C0B0107BE024194D40EA63BEE9610B61C0B7107BE0241C4D40CA27BEE99C0961C0888D258BBF1B4D40331FBEE9B90861C00436248B471C4D40BD52BEE96B0861C0E3FD79E0C41B4D40D5FCBDE94D0861C02004258B8F194D40321FBEE9290861C0E3B2CE3562184D40CA27BEE98C0761C0C4C5CF3502164D40264ABEE9680761C04B3CCF3552144D4066BE6894300761C0680AD0351A134D40B07DBEE92A0661C0F716268B2F114D40C3E06894DC0561C030D5CE356E0F4D40B4C4133FEB0561C02B04258B0F0F4D408E41BEE9550661C087427AE05C0B4D40F738BEE9320661C040877AE0B40A4D40C927BEE94C0561C044B6D03596084D40CA27BEE93C0361C08871D0357E074D40EA63BEE9B10461C0B97A248B5F0A4D40B07DBEE91A0561C0948D258B7F0B4D408E41BEE9450561C0FFCB7AE00C0D4D40BD52BEE94B0561C07871D0353E0F4D40331FBEE9390561C063A3CF3536114D40B07DBEE91A0561C018E8CF350E124D40C5E068946C0561C00FE8CF35CE124D40311FBEE9A90561C0503CCF3592144D4079256994C40561C0AF7A248B9F164D404D146994AE0561C0988D258B3F184D407B256994440561C00781CF352A194D40B2C4133FAB0461C0D793D035CA194D4068BE6894400461C0D0FD79E0841A4D40545BBEE95E0461C0888D258BBF1B4D40545BBEE95E0461C008CC7AE08C1C4D40B4C4133F4B0361C0A05ECF355E1C4D4086B3133F450261C02B04258B0F1B4D40545BBEE96EFF60C048877AE074154D40020EBEE9E3FE60C07B71D035FE144D4096CF6894A6FE60C00336248B07164D407D256994B4FE60C04C877AE034194D4095CF689496FE60C0BC107BE0241A4D409C16BEE936FE60C0888D258BBF1B4D401875BEE987FD60C0F816268BAF1D4D402003699408FA60C0A05ECF351E234D4056A2133F1FF960C03CB6D03556234D401F03699448F860C0D8B2CE3562224D40E2D5133FE1F660C0D348258B671D4D40010300000001000000080000006C87E17EEB0161C0A478C1C646224D40B4ABF71E950361C0E772E4A417214D40ACBA1BFF660461C0ACDF0273EE214D40D0803E1A990461C028EC40E286244D4038630A696C0361C0B02D171FD6264D40BE416B13710161C0AF58DCBCC7284D40C109D2E0E40061C0D414448EC1254D406C87E17EEB0161C0A478C1C646224D400103000000010000001C000000C927BEE9AC1B63C0C02CD035E62A4D409C16BEE9761B63C08F427AE0DC2A4D40F638BEE9121B63C060A3CF35362B4D40F638BEE9F21A63C0E893D0350A2B4D40C927BEE9EC1A63C0E0FD79E0C42A4D4020036994F81A63C0A87A248B9F2A4D40D2B568940D1B63C027D5CE35AE2A4D40244ABEE9F81A63C0473CCF35922A4D40311FBEE9791A63C074BF248B372A4D40501469945E1A63C040B6D035D6294D401675BEE9371A63C0780AD0351A294D40E61C6994F11963C07F71D0357E284D4022036994981963C0DF19CF3586284D407C256994741963C053A3CF35F6274D40AE7DBEE93A1963C0DBB2CE3522264D402DD86894091963C02F4FD035F2244D409C16BEE9661963C0E793D035CA244D400655133F741963C0697479E0D4244D40B4C4133FAB1963C05FA3CF35F6244D4096CF6894F61963C00881CF352A254D40D5FCBDE92D1B63C03F3CCF3592264D40F638BEE9E21C63C0E0B2CE3562274D40244ABEE9681D63C0A45ECF355E284D40A3A46894C71D63C018E8CF350E2A4D409A16BEE9961D63C010E8CF354E2B4D406030BEE9FF1C63C0FFCB7AE0CC2B4D40A3A46894771C63C034D5CE35AE2B4D40C927BEE9AC1B63C0C02CD035E62A4D4001030000000100000014000000FD7F133F33CC60C07C557BE0BC224D4065BE6894F0C860C07871D0353E1C4D40806CBEE944C860C0BB7A248B1F194D40CA27BEE90CCF60C0E048258BE71C4D407E25699464D060C008CC7AE08C1C4D40EA63BEE921D160C00817268BAF1C4D4058A2133F7FD260C0E893D0350A1E4D40CB27BEE91CD360C0A05ECF355E1E4D40AE7DBEE9DAD360C0DC93D0358A1F4D40FA7F133FD3D460C0D0FD79E044224D402991133F99D560C0690AD0355A254D40E3D5133FC1D560C030B6D03596274D408E41BEE935D560C00081CF35EA284D405E30BEE9DFD360C0AF7A248B5F294D40806CBEE954D360C063A3CF35362A4D40F838BEE9B2D260C0C4107BE0A42B4D409B16BEE906D260C0680AD0351A2C4D40B2C4133F6BCF60C0F816268BAF2A4D401875BEE947CE60C044B6D03556284D40FD7F133F33CC60C07C557BE0BC224D40010300000001000000080000007CD0101463F160C0AFED63C8DB2A4D4031892B7BF3F260C0A84EDBC1F3294D40CA7728BE75F560C097CC77EB5A2A4D40EFB4D8FAFDF660C0E4B578764E2C4D40681FD9F9DAF660C0D8914BD26B2F4D40FE7BE0F8F4F460C097A48A339D304D40438DE36934F260C00182B866C32F4D407CD0101463F160C0AFED63C8DB2A4D400103000000010000008B0100002003699458DD60C02804258BCF2F4D40C927BEE9ECDC60C004CC7AE08C2F4D40BD52BEE96BDC60C03FB6D035962F4D40D7FCBDE9FDDB60C013E8CF350E2F4D4056A2133F6FDB60C00717268B6F2D4D40E2D5133FA1DA60C00CE8CF350E2C4D409D16BEE9E6D960C0443CCF35522A4D4093CF689496D960C030B6D03596274D402B91133F79D960C08BF7CE353A264D407D25699434D960C0C3107BE064254D40EB63BEE9E1D860C0E719CF35C6244D40B07DBEE99AD860C013E8CF350E244D40555BBEE99ED760C0403CCF35521F4D40F2F1689442D760C0680AD0351A1E4D40C3E06894FCD660C0D348258B671D4D40FA38BEE9C2D660C018E8CF358E1C4D40A15D133F87D660C0B37A248BDF1A4D409D16BEE946D660C0EB19CF3546164D404E1469942ED660C007E8CF358E154D4084B3133F55D360C0B9107BE0E4154D4096CF6894F6D160C0A75ECF35DE164D40D6FCBDE9CDD160C0B07A248B1F174D40040EBEE9A3D160C0DCFD79E044174D40D6FCBDE92DCF60C007CC7AE04C174D403AAD68943ACE60C040877AE0B4164D406E05BEE980CC60C0DCB2CE35E2134D4066BE689490CB60C037D5CE35EE124D40C3E068949CCA60C05DA3CF35F6124D409C16BEE9F6C560C007E8CF358E154D40321FBEE9A9C560C037D5CE35EE144D401E03699458C560C05CA3CF3576134D407F6CBEE924C560C094F7CE35BA114D4067BE689430C560C013E8CF354E104D4067BE689470C560C004CC7AE0CC0F4D402A91133FC9C560C03FB6D035D60F4D4086B3133F85C660C013E8CF354E104D40244ABEE918C660C007E8CF35CE0E4D4068BE6894A0C560C038D5CE35AE0D4D40B4C4133F6BC560C054877AE0F4094D40FC7F133FE3C260C040B6D03556034D40040EBEE9C3C260C04B877AE0B4FF4C4068BE6894F0C060C0B87A248B5FFB4C40F838BEE912C060C068557BE03CF84C402103699458BF60C097427AE05CF04C401F03699478BE60C0E4B2CE3522EC4C40826CBEE964BD60C01BE8CF358EE84C40D6FCBDE96DBC60C02C4FD03532E64C40E2D5133F91BC60C014E8CF350EE54C40030EBEE9A3BC60C0E119CF35C6E34C401F036994A8BC60C037D5CE356EE24C406F05BEE9A0BC60C0F735248B07E14C4097CF689486BC60C018E8CF358EDF4C406030BEE93FBC60C00017268B6FDD4C406E05BEE930BC60C0CC2CD03526DC4C40E863BEE921BC60C098F7CE35BAD84C40C4E06894ECBB60C0908D258B3FD64C4085B3133F85BB60C091F7CE353AD44C40301FBEE9B9B960C0607479E014CE4C40E863BEE941B960C0B87A248B5FCB4C4069BE6894B0B960C0CF2CD03526CA4C406030BEE96FBA60C0888D258BFFCA4C40F838BEE9F2BA60C0403CCF3512CD4C409C16BEE966BB60C00881CF35AACF4C402A91133FF9BB60C0770AD0351AD24C4067BE6894D0BE60C0A05ECF359ED84C40B4C4133FEBBE60C00FE8CF350EDA4C40E863BEE961BF60C0403CCF3592DB4C40CC6E133F7DBF60C070557BE0FCDC4C40264ABEE988BF60C097F7CE357ADE4C409B16BEE9A6BF60C050A3CF3576DF4C40CA27BEE9CCBF60C028B979E06CE04C40EA63BEE9F1BF60C0607479E0D4E14C409C16BEE956C060C08771D0353EE74C40F638BEE9C2C060C0DF19CF3506E94C40020EBEE933C260C0204FD03572EA4C40E2D5133FD1C260C0EF19CF3546EC4C407D25699454C360C01704258B8FEE4C40264ABEE9A8C360C030D5CE35AEF04C40E863BEE931C460C04FA3CF35F6F74C402003699488C460C05BA3CF3576FA4C402A91133F19C560C0888D258BFFFC4C40050EBEE9D3C560C00381CF356AFF4C40826CBEE964C760C0284FD03532034D40826CBEE964C760C08C71D035FE034D40F638BEE9C2C660C0FF16268B6F034D40B4C4133F1BC660C01CE8CF350E024D401E036994F8C460C09D8D258BBFFE4C4098CF689486C560C0C4C5CF35C2014D40FA7F133F63C660C063A3CF3536054D40CA27BEE95CC760C008E8CF350E084D40E963BEE941C860C070557BE03C094D40826CBEE9B4C860C0A85ECF355E094D406030BEE9FFC860C0EC19CF35C6094D40244ABEE938C960C093F7CE357A0A4D408C41BEE975C960C0948D258B7F0B4D406C05BEE9D0C960C011E8CF358E0C4D40C5E06894ECC960C050877AE0F40B4D403AAD6894DAC960C0473CCF35D20A4D40CE6E133FADC960C0FF16268B2F0A4D4068BE689440C960C048877AE074094D4021036994D8C860C0E0B2CE35A2074D40CE6E133F8DC860C0700AD0355A054D40A05D133F77C860C0284FD03532034D404E1469944EC960C06C0AD0359A044D40BC52BEE9BBC960C0BCC5CF3502054D409C16BEE936CA60C0204FD035F2044D409C16BEE936CA60C08C71D035FE034D4058A2133F5FC860C0DB48258B27014D404E1469949EC760C0607479E014FF4C40C827BEE92CC760C0B37A248B1FFC4C404C146994CEC760C0FF80CF352AFC4C40535BBEE96EC860C0F780CF35EAFC4C407D25699494C960C097F7CE353AFF4C40EA63BEE921CA60C0403CCF3592FF4C40D6FCBDE9FDC960C0A85ECF355EFD4C40C4E068945CC960C087427AE01CF94C40545BBEE93EC960C0888D258BBFF74C4087B3133FC5C860C074557BE0FCF34C407E256994B4C860C0B3107BE0A4F14C40040EBEE9E3C860C0770AD0355AEF4C402A91133F29C960C0543CCF3512ED4C406F05BEE940C960C04BD2258B17EB4C409E5D133FE7C860C0284FD035B2E94C40501469940EC860C0F816268BAFED4C40D5FCBDE9ADC660C0BBC5CF3582EB4C40F738BEE9D2C160C0443CCF3512D94C40EA63BEE981C160C068BF248B77D74C406E05BEE9B0C160C0E0B2CE3522D64C40E2D5133F91C260C090F7CE35BAD44C40264ABEE918C260C074557BE03CD34C40B4C4133F5BC060C0F716268BAFD34C40254ABEE998BF60C0FB35248B87D24C40D5FCBDE9FDBE60C0908D258BFFD04C40EB63BEE971BE60C0A45ECF355ED04C40F938BEE902BE60C028B979E02CCF4C40D6FCBDE9BDBD60C0C82CD035E6CB4C40D6FCBDE9BDBD60C0670AD0351AC74C40F97F133FA3BD60C0FC16268BAFC54C409E5D133FC7BC60C0677479E0D4C04C408E41BEE955BB60C038D5CE35EEBC4C40E2D5133FE1BA60C06FBF248B37BB4C40B07DBEE98ABB60C00C81CF356ABA4C40274ABEE9E8BB60C0D5FD79E0C4BB4C40C3E068942CBC60C064BF248BB7BD4C401875BEE987BC60C050A3CF35B6BE4C407D256994D4BC60C018E8CF35CEBE4C40826CBEE904BD60C0334FD035F2BE4C408C41BEE935BD60C093F7CE35FABE4C408E41BEE985BD60C050A3CF35B6BE4C406E05BEE960BD60C01F4FD03532BE4C40E2D5133F61BD60C0CB2CD035E6BC4C401E03699488BD60C05CA3CF35F6BB4C409B16BEE9D6BD60C0E719CF3586BC4C40B17DBEE9DABE60C064BF248BB7BD4C4096CF689446C160C0C72CD03566BF4C40B07DBEE9CAC160C0DFFD79E004C04C407E25699454C260C00481CF356AC14C40E2D5133F71C260C0403CCF3512C14C40040EBEE9C3C260C02CB979E0ACBF4C407C25699424C260C057A3CF3576BE4C406030BEE9CFC160C0E5FD79E004BE4C407E25699474C160C031B6D035D6BD4C407E25699474C160C058A3CF35F6BC4C40244ABEE938C360C058A3CF35F6BC4C40545BBEE91EC260C018E8CF350EBB4C4086B3133F65C060C0F716268BAFBA4C40040EBEE943BF60C09B8D258B7FB94C40EA63BEE9F1BF60C038D5CE352EB54C40254ABEE958BF60C0D32CD035E6B44C40525BBEE91EBE60C0E048258B67B64C40C4E068946CBD60C0730AD035DAB64C40FA7F133F43BD60C038D5CE352EB74C40B952BEE9EBBC60C0284FD035B2B74C4086B3133F95BC60C02BD5CE35AEB74C40D6FCBDE96DBC60C0FF80CF356AB64C404D1469945EBC60C040D2258B17B64C404C1469941EBC60C0E5B2CE35E2B34C40826CBEE914BC60C06C0AD0355AB34C40B5C4133FDBBB60C0BCC5CF3542B24C40331FBEE9A9BB60C09C427AE0DCAF4C40D7FCBDE9ADBB60C03F877AE074AD4C40826CBEE914BC60C090427AE05CAC4C40B07DBEE9DABC60C0204FD035F2AB4C40C5E068944CBD60C0730AD035DAAA4C40545BBEE90EBE60C0BFC5CF3582A74C4020036994A8BE60C0AC7A248BDFA64C405D30BEE96FBF60C074557BE07CA74C40C4E06894ACC160C08071D0357EAB4C40B07DBEE9EAC160C0D1B2CE3562AC4C4084B3133F05C260C0E0FD79E044AD4C40C4E068942CC260C017B979E0ACAD4C40E2D5133F91C260C0D748258B27AD4C4097CF689486C260C0A15ECF355EAC4C4098CF689466C260C030D5CE35EEAA4C401975BEE977C260C077557BE0BCA94C40E3D5133F01C360C00781CF35AAA94C406130BEE92FC360C00881CF352AAA4C40AE7DBEE94AC360C0A85ECF351EAC4C406D05BEE970C360C0D748258B27AD4C40FB7F133FD3C360C0988D258B7FAE4C406E05BEE960C460C0D893D0350AB04C40F1F1689402C560C07F71D0353EB14C4068BE6894A0C560C094427AE09CB14C40CF6E133F8DC460C0503CCF35D2AC4C401875BEE937C460C0DFB2CE35E2A94C408D41BEE9C5C460C00381CF35EAA74C40D8FCBDE98DC460C093F7CE35FAA64C406E05BEE950C460C00B81CF352AA64C406E05BEE9C0C360C01F4FD03532A74C40545BBEE93EC360C027D5CE356EA64C407E25699454C260C0D793D0358AA34C4096CF6894B6C260C0443CCF35D2A04C40555BBEE92EC360C00036248BC7A04C40321FBEE9A9C360C060A3CF35B6A14C40040EBEE913C460C0BC7A248BDFA14C40F0F1689452C460C0BCC5CF3582A04C4086B3133FB5C460C0B7C5CF35C29B4C401E036994F8C460C0780AD035DA994C40B5C4133F5BC560C0E4FD79E084984C40FD7F133FD3C560C088F7CE357A974C40CB27BEE95CC660C0908D258BBF964C40806CBEE9F4C660C07C0AD0355A964C4056A2133F3FC760C0747479E094964C40CB6E133F8DC760C093427AE01C974C40BA52BEE9DBC760C0A85ECF355E974C401F03699428C860C0E093D035CA964C40D5FCBDE95DC860C0C4107BE024964C407F25699424C960C087427AE09C944C407F256994A4C860C0FC80CF352A924C40C827BEE91CC960C0CF2CD03566914C40C927BEE9ECC960C094427AE05C914C40040EBEE973CA60C098427AE01C914C403AAD68945ACA60C0AC5ECF359E904C409C16BEE936CA60C0985ECF355E8F4C40B2C4133F9BCA60C05FA3CF35768F4C40244ABEE9E8CA60C0DC93D035CA8F4C4066BE689490CB60C098427AE01C914C403BAD6894AACB60C08771D035BE8F4C4096CF6894D6CB60C098F7CE35BA8E4C4096CF689416CC60C0EF19CF35068E4C40B2C4133F6BCC60C0A05ECF359E8D4C404D1469942ECC60C028D5CE35EE8C4C40321FBEE9E9CB60C0D848258B678C4C4068BE6894A0CB60C0D793D0350A8C4C40020EBEE953CB60C0A85ECF35DE8B4C40020EBEE953CB60C0503CCF35128B4C406C05BEE9F0CC60C0304FD035B2884C40545BBEE9FECD60C004CC7AE0CC874C40545BBEE9FECE60C0B0C5CF3502854C407E25699484CF60C08F8D258BFF834C40545BBEE90ED060C04C877AE0B4834C40CD6E133FCDD160C08F8D258BFF834C40FC7F133F63D260C08BF7CE35BA834C40B07DBEE9AAD360C018E8CF354E814C4095CF689426D360C040B6D03556864C409E16BEE926D360C04C877AE0F4884C40545BBEE9EED360C0FF16268B2F8E4C40C3E068949CD360C0F835248B47904C40F738BEE902D360C02C04258B0F924C404E1469948ED260C02304258BCF934C40244ABEE9A8D360C00C17268B6F964C4056A2133FFFD360C00081CF35AA974C408E41BEE935D460C02404258B0F994C4096CF689456D460C094F7CE35FA9A4C40040EBEE943D460C02C4FD035B29C4C40FC7F133FE3D360C02FD5CE356E9D4C401D036994D8D160C07C0AD0359A9B4C40E0D5133FD1D060C0AC5ECF359E9B4C409D16BEE926D060C0F7CB7AE04C9E4C4085B3133F45D160C057A3CF35B69E4C4067BE6894D0D160C0503CCF35529F4C40CB6E133F3DD260C07C557BE07CA04C40FC7F133F93D260C0BC7A248BDFA14C402A91133FA9D260C098F7CE357AA24C40040EBEE923D260C00881CF356AA44C40816CBEE964D160C0E493D0358AA64C40A15D133F87D060C03F3CCF3592A74C406030BEE99FCE60C00381CF35EAA74C40A15D133FD7CE60C0D32CD035E6A84C401675BEE9A7CF60C0B0C5CF3502AB4C4059A2133FEFCF60C08071D0357EAB4C40836CBEE9F4D060C08071D0357EAB4C402A91133F79D160C040B6D035D6AB4C4094CF6894E6D160C0D748258B27AD4C40264ABEE9B8D160C06BBF248B77AE4C40CA27BEE9ECD160C02CD5CE356EB14C40CD6E133FCDD160C0F880CF35EAB24C40264ABEE958D160C0CFB2CE35A2B34C4087B3133FB5D060C0700AD0359AB34C40F97F133F43D060C00117268BAFB24C407E25699464D060C06F557BE0BCB04C4067BE6894E0CC60C088427AE01CAE4C40545BBEE9EECA60C01FB979E0ECAA4C40020EBEE903CA60C0EC93D0358AAA4C408E41BEE945CA60C0B8107BE024AC4C40BA52BEE9BBCA60C03FB6D03556AD4C40FB7F133FC3CB60C078557BE0FCAE4C40FB7F133FC3CB60C09C427AE0DCAF4C40555BBEE93ECB60C0F735248B07B04C4097CF6894B6CA60C08771D0357EB04C4098CF689436CA60C0EC93D0354AB14C40BD52BEE9CBC960C094F7CE357AB24C402891133FE9CA60C0483CCF35D2B24C40E2D5133F81CD60C02C04258B4FB14C401A75BEE9D7CE60C094F7CE357AB24C4068BE689420CF60C0E793D0354AB34C4059A2133FEFCF60C0730AD035DAB64C40030EBEE913D160C038B6D03596BA4C40F738BEE922D160C06FBF248B37BB4C4067BE689490D160C00881CF35EABB4C40E863BEE901D260C0274FD03572BD4C4096CF689436D260C093F7CE35FABE4C40BC52BEE9EBD160C02CB979E0ACBF4C40F1F16894A2D160C0E0FD79E084BF4C40B07DBEE90AD160C097427AE0DCBE4C40F838BEE9B2D060C050A3CF35B6BE4C4086B3133F65D060C07771D035FEBE4C40545BBEE9DECF60C00017268B2FC04C40836CBEE924CF60C0985ECF35DEC04C40F2F1689422CE60C037D5CE35AEC24C40E863BEE9F1CC60C0DFB2CE3562C34C40020EBEE953CB60C054877AE0B4C54C402103699418CC60C00036248BC7C64C40545BBEE99ECF60C00817268B2FC44C406E05BEE950D160C00481CF356AC14C40040EBEE923D260C00481CF356AC14C40CE6E133F8DD260C0304FD035F2C24C401F03699458D360C0D42CD03526C84C409C16BEE9C6D360C0F035248B47C94C4068BE689470D460C071557BE03CCA4C40321FBEE9E9D460C0433CCF3592CC4C40B4C4133F3BD560C05FA3CF3576CF4C403AAD68946AD560C0770AD0351AD24C404E1469948ED560C0503CCF3512D64C409F5D133FA7D560C04BD2258B57D74C409D16BEE966D660C074557BE07CDA4C40A15D133F87D660C0E719CF3546DB4C40311FBEE9E9D660C050A3CF3576DF4C40264ABEE9D8D660C0687479E014E04C4022036994A8D660C0948D258BBFE04C40C4E068947CD660C01CE8CF354EE24C403AAD68944AD660C0D848258B67E54C40CE6E133F5DD660C0908D258BFFE74C40311FBEE9D9D660C00CE8CF358EED4C407F25699414D760C088427AE0DCF24C40331FBEE909D860C05BA3CF3576FA4C40040EBEE963D860C00717268B6FFC4C40E863BEE961D860C0334FD03572FD4C40331FBEE909D860C09D8D258BBFFE4C401875BEE987D860C08771D035BE004D40CF6E133F1DD960C0E019CF3586024D40331FBEE999D960C0BBC5CF3582044D404D146994CED960C049D2258B17074D40826CBEE984D960C00117268B2F094D40020EBEE933D860C0AC5ECF351E0C4D409E16BEE9D6D760C070557BE07C0E4D40E963BEE9E1D760C0FF80CF35EA0F4D40274ABEE908D860C0CF48258B67114D40F2F1689432D860C008CC7AE08C124D409C16BEE946D860C037D5CE35EE124D40264ABEE918D860C044B6D03596144D40CB27BEE9CCD760C0CC2CD03566154D4095CF689486D760C058A3CF35F6154D409C16BEE966D760C0C82CD035E6164D404C1469948ED760C0C02CD03526184D4020036994E8D760C0975ECF35DE174D40B07DBEE99AD860C0C0C5CF3582164D40C2E06894CCD860C018B979E0EC154D40AE7DBEE9CAD860C0E5FD79E084144D4021036994B8D860C000CC7AE0CC124D409C16BEE9B6D860C0C0C5CF3542114D40040EBEE913D960C0BC107BE0240E4D401675BEE987D960C00417268B6F0E4D4058A2133F8FDA60C0D048258B67134D40B5C4133FFBDA60C004CC7AE00C164D40816CBEE934DB60C054877AE0F4164D408D41BEE9F5DB60C02BB979E0AC174D409E16BEE986DC60C03FB6D03596184D40B4C4133F0BDD60C0B7C5CF35C2194D40CC6E133F4DDD60C0B37A248BDF1A4D40D3FCBDE90DDD60C0EC19CF35861D4D401775BEE977DC60C00C17268B6F1F4D4096CF689446DC60C0740AD0359A204D40030EBEE933DD60C08871D035FE204D40EA63BEE9D1DD60C08071D035BE214D40C5E068943CDE60C00C81CF35AA234D40D5FCBDE97DDE60C04B877AE034264D40FC7F133F03DF60C07771D0357E2E4D40565BBEE90EDF60C0670AD0355A314D4068BE6894C0DE60C04F3CCF35D2334D4068BE689460DE60C00181CF356A344D40264ABEE9F8DD60C0BF107BE0E4334D409C16BEE9A6DD60C00B17268BAF324D4085B3133F85DD60C08871D0353E314D402003699458DD60C02804258BCF2F4D40010300000001000000EE000000AF7DBEE96A1363C063A3CF35F63B4D405CE968944F1363C00981CF356A3A4D40CA27BEE99C1263C09CF7CE35BA3B4D4096CF6894C61163C0C82CD035E63B4D404E146994FE0F63C0EC93D0354A3B4D40F2F16894321063C0E719CF3586394D405AE96894AF1063C0700AD035DA364D40D5FCBDE9DD1063C04CD2258B17354D40C827BEE9CC0F63C08F8D258BFF344D40F838BEE9520F63C07F71D0357E344D4096CF6894E60E63C054D2258B57334D409A16BEE9660F63C0E893D035CA314D40F2F16894820F63C009CC7AE0CC2F4D40F2F16894420F63C0D0FD79E0442E4D40525BBEE9AE0E63C0730AD0351A2E4D40545BBEE95E0E63C0770AD035DA2E4D40311FBEE9390E63C050A3CF35B62F4D402ED86894090E63C05FBF248B37304D409A16BEE9960D63C04CD2258BD72F4D409C16BEE9460D63C02704258B4F2F4D403AAD6894FA0C63C07771D0357E2E4D40321FBEE9D90C63C0A85ECF355E2D4D40D6FCBDE96D0D63C040B6D03556294D406D05BEE9C00C63C09C5ECF351E2A4D406E05BEE9000C63C0E448258B272C4D40264ABEE9280C63C01BE8CF354E2D4D4000C76894F30B63C0EC93D0354A2E4D40030EBEE9A30B63C02304258B8F304D40040EBEE9730B63C0CB2CD03526334D406030BEE99F0B63C04CD2258B17354D40D6FCBDE92D0B63C0E148258BE7354D402ED86894590A63C0D0FD79E004354D40321FBEE9F90963C0493CCF3592354D406030BEE98F0963C0473CCF3592364D403AAD68942A0963C09B8D258B7F364D4000C76894530863C04CD2258B17354D40C6E068946C0863C040D2258B97344D409C16BEE9760863C0284FD03532344D40D7FCBDE97D0863C008E8CF35CE334D40B60B69948B0863C054D2258B57334D404F146994DE0763C00FE8CF358E324D4098CF6894560863C0E893D035CA314D40B60B69948B0863C039D5CE35AE314D40A4A46894370863C09F5ECF359E2F4D40D6FCBDE98D0763C043B6D035162E4D401775BEE9C70663C08F8D258B3F2D4D40525BBEE91E0663C01BE8CF354E2D4D403CAD6894DA0463C0D42CD03566314D406C05BEE9800463C038D5CE352E324D40CA27BEE9BC0363C054D2258B57334D40EC63BEE9710363C0985ECF35DE314D4068BE6894F00263C097F7CE35BA304D402ED86894A90263C02804258BCF2F4D40AE7DBEE90A0363C013E8CF350E2F4D40AE7DBEE95A0463C0F835248BC7264D40525BBEE9EE0463C088F7CE357A214D401975BEE9970463C03CD5CE35EE1D4D40264ABEE9380463C05CA3CF35761E4D404E146994DE0363C02F4FD035B2204D40AE7DBEE99A0363C0E0FD79E084234D406230BEE97F0363C0FCCB7AE0CC254D40F4F16894320363C01FB979E0EC274D4088FA6894950263C0D0FD79E084284D402CD86894190263C058A3CF3536274D4069BE6894300263C09F5ECF359E234D409B16BEE9A60163C0C0C5CF3502254D4068BE6894000163C0C3C5CF3542274D40030EBEE9730063C0EF19CF35C6294D40234ABEE9380063C00781CF35EA2B4D4096CF6894060063C0D893D0350A2D4D408B41BEE995FF62C048D2258B972C4D40F738BEE922FF62C078557BE07C2B4D402ED86894E9FE62C0670AD0359A2A4D4022036994E8FE62C018E8CF350E294D40040EBEE913FF62C00781CF35AA274D40BD52BEE98BFF62C088427AE05C254D4068BE689400FF62C0985ECF355E244D40FEC6689463FF62C0B7C5CF3582204D40C4E068941CFF62C0A05ECF355E1E4D409A16BEE9C6FF62C04F3CCF35D21C4D406C05BEE9000163C044B6D035D61A4D4020036994880163C0BB7A248B1F194D40E41C6994810163C0C0C5CF3502194D40C6E068948C0163C0D7FD79E044184D40F838BEE9A20163C007CC7AE04C174D406C05BEE9C00163C0C0C5CF3582164D409A16BEE9D60163C050A3CF3536164D40CA27BEE9BC0363C037D5CE35EE124D40244ABEE9280463C0D0FD79E044154D40254ABEE9480663C017E8CF35CE174D40040EBEE9030763C0908D258BFF194D40EA63BEE9710763C037B6D035961F4D4067BE6894E00763C03CB6D03556224D4000C76894530863C08871D035FE204D40BC52BEE99B0863C06F557BE0BC214D402FD86894D90863C04C3CCF35D2214D40B90B69940B0963C0B0C5CF3542214D4000C76894330963C0985ECF351E204D40D2B56894BD0963C068BF248BF7204D4069BE6894200A63C0AF107BE0E41F4D40F3F16894620A63C040B6D035D61D4D401875BEE9870A63C0888D258BBF1B4D40244ABEE9E80963C0AFC5CF35821B4D40525BBEE97E0963C0B1C5CF35821A4D40D0B568946D0963C0B8C5CF3542194D40B60B6994DB0963C0988D258B3F184D406C05BEE9600A63C033D5CE356E184D40F1F16894520B63C0F735248B471A4D40A3A46894D70B63C0908D258BFF194D407F6CBEE9A40B63C0B7C5CF35C2184D4098CF6894560B63C02B4FD03532184D407E256994F40A63C0700AD0351A184D401875BEE9870A63C0988D258B3F184D40AE7DBEE9BA0A63C0E048258B27164D4022036994980A63C0B47A248B1F154D40B60B6994DB0963C0DCB2CE35E2134D403AAD68940A0963C0BFC5CF35C2114D40FEC66894C30863C0C0C5CF3542114D40D4FCBDE92D0963C094F7CE35BA104D40A3A46894E70963C013E8CF354E114D40030EBEE9330A63C0FF35248BC7104D40AF7DBEE9CA0A63C0CB2CD035260E4D401975BEE9F70A63C038D5CE35AE0D4D40CA27BEE92C0B63C00CCC7AE00C0E4D4022036994880B63C0CFB2CE35E20F4D40806CBEE9D40B63C013E8CF354E104D405D30BEE9BF0C63C08C71D035FE0F4D407C256994240D63C03BB6D03516104D407E256994940D63C0FF35248BC7104D406130BEE98F0E63C0687479E094114D40254ABEE9A80F63C03BD5CE356E104D408AFA6894B51063C0F035248B070E4D40AE7DBEE98A1163C02404258B0F0B4D40C4E06894DC1163C038B6D035D60C4D40D7FCBDE9FD1163C06F7479E0540E4D40FFC66894031263C0E4B2CE35E2164D40F638BEE9F21163C0AD5ECF351E194D40F738BEE9C21163C0B37A248BDF1A4D40040EBEE9731263C050877AE0741A4D40F838BEE9D21263C0B8C5CF3542194D40D6FCBDE9FD1263C03CB6D03556174D401875BEE9271363C0E793D0358A124D40C827BEE94C1363C097F7CE35FA104D407E256994941363C020B979E06C0F4D406E05BEE9101463C08871D0353E0D4D40C4E068943C1463C0BB7A248B1F0C4D4097CF6894461463C0204FD035320B4D402DD86894591463C0FC35248B470A4D40545BBEE99E1463C070557BE03C094D40AE7DBEE9EA1463C0CD2CD035E6084D40525BBEE9BE1563C0F8CB7AE08C084D4020036994A81663C00481CF35AA064D409A16BEE9761763C0607479E0D4064D406130BEE92F1863C094427AE01C084D40D4FCBDE98D1863C0FF16268B2F0A4D40C827BEE9CC1863C0750AD0351A084D40E51C6994811863C020B979E0EC024D40E61C6994E11863C07C0AD0351A004D40EA63BEE9C11963C0F780CF35EAFE4C4020036994A81D63C0E048258BE7014D408AFA6894752063C03F3CCF35D2054D40D1B568942D2163C0F8CB7AE08C074D40D2B56894DD2163C02304258B0F0A4D405BE968941F2263C033D5CE356E0C4D40CA27BEE98C2163C038D5CE35AE0D4D40244ABEE9982263C058A3CF35360E4D40525BBEE90E2463C0E1B2CE35E20D4D40BB52BEE95B2563C088F7CE353A0E4D40BC52BEE9EB2563C0FF35248BC7104D40254ABEE9582763C0A45ECF359E154D4021036994582763C09C5ECF355E174D401875BEE9072663C0B7107BE0241C4D40D1B568942D2563C0780AD0351A1C4D408BFA6894E52063C0BB7A248B1F194D4068BE6894C02063C0607479E094184D407D256994742063C0A75ECF35DE164D409A16BEE9562063C0C0C5CF3582164D40FFC66894132063C0E793D035CA164D40FFC66894032063C0D748258B67174D402DD86894F91F63C0E1FD79E004184D4020036994C81F63C0988D258B3F184D4020036994181F63C01F4FD035B2174D40A4A46894B71D63C0EC93D035CA154D4096CF6894F61C63C007E8CF358E154D4096CF6894F61C63C0C0C5CF3582164D4022036994382063C01704258B4F1B4D40331FBEE9692063C0FF16268B6F1C4D40D0B56894DD2063C00B81CF356A1D4D406C05BEE9602163C087427AE01C1E4D408E41BEE9452263C074557BE0BC1E4D40264ABEE9B82263C08FF7CE35BA1F4D407C256994842363C07C557BE0BC224D407D256994E42163C0978D258B3F264D4089FA6894552163C097427AE01C274D405CE968949F2063C06F7479E054274D403CAD6894AA1F63C090F7CE35FA264D405BE96894BF1E63C0C02CD03526264D40806CBEE9241E63C034D5CE35EE244D406130BEE9DF1C63C0473CCF35D2234D409C16BEE9161B63C0680AD035DA244D40EFAA133FB21963C034D5CE35EE244D40FFC66894731963C0D8FD79E0C4244D40F2F16894621963C05CA3CF35B6244D40D4FCBDE98D1863C08871D035FE204D40525BBEE90E1863C0C82CD035E6224D40C827BEE91C1863C0FF35248B87244D40FEC66894631863C0D8FD79E044264D40D4FCBDE98D1863C04FA3CF3576284D40C4E068949C1863C09B8D258B7F2A4D40B90B6994CB1863C0C4107BE0242B4D40E963BEE9211963C00481CF35AA2B4D4089FA6894A51963C01BE8CF354E2D4D40B80B69944B1963C0304FD035322D4D40040EBEE9F31863C08071D0353E2D4D40EA63BEE9A11863C0F419CF35862D4D408C41BEE9551863C0730AD0351A2E4D405AE968941F1963C074BF248B772F4D40E51C6994C11B63C090F7CE357A324D407E256994441C63C0F8CB7AE04C344D407C256994941B63C0B0C5CF3502354D401875BEE9271A63C0D3B2CE35E2344D4069BE6894C01863C060BF248B77354D40D6FCBDE91D1863C0F019CF3546384D40CA27BEE9EC1763C00CCC7AE0CC394D40545BBEE97E1763C0A35ECF351E3A4D40C4E068940C1763C030B6D035D6394D404F146994CE1663C0D793D0358A394D408D41BEE9751663C0737479E094384D40EB63BEE9511663C0A87A248B9F374D40C727BEE92C1663C01F04258B4F374D406030BEE9CF1563C0F019CF3546384D40F4F16894921563C051877AE0B4394D4088FA6894751563C06B7479E0543B4D408E41BEE9451563C03BB6D035D63C4D40EA63BEE9D11463C0E448258BE73D4D406C05BEE9401463C00036248B073E4D40E963BEE9C11363C0FC35248B473D4D40AF7DBEE96A1363C063A3CF35F63B4D400103000000010000000A00000096CF6894D6FE63C04C3CCF35924C4D40B4C4133F5BFF63C06CEE7AE0984B4D4096CF6894C6FF63C0C0E1248B834D4D40E51C6994F1FF63C0C0107BE0644E4D400755133FD4FF63C04F3CCF35524F4D405E30BEE9BFFF63C07871D035BE4E4D406477133F60FF63C02FD5CE356E4E4D40CC6E133FBDFE63C059A3CF35364D4D40D2B56894ADFE63C0E7AF258BCB4C4D4096CF6894D6FE63C04C3CCF35924C4D400103000000010000001F000000806CBEE9740F63C0BFC5CF35823D4D4068BE6894101063C06F0AD0359A3C4D4022036994D81063C0878D258BFF3C4D40D6FCBDE92D1463C0B0C5CF3502414D40545BBEE99E1463C090427AE05C424D40050EBEE9731463C054877AE0B4434D4001C76894931463C0F019CF35C6444D406C05BEE9E01463C0D793D0358A454D40EA63BEE9411563C00917268BEF454D4068BE6894F01263C0503CCF3512474D40D1B568949D1263C0878D258BFF474D40F838BEE9521263C0D8FD79E0444A4D40FFC66894A31163C030B6D035964B4D40B60B69943B1063C054D2258BD74C4D407E256994E40F63C00317268B6F4D4D40525BBEE91E0F63C060BF248B774F4D407C256994840E63C0D048258B67504D4020036994E80D63C02BB979E06C504D40A4A46894270D63C040B6D035D6504D402ED86894790C63C0F835248B87514D4000C76894D30B63C024B979E0AC514D40AF7DBEE92A0B63C02BB979E06C504D40311FBEE9390B63C00C81CF356A4F4D40816CBEE9340B63C07C557BE07C4E4D40501469941E0B63C0D7B2CE35A24D4D401975BEE9F70A63C054D2258BD74C4D40341FBEE9D90B63C0CFB2CE35A2494D40535BBEE9FE0B63C00081CF352A484D406030BEE99F0B63C0CF2CD035A6464D401875BEE9970E63C0A45ECF355E404D40806CBEE9740F63C0BFC5CF35823D4D40010300000001000000150000001D91C8D4930864C05CBAABC6AE514D407A59D8A8DE0864C09408B4257F514D406A577376AE0864C0D05F24056D534D40807A6C5EE40864C087874D6426554D401807689F6A0964C02D9BE648E7554D40D2AE9CCC1E0A64C0F013FE817C574D40D0B568940D0A64C0D793D0354A584D40D0B568940D0A64C0B37A248B5F594D402C76B11FD80964C060BB7BC7435A4D40D03B5E46A60964C050ADE2EDBE5A4D4060E485A4F10964C02BF39C2FA15B4D40BFCF2CC7A30964C0701099785B5D4D408E41BEE9E50864C098F7CE35FA5B4D4072CF29E4D40864C093EECCBD2D5A4D407F79C5DCE00864C0F8E0F4F673584D40E8073DE7D30864C0EBE96DC4F7564D40A3A46894470864C088427AE0DC564D406E05BEE9F00764C068557BE0FC554D40D2B56894CD0764C0483CCF35D2544D405931E910140864C04706E2E45A534D401D91C8D4930864C05CBAABC6AE514D400103000000010000000F0000002ED86894590D64C0D8FD79E044574D40F638BEE9A20D64C03FB6D03516574D40BD52BEE9DB0D64C0DCB2CE35A2574D405F30BEE9EF0D64C070BF248B77584D40545BBEE98E0D64C017B979E0AC5C4D403CAD68944A0D64C0B8C5CF35825E4D40852CDFEEFD0C64C0E0B4F6042A604D409A16BEE9860C64C028B979E06C5E4D404D1469944E0C64C007CC7AE08C5D4D40244ABEE9380C64C0B8C5CF35025D4D40806CBEE9340C64C0443CCF35525C4D40B90B69944B0C64C09BF7CE35FA5A4D4000C76894930C64C01CE8CF358E594D4020036994F80C64C08771D0353E584D402ED86894590D64C0D8FD79E044574D400103000000010000002D0000007EF3F3F05F1A64C0A82C8311CB534D40A5615CFD0A1B64C0573E26F428514D4005FD19CC891B64C0334C45BBAE4E4D40DC05567DCA1B64C020598F5BC94B4D408D504C41BB1C64C0BBF8730201494D4020602332F41D64C000267D828D474D402761C18BEB1E64C02B21424A56464D4005B8F2229B2064C0C0AADB8F8A474D408CCF1F2B4C2164C0108E688E6E474D40228AB1C8B62164C0206BAD0C83464D401615753C5F2264C057FF8B9A01464D4038EEE756C02264C0EF388C63D3464D4063C84B13732264C0C4DA6A133D494D40BD18FEC4922264C0701B6BBE4B4A4D400F12C4D4E12264C0F3C8E339804B4D4016EC92E0692264C00052794DE54C4D400C10067D7D2264C06F5A95C3354E4D40A2BB46268B2264C02FB47EC39C504D4098CF6894862364C098427AE05C534D404E2C126E7D2464C07C9AE7F09F554D40F967B13A802564C0F8FC099E6A584D40D22877E12F2564C078D0487263584D40E9E226387F2264C09382C3BFD3514D4004131CEA092264C0B979F9F69E564D404687543FF92164C08FC17726AA594D40C9B2612C672164C0CB0C6884DF594D40DDC33DAD2A2064C02074B9F6C25B4D405DEF2188231F64C0C0DB2630AB5D4D40C44F1318531E64C02DB5D2436B5E4D40662B66EC1A1D64C0F78B1E416F5F4D40A03BCCBA761B64C08FAC65A7A95F4D4086A6EEF5AE1A64C045B64543CD604D403C23929AE61964C008BF82ABF1614D407DA3E0D3331964C02736AF5C02634D40BFC510548B1864C0DF1C60B34A634D40907FE120A71764C0CBD1E01921664D40C730F3BFCA1664C04BACE8FDE9664D402BF40C0A881664C014A8A1CE1B684D4005FDB758021664C0A7F3F0F1CB684D40E1E4CC16F31564C07724408FC9674D405FA17F7D621664C0EB34571C7A654D409121B7F4121764C00330AFB430624D400EBD8C62B91864C0531F0A78AF5B4D40FCB24600A11964C0C93B106B07574D407EF3F3F05F1A64C0A82C8311CB534D400103000000010000000F000000EFAA133FC20564C08871D035FE694D404E146994EE0564C00017268BEF684D409041BEE9750664C0406B258B336A4D401CBC133FB80664C05FA3CF35366B4D40D6FCBDE91D0764C0A7A97AE0806B4D4086B3133F750764C0FF80CF352A6C4D408E41BEE9750764C0908D258B3F6D4D40D3B568942D0764C0FF16268BAF6D4D4086B3133FC50664C017337BE0706D4D4021036994A80664C00436248B076D4D40E763BEE9910664C0503CCF35126C4D40BD52BEE96B0664C01BE8CF35CE6B4D40244ABEE9180664C0386B258B736B4D40CE6E133FCD0564C0DBB2CE35E26A4D40EFAA133FC20564C08871D035FE694D4001030000000100000012000000B07DBEE96A0063C08B8D258BFF784D40B70B69946B0063C00CCC7AE04C784D40C099133F5C0163C0B7C5CF3502774D406030BEE99F0163C07826258B1B764D40040EBEE9C30163C0FC35248B07754D4084B3133F150263C0B8107BE0A4744D40FFC66894630263C0FC35248B07754D40A1A46894670263C074BF248BB7754D40545BBEE93E0263C058EE7AE098764D403AAD68940A0263C08B26258B5B774D403CAD6894FA0163C06458248B13784D406030BEE9FF0163C01FB979E0AC784D4056A2133FEF0163C0D8B2CE35E2784D40FC7F133F830163C098427AE0DC784D4056A2133F6F0163C0B0F4258B23794D4096CF6894560163C00BCC7AE0CC794D4068BE6894200163C03B207AE0D0794D40B07DBEE96A0063C08B8D258BFF784D40010300000001000000160000005AE96894BF0863C018E8CF35CE7A4D402DD86894190863C054877AE0747A4D40C6E068940C0563C054877AE0747A4D40D6FCBDE90D0563C0C92CD035E6794D40234ABEE9180563C0C3C5CF3582794D405CE968943F0563C050877AE0B4784D402ED86894A90563C050877AE034784D40AD7DBEE96A0663C06FBF248BB7784D40BC52BEE9CB0663C050877AE0B4784D40A2A46894170763C0E1B2CE3522784D40C5E06894AC0763C00C17268B6F764D40CC6E133FFD0763C0687479E014764D40D0B56894FD0763C0687479E014764D40EA63BEE9B10A63C093F7CE35BA744D406030BEE99F0B63C064A3CF3536754D406030BEE99F0B63C0687479E014764D40F4F16894E20A63C0BB7A248B5F764D4022036994780A63C00417268BAF774D40C5E068945C0A63C07F71D035BE794D401875BEE9870A63C0E719CF35467C4D40040EBEE9E30963C05CA3CF35367C4D405AE96894BF0863C018E8CF35CE7A4D400103000000010000000B00000085CC0B99B3F462C017E6D3C34D8D4D40801519B033F562C0D157C47B918C4D402F661F1FB5F562C0E738AA26CA8C4D40748C3F1265F662C0F41F7847898C4D40773B9431D6F662C078DEE2028C8D4D40CA85823317F762C0FCF442559A8F4D4007C45026ACF662C0497B7471BB904D4076BDC4F002F662C0E0AA849198904D405D6937FF71F562C0A9B7A0401D8F4D40797EF25999F462C048631ADED08E4D4085CC0B99B3F462C017E6D3C34D8D4D400103000000010000000B000000647E9579B4ED62C037E5EFBD038F4D40879EA0BC0BEE62C0CCEF708CBB8D4D40DE2593AEB4EE62C0D73B1C2AF48D4D404683D62169EF62C05580EEC6208F4D40386B5CA445F062C010C139DC74904D4064A36B0D02F062C013EAC0EB93914D40D902FA5EE2EE62C0044C243BB0914D4064AA670E57EE62C0440C4BDB76914D40C5C555BBDFED62C037FF144051914D4091996DCF05EE62C08D06428247904D40647E9579B4ED62C037E5EFBD038F4D4001030000000100000008000000B17EB6B23DF962C0C3E1C53C97934D40E2E5F5CF9FF962C0B84DD33CC7914D40940CAC554EFB62C0BF01FEB487924D40CB64230395FC62C0483A9D877A924D4083703E0870FC62C08FD2798F1E944D40AEF1B1D27CFB62C044D4EB9AF9944D402058D96723FA62C0584FB452D8954D40B17EB6B23DF962C0C3E1C53C97934D400103000000010000000F0000008E41BEE965D662C035D5CE352EA84D402DD8689469D762C0B07A248BDFA74D406C05BEE960D862C008CC7AE08CA84D407E256994F4D862C0AFC5CF35C2AA4D406D05BEE9E0D762C017E8CF35CEAD4D40A5A4689427D762C0680AD035DAAE4D406E05BEE9E0D662C078557BE03CB04D402203699488D662C0A95ECF359EB24D40F538BEE9D2D562C091427AE0DCB34D40BC52BEE9EBD462C0A87A248B1FB44D405CE968940FD462C028D5CE352EB34D402BD8689479D362C0D893D035CAB04D4095CF6894F6D462C0B47A248B9FAA4D40D5FCBDE9ADD562C037D5CE35EEA84D408E41BEE965D662C035D5CE352EA84D4001030000000100000013000000C927BEE9FC2C63C02FB6D03556AB4D409A16BEE9F62F63C0E548258BA7A94D40264ABEE9C83063C0E019CF3546AA4D405CE968941F3163C00081CF352AAB4D40E41C6994713163C0D8B2CE3562AB4D405CE96894AF3163C0F780CF35EAAB4D40A4A46894C73163C0EC19CF35C6AD4D40B07DBEE99A3163C05FA3CF35F6AE4D4020036994383163C0D8FD79E044B04D405DE96894CF3063C01704258B4FB14D40E61C6994913063C07771D035BEB14D407C256994243063C0B7107BE024B24D40E61C6994412F63C0AF107BE0E4B34D407B256994D42E63C0E093D0354AB44D40BD52BEE9BB2C63C0E093D0354AB44D406030BEE96F2B63C0D02CD03566B04D40244ABEE9582B63C08771D035BEAE4D40545BBEE90E2C63C0C0C5CF3582AC4D40C927BEE9FC2C63C02FB6D03556AB4D40010300000001000000080000009A16BEE9E64A62C00481CF35AAB44D402991133F794B62C08871D0357EB44D40321FBEE9794B62C0543CCF3512B64D40B07DBEE95A4A62C0AC7A248BDFB94D40826CBEE9044A62C038B6D03556BA4D40C827BEE9DC4962C098F7CE353AB94D40E1D5133F514A62C0B7C5CF3582B64D409A16BEE9E64A62C00481CF35AAB44D4001030000000100000017000000B60B6994ABC962C07771D0357EB94D401775BEE9B7C962C0730AD0351AB74D405DE968940FCA62C0D893D0350AB64D401675BEE947CA62C01804258B0FB64D40264ABEE968CA62C070BF248BB7B64D406ABE689480CA62C07C71D0357EB74D40B07DBEE99ACA62C098427AE0DCB74D4000C76894D3CA62C055A3CF35B6B74D40BC52BEE92BCB62C04F3CCF3512B74D40525BBEE95ECB62C08871D035FEB64D40E51C699421CC62C06FBF248B37B74D4096CF689456CC62C0A75ECF35DEB64D4001C76894B3CC62C0D893D0350AB64D403AAD68944ACD62C087427AE01CB44D40311FBEE9A9CD62C00B81CF356AB34D406B05BEE930CE62C08C71D0357EB34D40525BBEE98ECD62C01CE8CF35CEB74D40F738BEE922CD62C0B07A248B1FB94D409C16BEE9B6CA62C08471D0357EBA4D40525BBEE9CEC962C023B979E06CBB4D40D2B568946DC962C06FBF248B77BB4D40A2A4689467C962C08471D0357EBA4D40B60B6994ABC962C07771D0357EB94D40010300000001000000160000008E41BEE9851262C021B979E0ACE84D404E1469945E1362C037B6D03516E84D40CA27BEE9AC1162C0F319CF35C6EF4D4086B3133F151162C0DF48258BE7F04D40C4E068944C1062C0E393D035CAF14D407F6CBEE9240E62C093F7CE35FAF74D40FC7F133F930C62C02F4FD03572FA4D405E30BEE9EF0A62C0DBFD79E004FE4D40BA52BEE9DB0962C02804258B8FFE4D40CC6E133FDD0762C06CBF248BF7004E40C827BEE9AC0662C0B8C5CF3582014E40FB7F133FD30662C0DF93D0354A004E406E05BEE9100762C05DA3CF3576FF4D40DFD5133F610762C0EC19CF3506FF4D406030BEE9BF0762C0B0107BE0E4FE4D40E0D5133F110C62C04BD2258B57F74D40B4C4133FEB0C62C030D5CE35AEF64D406ABE6894300D62C01BE8CF35CEF54D401875BEE9670D62C024B979E0ACF44D405E30BEE9AF0D62C0E719CF3586F34D4057A2133FBF1162C0A85ECF35DEE94D408E41BEE9851262C021B979E0ACE84D40010300000001000000240000009F5D133FD77F62C03CD5CE352E044E40244ABEE9988262C0B37A248B5FFC4D40CA27BEE99C8362C070557BE0FCFA4D40C6E068948C8462C03CD5CE352EF94D40D4B56894FD8462C0EB19CF35C6F84D409916BEE9D68762C0EB19CF35C6F84D40826CBEE9548762C0DFFD79E084F94D40A4A46894478662C0FF35248B07FA4D4088FA6894D58562C0CF2CD03566FB4D40D0B568940D8662C0543CCF3552FB4D40E61C6994818662C00417268B6FFB4D40321FBEE9B98662C0CF2CD03566FB4D40FFC66894938662C040D2258B17FC4D40EA63BEE9818662C0E019CF3586FC4D40F638BEE9628662C06F7479E0D4FC4D40F4F16894128662C0B8107BE024FD4D40F4F16894128662C0DBFD79E004FE4D408F41BEE9558662C01F4FD035F2FD4D406D05BEE9E08662C03CB6D03516FE4D407F6CBEE9248762C0DBFD79E004FE4D407F6CBEE9248762C0B0107BE0E4FE4D40525BBEE97E8662C03CD5CE356EFF4D403BAD6894FA8562C0A87A248B1FFF4D401675BEE9878562C0F780CF352AFE4D402CD86894198562C047877AE0B4FC4D40F4F16894A28462C064BF248B77FC4D40816CBEE9648362C07B557BE0FCFE4D406ABE6894808262C0E0B2CE3522004E409C16BEE9068162C0B0C5CF3542034E408AFA6894D58062C0344FD035F2034E407D256994A48062C03CB6D035D6044E40D7FCBDE96D8062C0B17A248B9F054E402991133F298062C060A3CF35F6054E409E5D133FC77F62C04C877AE0B4054E40E763BEE9B17F62C014E8CF350E054E409F5D133FD77F62C03CD5CE352E044E400103000000010000001300000049CD133FCE0B62C0EF19CF3546FF4D40E0D5133FF10B62C02404258BCFFE4D40D4FCBDE92D0C62C0938D258B3FFF4D409E5D133F670C62C0E0FD79E044FF4D401DBC133F880C62C0E893D0358AFF4D40B4C4133F8B0C62C00036248B47004E40254ABEE9680C62C0737479E014014E40D2B568945D0C62C0E8AF258B0B024E409288133F860C62C0B87A248B5F034E40CE6E133F9D0C62C0B07A248B1F054E4068BE6894B00C62C0CF48258BA7054E40F2F16894A20C62C0DCB2CE3522064E4068BE6894700C62C02F4FD03572064E40E2D5133F410C62C0D8FD79E044064E40F638BEE9220C62C0E893D035CA054E40B80B6994DB0B62C038D5CE35EE014E40B80B6994DB0B62C03C6B258BF3004E40CD6E133FCD0B62C0607479E054004E4049CD133FCE0B62C0EF19CF3546FF4D40010300000001000000120000003AAD68946A7F62C0B8C5CF35C2FA4D407C256994248162C033D5CE35EEF94D40BC52BEE97B8162C0B3C5CF3582FA4D40F838BEE9228162C047877AE0B4FC4D40D2B568943D8062C0D9FD79E084FF4D405E30BEE94F7E62C05FBF248BB7034E402A91133F897C62C044B6D035D6084E40CA27BEE90C7C62C0F319CF35C6094E406ABE6894907B62C040B6D035560A4E409E5D133F177B62C0D02CD035660A4E40C827BEE98C7A62C060BF248BF7094E40CE6E133F3D7A62C0503CCF35D2084E40030EBEE9737A62C0B8C5CF35C2064E40BD52BEE9FB7A62C0C82CD035E6034E40F3F16894C27B62C0E0B2CE3522014E4086B3133FA57C62C0F019CF35C6FE4D40244ABEE9087E62C0E048258B67FC4D403AAD68946A7F62C0B8C5CF35C2FA4D400103000000010000001C0000006030BEE97F7E62C0503CCF3592104E406C05BEE9807E62C0503CCF35920F4E408D41BEE9457D62C02304258B0F104E40826CBEE9C47C62C095427AE09C0F4E40FC7F133F337C62C08071D035BE0D4E406030BEE9AF7C62C074557BE03C0C4E40FA7F133F637D62C0BCC5CF35020B4E40A05D133FD77E62C050A3CF3576094E40CA27BEE99C8062C01BE8CF358E094E40BB52BEE96B8162C0908D258BFF084E4096CF6894E68162C0B8C5CF35C2064E4068BE6894A08162C0304FD035F2064E409C16BEE9068162C0B8C5CF35C2064E40C6E06894FC8262C0DF19CF3546024E40525BBEE9FE8362C0F835248B87004E408BFA6894858462C0B8C5CF3582014E40F3F16894428462C093F7CE35FA034E40E61C6994818362C04C877AE034074E40040EBEE9938262C0BCC5CF35020A4E40050EBEE9738162C0948D258BBF0B4E408AFA6894958062C0E048258B270E4E40AE7DBEE90A8062C0304FD035B20E4E407C256994F47F62C0C3C5CF35820F4E4020036994387F62C034D5CE35EE124E4039AD68940A7F62C000CC7AE08C134E40CE6E133FED7E62C0DF93D0350A144E40EA63BEE9B17E62C010E8CF358E124E406030BEE97F7E62C0503CCF3592104E400103000000010000000E000000C827BEE9DC1163C0AC5ECF35DE0D4E4067BE6894901263C090F7CE35BA0D4E40501469948E1363C0EB19CF35C6104E40AE7DBEE91A1463C0EF19CF3506134E40A4A46894571463C068BF248B37144E40B70B69946B1463C00081CF356A154E40C4E068943C1463C0B07A248B5F164E40AE7DBEE9DA1363C01F4FD035F2164E40264ABEE9581363C090427AE0DC164E40EA63BEE9C11263C0DF19CF3506164E40234ABEE9381263C0543CCF3552144E408AFA6894051263C02D4FD03532134E40D3B56894DD1163C0FB35248B47114E40C827BEE9DC1163C0AC5ECF35DE0D4E40010300000001000000250000002FD86894998262C0FB35248B47114E40B90B6994CB8262C0DFB2CE35220F4E407E256994E48262C0607479E0D40C4E40C827BEE92C8362C0FD16268BAF0A4E405CE968949F8362C0A95ECF351E094E409A16BEE9368462C0B0C5CF3582084E407F6CBEE9648462C0D8B2CE3522084E402791133F198562C0F019CF3586054E402CD86894198562C0F019CF3586054E409916BEE9668562C0677479E0D4044E4096CF6894468862C059A3CF35F6024E409A16BEE9268962C0503CCF3512034E40B07DBEE90A8A62C0D1B2CE3522044E40E863BEE9318962C065A3CF3576054E40341FBEE9098762C050D2258B17054E40F4F16894128662C060A3CF35F6054E40F738BEE9D28662C0304FD035F2064E4097CF6894968962C0B8C5CF35C2064E4097CF6894968962C058A3CF35B6074E40D1B56894AD8862C0780AD0359A084E401875BEE9E78662C030D5CE356E094E40F4F16894128662C054877AE0340B4E403AAD68946A8862C0700AD0355A0B4E4096CF6894268962C0687479E0140C4E40D5FCBDE9AD8862C034D5CE352E0D4E40E41C6994818462C034D5CE35EE124E40C4E06894CC8362C077557BE03C134E408D41BEE9A58362C0EF19CF3586104E4059E968943F8362C09B5ECF355E114E40E41C6994D18262C0F735248BC7124E403BAD68947A8262C090F7CE357A144E401875BEE9378262C03CD5CE35EE174E4068BE6894F08162C098F7CE35FA184E402DD86894998162C008CC7AE00C194E4059E968944F8162C0D1B2CE35E2174E40A2A46894A78162C0B87A248B9F154E402FD86894998262C0FB35248B47114E400103000000010000000E0000009E5D133FE71E62C0A8F4258BE31C4E401775BEE9571E62C038207AE0D01C4E408AFA6894B51D62C0A05ECF359E1D4E40D2B568946D1D62C0334FD035721D4E4056A2133F4F1D62C03F207AE0901C4E40806CBEE9441D62C0FF80CF352A1C4E40F2F16894121E62C0C3C5CF35821B4E40B4C4133FEB1E62C013337BE0B01B4E404E1469946E2062C05B58248B531C4E40501469941E2162C040B6D035961C4E40C5E06894AC2162C03BD5CE35AE1D4E4021036994E82062C03F877AE0341D4E407C256994042062C004CC7AE00C1D4E409E5D133FE71E62C0A8F4258BE31C4E400103000000010000000D000000BD52BEE9DB1962C04CD2258B571C4E40545BBEE94E1962C00817268BEF1B4E402891133F791862C0D5E1248B031C4E40AE7DBEE98A1862C0FBAF258B4B1B4E40501469944E1962C0396B258B731B4E40C099133F0C1A62C00817268BEF1B4E406C05BEE9B01B62C0D02CD035A61C4E4095CF6894261C62C0334FD035721D4E40F838BEE9D21B62C07B26258BDB1D4E40B07DBEE91A1B62C0473CCF35521D4E40C099133FBC1A62C0A8F4258BE31C4E40B70B69946B1A62C05758248BD31C4E40BD52BEE9DB1962C04CD2258B571C4E400103000000010000000E000000CA27BEE93C2562C04C877AE0341F4E40A4A46894972462C06CBF248BB71E4E402ED86894A92462C0B0A97AE0001F4E40501469945E2462C0149D248BEB1E4E406C05BEE9602462C0697479E0541D4E40FEC66894C32462C03F877AE0341D4E40525BBEE91E2562C0089D248BEB1D4E404ACD133F5E2562C07F26258B9B1E4E40A05D133FC72562C0DF93D0350A1F4E40040EBEE9632662C0EFAF258B8B1F4E402891133FE92662C0CD9679E0A0204E40A05D133F672662C088427AE0DC1F4E406D05BEE9E02562C0199D248BAB1F4E40CA27BEE93C2562C04C877AE0341F4E400103000000010000000F000000D5FCBDE90D2862C0CF48258BA71F4E40D2B568947D2862C02F207AE0901E4E400855133F042962C07F26258B9B1E4E40826CBEE9742962C01F04258B8F1F4E401875BEE9772A62C0770AD0351A214E40040EBEE9732B62C00817268B2F224E406577133F002C62C098427AE09C224E40F838BEE9622C62C050D2258B57234E409288133F562C62C05FBF248B77234E409E5D133FC72B62C0C89679E020234E407E256994242B62C070557BE07C224E403AAD68949A2962C00F9D248BEB204E401CBC133FE82862C0D048258B27204E4002C76894432862C0BB7A248B1F204E40D5FCBDE90D2862C0CF48258BA71F4E400103000000010000001200000067BE6894206F62C0E4B2CE35621D4E40C827BEE9BC6F62C0E893D0354A1D4E408C41BEE9D56F62C0680AD0355A1E4E406ABE6894C06F62C0747479E054204E401A75BEE9077062C04C3CCF3512214E40D5FCBDE9CD6F62C038D5CE35AE214E4020036994F86E62C0D7B2CE3522224E409C16BEE9666E62C0710AD035DA224E40321FBEE9396E62C040877AE0F4224E40BC52BEE90B6E62C07C557BE0FC224E4096CF6894B66B62C0E319CF3546264E4020036994886B62C08871D0357E264E40C827BEE92C6B62C0995ECF359E264E40CD6E133FFD6A62C074557BE03C264E406C05BEE9006B62C08B71D0357E244E40E1D5133F216B62C0DBFD79E004234E402891133FD96B62C0BB107BE0A4214E4067BE6894206F62C0E4B2CE35621D4E400103000000010000001A00000069BE6894403262C05B58248B53274E402991133F093262C0D8FD79E004274E4058A2133FCF3162C0C1107BE024274E40806CBEE9C43062C0D893D0358A264E4088B3133F053062C018337BE0F0264E40C3E068948C2F62C008E8CF358E274E4022036994782F62C03F3CCF35D2264E405BE96894EF2F62C0BB7A248B5F264E40F2F16894D23062C0AF107BE0E4254E401875BEE9B73162C0D893D0358A264E402CD86894293262C0DCB2CE35E2264E40FB7F133F933262C047877AE074274E40E41C6994A13262C00781CF35EA274E40B80B6994AB3262C0FB80CF356A284E40A4A46894A73262C090427AE01C294E4098CF6894263362C0B0A97AE0002B4E40FFC66894833362C0B8C5CF35422C4E403666133F8A3362C0DF19CF35062D4E400855133F643362C07726258B5B2C4E40C199133F1C3362C0C7E1248BC32B4E40A5A46894D73262C074557BE0FC2A4E4098CF6894863262C097427AE05C294E405CE968946F3262C093427AE09C284E40D6FCBDE95D3262C05B58248B53284E40B1C4133F5B3262C0D5E1248B03284E4069BE6894403262C05B58248B53274E40010300000001000000060000000855133F943762C0D8B2CE35A22D4E403766133FBA3762C0D8B2CE35A22D4E40D6FCBDE9DD3762C0B3A97AE0C02D4E4087FA6894B53762C007E8CF35CE2D4E40E963BEE9913762C0C4C5CF35C22D4E400855133F943762C0D8B2CE35A22D4E4001030000000100000005000000F638BEE9023A62C0C09679E0E02F4E40545BBEE9DE3962C0AFF4258B632F4E404ACD133FEE3962C0C0107BE0642F4E407C256994143A62C0BBC5CF35822F4E40F638BEE9023A62C0C09679E0E02F4E40010300000001000000660000009E5D133FA76362C0DC48258BA72D4E402891133FD96362C08471D0357E2C4E403BAD68945A6062C08471D0357E2C4E402891133FD96062C03CB6D035562A4E404E1469946E6362C0E3B2CE35A2244E408D41BEE9956262C0CFB2CE35E2234E40FA7F133F835D62C0B37A248B1F284E40FA7F133F835D62C0908D258B3F274E401875BEE9B75D62C0D8FD79E004274E40B2C4133FDB5D62C0747479E094264E40BA52BEE9FB5D62C0DB93D0350A264E408D41BEE9255E62C0998D258B7F254E40525BBEE90E5F62C028B979E02C214E408C41BEE9556062C0F780CF35EA1D4E40B1C4133F7B6762C0E493D0350A114E4069BE6894806A62C07F71D035FE084E406030BEE9DF6B62C0204FD035B2034E40CE6E133F0D6C62C078557BE0FC014E40F638BEE9D26B62C0AB5ECF35DE004E40B4C4133F7B6B62C04B877AE0F4FF4D40E2D5133F516B62C0B0107BE0E4FE4D4050146994BE6B62C0E019CF3586FC4D40BC52BEE9AB6D62C0AFC5CF3502FD4D40545BBEE97E6E62C044B6D035D6FB4D402891133F796F62C05CA3CF3536F94D40244ABEE9986F62C0EB19CF35C6F84D4068BE6894B06F62C060BF248B37F84D40E2D5133F516F62C0C4C5CF3502F74D4021036994986E62C02F4FD03532F54D40040EBEE9836E62C017B979E0ACF24D40BC52BEE9FB6E62C087F7CE353AF04D40E2D5133FC16F62C01804258B4FEE4D40321FBEE9997062C037B6D03556ED4D40C6E068943C7362C0304FD035F2EE4D402A91133F997462C00481CF356AEE4D4095CF6894667562C0A85ECF35DEE84D4086B3133FE57562C045B6D03596E84D406030BEE9EF7662C058A3CF35F6E84D404E1469949E7962C0403CCF35D2E64D40FC7F133FE37A62C017B979E0ACE44D406E05BEE9907B62C0D748258B27E44D40535BBEE91E7C62C07771D0353EE44D40B07DBEE94A7D62C050A3CF3576E54D40B07DBEE94A7D62C050D2258B57E64D40F638BEE9C27C62C04F877AE0B4E74D4055A2133F9F7C62C09DF7CE35BAEA4D40B4C4133F5B7C62C0E819CF35C6ED4D40EA63BEE9717B62C00881CF352AEF4D40301FBEE9697A62C05FA3CF3576EF4D4096CF6894667962C0740AD0355AF04D40E963BEE9717862C093F7CE35BAF14D409E5D133F977762C0E719CF3586F34D40F638BEE9527862C034D5CE352EF44D40CD6E133F4D7962C0680AD0359AF44D40EA63BEE9C17962C01BE8CF35CEF54D40BE52BEE9EB7862C0EB19CF35C6F84D40050EBEE9137862C043D2258B17FA4D40FA7F133F437662C0DB48258B27FB4D401775BEE9677562C0F419CF3546FC4D40030EBEE9937562C09CF7CE357AFD4D40A05D133FD77562C050D2258B57FE4D405E30BEE97F7662C033D5CE35AEFF4D403AAD6894CA7562C0975ECF351E014E4058A2133F0F7162C0908D258B7F074E40B3C4133F7B7062C09BF7CE35FA084E4096CF6894966D62C06F557BE03C0E4E403AAD68942A6C62C0995ECF35DE114E40264ABEE9686C62C0503CCF35D2144E4020036994F86B62C06F7479E0D4154E40F638BEE9F26A62C0BCC5CF3502174E40CC6E133F8D6A62C04FA3CF35F6174E40244ABEE9B86962C0E493D0350A1D4E408C41BEE9756962C05FBF248BB71D4E408E41BEE9256962C0503CCF35921D4E4058A2133F7F6862C0F780CF35EA1C4E4097CF6894266862C0BCC5CF35C21C4E40806CBEE9E46762C0E493D0350A1D4E40F3F16894526762C07C557BE03C1E4E406030BEE96F6662C0938D258BFF1E4E40D5FCBDE94D6662C0D048258B27204E40D6FCBDE97D6662C0204FD03572224E408E41BEE9856662C0D848258B27234E401875BEE9976662C0E793D0350A244E40AE7DBEE9AA6662C029D5CE35AE244E4088B3133FB56662C0E3B2CE35A2244E407D256994A46662C0C1C5CF35C2254E402A91133F896662C0DFB2CE3522264E4021036994686662C00881CF356A264E408E41BEE9456662C0908D258B3F274E40F738BEE9226662C061A3CF35B6274E40264ABEE9E86562C0DFB2CE3522284E40F2F16894B26562C0F035248BC7284E40D4FCBDE99D6562C0A75ECF35DE294E40EB63BEE9C16562C0878D258B7F2A4E40331FBEE9596662C0E5B2CE35622B4E40D6FCBDE97D6662C02C4FD035B22B4E40E2D5133F116662C094427AE05C2E4E409A16BEE9F66462C0FC16268B2F304E40F3F16894B26362C06F0AD035DA304E409A16BEE9C66262C0473CCF3512304E4022036994686362C06D7479E0942E4E409E5D133FA76362C0DC48258BA72D4E400103000000010000000F000000FFC66894738062C069BF248B77274E409A16BEE9968062C0BB7A248B5F264E40311FBEE9598162C029D5CE35AE244E4020036994588262C09C8D258B7F244E40A3A46894578362C077557BE07C254E40AE7DBEE91A8462C0908D258B3F274E40F638BEE9528462C0BB7A248B5F264E406E05BEE9108462C0A87A248BDF2A4E40B90B69946B8262C00336248B472F4E408D41BEE9758062C0E448258BA7314E409E5D133F477F62C0473CCF3512304E4084B3133F757F62C0E048258BE72E4E409A16BEE9268062C044D2258B172C4E40F838BEE9328062C064A3CF35F62A4E40FFC66894738062C069BF248B77274E400103000000010000000700000058A2133F6F3B62C0204FD035F2304E40BA52BEE97B3B62C0D048258BE7304E40331FBEE9293C62C0F0AF258B4B314E40244ABEE9A83C62C0E893D0350A324E4098CF6894E63B62C0B4F4258BA3314E40F638BEE9A23B62C0CF48258B67314E4058A2133F6F3B62C0204FD035F2304E40010300000001000000140000007E256994D42362C0F019CF3586294E40EA63BEE9F12362C0DB48258BE7274E40545BBEE95E2462C0908D258B3F274E40B5C4133FAB2462C0D993D0358A274E40234ABEE9382562C0EC93D035CA284E40F3F16894D22562C027D5CE35EE284E40264ABEE9782662C0E019CF3546284E4020036994C82662C0B37A248B1F284E4020036994782762C0A45ECF359E284E40E2D5133F612862C0637479E0942A4E40264ABEE9182962C08C71D035BE2A4E40264ABEE9182962C02C4FD035B22B4E40806CBEE9942562C0204FD035F2304E4086B3133FD52362C048877AE074344E40B07DBEE90A2362C0EB93D0354A354E408E41BEE9F52262C088F7CE357A334E40C827BEE92C2362C0F119CF35C6314E409B16BEE9A62362C0700AD0355A2F4E4086B3133FD52362C0304FD035722D4E407E256994D42362C0F019CF3586294E40010300000001000000D80000002FD8689449C364C024B979E02C324E40F638BEE9F2C264C03F877AE0F42F4E4068BE689490C264C08071D035FE2D4E403BAD6894FAC164C08471D0357E2C4E40C3E068942CC264C0AC5ECF351E2C4E40F2F1689442C264C098F7CE35BA2B4E406C05BEE950C264C0E719CF35462B4E403CAD68946AC264C08C71D035BE2A4E401675BEE9A7C164C094F7CE35FA294E405DE968949FBF64C0E493D0350A294E40AE7DBEE97ABD64C0A75ECF35DE294E408E41BEE9B5BC64C033B6D035162C4E4069BE689460BC64C08471D0357E2C4E405BE96894EFB964C0E819CF35462C4E40FFC6689433B964C02C4FD035B22B4E406030BEE9EFB864C0D0B2CE35222B4E409A16BEE986B864C014E8CF358E294E4000C7689453B864C0707479E014294E40B80B6994DBB764C03CB6D035D6284E40D1B56894FDB664C0C72CD035E6284E40030EBEE993B664C0B37A248B1F284E40BC52BEE93BB764C0908D258B3F274E409916BEE9E6B564C0BB7A248B5F264E40B70B6994FBB564C077557BE07C254E402103699408B664C0975ECF351E254E40050EBEE923B664C0E3B2CE35A2244E40BA52BEE9BBB564C0C82CD035A6234E40545BBEE9EEB564C0DC48258B27224E40D3B568946DB664C0F735248BC7204E401875BEE9E7B664C037D5CE352E204E40B90B6994FBB664C033D5CE356E1F4E40FEC6689493B664C08C71D035BE1D4E407B256994B4B564C0E3FD79E0041B4E407E25699414B764C07871D0353E174E40050EBEE973B764C0483CCF3592164E406ABE689430B764C09BF7CE35FA144E40FFC66894C3B664C07C0AD0351A144E404E1469943EB664C009E8CF35CE134E407B256994B4B564C02F4FD035F2134E40AF7DBEE9DAB564C038B6D03556134E4069BE689400B664C040B6D03596124E40050EBEE923B664C02C4FD03532124E40050EBEE923B664C0473CCF3552114E40321FBEE9D9B564C0CFB2CE3522114E404D146994BEB564C0B77A248BDF104E40B80B6994ABB564C0D848258B67104E40C6E068947CB564C0503CCF35920F4E40C4E06894CCB564C00381CF35AA0D4E40F738BEE932B664C03CD5CE35EE0B4E40BC52BEE93BB764C0B0C5CF3582084E406130BEE91FB664C027B979E0AC084E40B80B6994ABB564C02FB6D03516084E40E51C699451B564C064A3CF35F6044E402ED86894E9B464C04FA3CF3536044E405F30BEE9EFB364C0B0C5CF3542034E406ABE689430B464C0BB107BE0E4014E40D0B568945DB464C070557BE03C014E40A4A4689497B464C0DFB2CE35A2004E40A4A4689497B464C033D5CE35AEFF4D405CE968941FB464C048D2258B17FF4D406C05BEE9A0B364C0D4B2CE35E2FC4D401875BEE947B364C0F419CF3546FC4D401775BEE9D7B264C08071D0357EFC4D40321FBEE9D9B164C06F7479E0D4FD4D4069BE689450B164C0DBFD79E004FE4D40244ABEE9B8B164C07F71D035FEFC4D402ED8689429B264C028B979E02CFC4D40E51C699481B264C048877AE034FB4D406ABE6894A0B264C098F7CE35BAF94D408C41BEE935B264C098F7CE35BAF94D40321FBEE9E9B164C0EF19CF3586F94D4067BE6894C0B164C0EB19CF35C6F84D40EB63BEE9C1B164C0D0B2CE35A2F74D406ABE6894E0B164C07771D035FEF64D40E51C699411B264C068BF248B77F64D402DD8689449B264C01FB979E0ACF54D401875BEE927B364C00B17268B6FF44D409C16BEE926B664C0747479E094F34D401875BEE9E7B664C06CBF248BF7F34D40A3A4689447B764C070BF248B37F54D4068BE6894C0B764C00CCC7AE04CF64D40A4A4689427B864C0FD80CF356AF64D4000C7689453B864C010E8CF35CEF44D40C5E06894ACB864C048D2258B17F44D40D1B56894ADBB64C08C71D035FEF04D401975BEE947BC64C0E4FD79E0C4F04D406ABE6894B0BD64C0DF48258BE7F04D401875BEE937BE64C04CD2258B97F14D40C5E06894ACBE64C0D0B2CE35E2F24D40311FBEE929BF64C0D32CD035A6F34D40B80B6994CBBF64C093F7CE35BAF24D4096CF6894D6BE64C0C82CD035A6F14D40806CBEE954BF64C0CC2CD03526F04D40F538BEE952C064C030D5CE35EEEE4D40D4FCBDE9DDC064C037D5CE35AEEE4D40AD7DBEE94AC164C0E819CF35C6ED4D40CA27BEE9ECC364C00C81CF35AAEB4D40D3B568943DC464C0680AD035DAED4D40F0F1689402C664C0975ECF355EEE4D40826CBEE9E4C764C008CC7AE04CED4D40D0B568948DC864C050A3CF35B6EA4D40501469944EC864C040B6D03596EA4D40A3A46894E7C664C058A3CF35F6E84D402DD8689409C564C0FC80CF35EAE94D40B60B69944BC464C0AFC5CF3542E94D40B90B69949BC364C0E093D035CAE74D40A4A4689407C364C040B6D035D6E54D40D2B568949DC264C068BF248BB7E34D408E41BEE955C364C0EF35248B07E24D40C3E068949CC464C0E0FD79E004E14D40FFC66894D3C564C018E8CF35CEE04D404E1469945EC664C08371D0357EE14D4095CF689496C664C04C3CCF3592E34D406C05BEE920C764C095F7CE35BAE54D40525BBEE9CEC764C0D048258B67E74D40D7FCBDE9CDC864C08871D0357EE84D40C4E068948CC964C01CE8CF354EEA4D402CD86894F9C964C050A3CF35B6EA4D40525BBEE98ECA64C0A85ECF35DEEA4D40E41C699401CD64C00481CF356AED4D40264ABEE908CE64C0680AD035DAED4D405CE968940FCF64C0C02CD035A6ED4D4068BE689400D064C0E093D0358AEC4D4000C7689433D064C07C0AD0351AEE4D40CA27BEE9ACD064C05CA3CF3536EE4D40826CBEE9C4D164C037B6D03556ED4D4068BE6894A0D364C0AC5ECF359EED4D40C4E068942CD464C05CA3CF3536EE4D409916BEE976D564C03FB6D03556F14D40B80B6994EBD564C00036248BC7F14D4067BE689440D764C094F7CE353AF24D407C256994F4D764C0B0107BE0E4F24D408E41BEE935D964C0DC48258BE7F54D403AAD6894AAE064C0B0107BE0E4FE4D401775BEE907E064C001CC7AE04C004E40AF7DBEE9CADF64C0DFB2CE35A2004E40D7FCBDE95DE064C0553CCF3592014E40A5A46894E7E064C0C4107BE024014E40545BBEE96EE164C05FA3CF3536004E40525BBEE9FEE164C033D5CE35AEFF4D40C3E06894ECE164C038B6D03596004E40E71C6994F1E164C0D793D0350A014E40CA27BEE9FCE164C0D7FD79E084014E40525BBEE9FEE164C068BF248B77024E408C41BEE965E264C0E093D0354A014E40331FBEE989E264C00C17268B6F004E40C5E06894BCE264C0BF2CD035E6FF4D40525BBEE94EE364C033D5CE35AEFF4D409916BEE9E6E364C048D2258B17004E40816CBEE9E4E464C0F319CF3506024E405DE968945FE564C068BF248B77024E40F538BEE912E664C013E8CF358E034E40E51C6994F1E664C09B427AE01C064E409B16BEE9B6E764C0DF19CF3506094E40F2F1689422E864C054877AE0340B4E40321FBEE959E864C054877AE0340B4E40F3F1689492E864C0908D258BFF084E40A3A4689427E964C0DFB2CE3562084E40F1F16894D2E964C054A3CF35F6084E40C5E068944CEA64C040B6D035560A4E408D41BEE945EA64C003CC7AE0CC0A4E40C5E068944CEA64C070BF248B370E4E40BC52BEE95BEA64C068557BE07C0F4E40816CBEE984EA64C065A3CF3576104E404E146994FEEA64C02C4FD03532124E40806CBEE9F4ED64C0B7C5CF3502194E40D2B568947DEE64C01CE8CF35CE1B4E40A3A46894F7ED64C0C0107BE0241B4E402FD8689479ED64C0740AD0351A1B4E40234ABEE9F8EA64C040877AE0B41C4E408AFA6894A5EA64C08D71D0353E1D4E4096CF689446EA64C0CFB2CE35221E4E40EB63BEE9C1E964C0403CCF35921E4E401975BEE937E964C010E8CF358E1E4E40A4A46894C7E864C09F5ECF351E1E4E402CD8689449E864C0E4B2CE35621D4E4095CF6894E6E764C060BF248B371D4E405CE968940FE564C0E0FD79E0041E4E40A2A46894F7DB64C057A3CF35F61A4E406C05BEE940DA64C0780AD035DA1B4E405BE968946FD964C0D7B2CE3522214E402003699488D964C0DC48258B27224E40D0B56894BDD964C0D748258BA7224E402CD86894D9D964C0BFC5CF3542234E40A2A46894A7D964C0E3B2CE35A2244E4039AD68945AD964C00781CF356A254E40264ABEE958D864C068BF248BF7264E40816CBEE914D764C04C3CCF35D2274E40D2B568945DD564C0344FD035F2294E40535BBEE95ED464C0A75ECF35DE294E40E963BEE921D364C030B6D03556284E40C6E068947CD264C0780AD0355A284E40806CBEE934D264C018E8CF354E2A4E406C05BEE920D264C089427AE0DC2C4E40F638BEE9E2D164C0AFC5CF35022E4E40E863BEE9B1CE64C018E8CF358E314E406C05BEE980CD64C0334FD03532314E40C5E068947CCC64C07C71D0353E2E4E406C05BEE9A0CC64C0740AD035DA2D4E40806CBEE9C4CC64C030B6D035162D4E40C6E06894ECCC64C08471D0357E2C4E40A4A4689427CC64C00881CF35AA2C4E40C927BEE9DCC964C0204FD035F2304E4050146994EEC564C088F7CE357A334E40C727BEE90CC664C090427AE05C314E40C4E068948CC564C02704258B8F304E402FD86894D9C464C0E493D035CA304E40EB63BEE961C464C074557BE0BC314E405CE968944FC464C0CB2CD03566334E40EB63BEE981C464C0204FD03532354E402DD8689409C564C034D5CE35EE374E4001C7689433C464C097F7CE353A374E40515BBEE9CEC364C014E8CF358E364E40C927BEE97CC364C02C04258B4F354E40311FBEE9B9C364C00717268B6F344E402FD8689449C364C024B979E02C324E40010300000001000000440000007C256994545162C09CF7CE35FA3B4E406030BEE96F5162C0AFC5CF35823B4E40F2F16894424E62C0AFC5CF35823B4E40B5C4133F8B4D62C0C1107BE0E43B4E40B07DBEE9DA4C62C03CB6D035963C4E406C05BEE9204C62C00017268BEF3C4E40C4E068944C4B62C013E8CF354E3C4E408E41BEE9954B62C030B6D035163A4E40F3F16894924B62C014E8CF358E364E40C4E06894BC4B62C00717268B6F344E403BAD68945A4A62C0503CCF3592344E406E05BEE9A04762C09C8D258B3F374E401775BEE9D74462C00781CF352A384E408E41BEE9254462C037B6D035D6374E40341FBEE9D94362C00C81CF35AA364E409A16BEE9264462C0B07A248B1F364E40FA7F133F934562C00881CF356A344E402891133F094662C088F7CE357A334E4057A2133FFF4262C0F319CF3586344E4084B3133F854262C088F7CE357A334E40D4FCBDE9BD4262C0D993D0358A334E4097CF6894E64262C0F035248B47334E402891133F094362C037D5CE35EE324E40EA63BEE9314362C0F816268BAF324E40C927BEE9DC4562C028D5CE352E314E402891133F094662C0204FD035F2304E403AAD68942A4662C004CC7AE04C304E40826CBEE9344662C040877AE0742F4E409A16BEE9364662C01BB979E0AC2E4E40E0D5133F414662C07C71D0353E2E4E40AE7DBEE92A4762C08FF7CE35FA2C4E40CC6E133F0D4862C037B6D035D62C4E40F738BEE9C24962C0304FD035722D4E40C827BEE9AC4A62C030B6D035162D4E40264ABEE9C84F62C0DCB2CE35E2264E40311FBEE9B95162C00417268B6F214E40FC7F133F835262C074557BE0FC1F4E407D256994345362C0DFB2CE35621F4E40E1D5133FE15362C0757479E0D41F4E40E2D5133FC15462C0AFC5CF3502214E40F4F16894825562C028D5CE35AE224E40FA7F133FD35562C0E3B2CE35A2244E40AE7DBEE9FA5462C0CFFD79E044274E406ABE6894B04F62C07C71D0353E2E4E409E5D133F275062C00081CF356A2F4E403BAD68942A5262C08071D0357E2E4E40C4E06894FC5262C0A75ECF351E2F4E409F5D133F875262C0473CCF3512304E40BA52BEE92B5362C02804258B0F304E408B41BEE9B55362C09C8D258B7F2F4E40BA52BEE9BB5462C0304FD035722D4E407E256994A45362C0304FD035722D4E403AAD6894FA5462C07B0AD0359A2B4E40AE7DBEE96A5662C00081CF356A2D4E405E30BEE91F5762C00C17268B6F314E40FB7F133F435662C0FF16268B2F364E40E1D5133F215562C02404258B0F374E40030EBEE9F35462C0E093D0358A374E40D6FCBDE9DD5462C07C0AD0359A384E40B07DBEE9AA5462C01804258BCF394E40C4E068944C5462C0AFC5CF35823B4E40B07DBEE99A5362C0334FD035323D4E40EA63BEE9D15262C04C877AE0F43D4E40AF7DBEE9FA5062C0E4B2CE35223E4E40AF7DBEE9FA5062C028D5CE352E3D4E401975BEE9275162C0FF35248BC73C4E406E05BEE9405162C0C0107BE0643C4E407C256994545162C09CF7CE35FA3B4E40010300000001000000540000004E1469940E7662C088F7CE357A404E401875BEE9D77562C013E8CF354E3C4E40EA63BEE9117562C00017268B6F3D4E408C41BEE9A57462C03FB6D035D63D4E40D7FCBDE94D7462C0D848258BA73D4E40EB63BEE9117462C094F7CE35BA3C4E40CE6E133F1D7462C0F419CF35C63B4E405F30BEE94F7462C08071D035FE3A4E4020036994887462C01CE8CF358E3A4E4020036994887462C038D5CE35AE394E401875BEE9477462C025B979E06C394E40254ABEE9A87362C034D5CE35EE374E40E2D5133F217462C003CC7AE08C364E40B4C4133F4B7462C0FF16268B2F364E40F2F16894327562C0F780CF35EA354E405D30BEE9BF7662C038D5CE356E334E409E5D133F977762C0F816268BAF324E40816CBEE9E47662C02804258B0F314E40E1D5133F317662C08371D0353E314E40AF7DBEE97A7562C0D52CD03526324E4068BE6894C07462C0F816268BAF324E40F638BEE9027462C0AC5ECF35DE314E40E3D5133F317462C098F7CE35FA2F4E406ABE6894307562C08471D0357E2C4E40B4C4133F3B7662C0B1C5CF35C2264E40040EBEE9A37762C0C4C5CF3542214E40040EBEE9A37762C0938D258BFF1F4E40CA27BEE9BC7662C037D5CE352E204E4020036994287762C03BB6D035561C4E4022036994B87762C0FF35248BC7184E406030BEE97F7862C04F3CCF3552164E40545BBEE98E7962C0F319CF35C6154E403BAD68947A7962C0473CCF3512184E409F5D133FF77962C074557BE03C184E408E41BEE9957A62C02BB979E0EC174E40FC7F133FE37A62C0E193D035CA184E40BC52BEE95B7962C0C0C5CF35821E4E40545BBEE98E7962C0DFB2CE35621F4E40EB63BEE9517A62C08C71D035BE1D4E40E0D5133F417B62C02BB979E02C1D4E4020036994387C62C0878D258B7F1D4E40F838BEE9127D62C0C0C5CF35821E4E401975BEE9E77C62C0985ECF355E204E40BC52BEE9AB7C62C04F3CCF3552214E40FA7F133FC37B62C0D0B2CE35E2224E4098CF6894167C62C0A85ECF359E234E407E256994C47C62C094F7CE35BA244E40F838BEE9127D62C0998D258B7F254E40B07DBEE9DA7B62C037D5CE356E254E407C256994547A62C0E093D0354A264E40234ABEE9F87862C00CCC7AE04C284E4058A2133F3F7862C02C4FD035B22B4E40B07DBEE91A7962C00381CF356A2B4E40D6FCBDE9AD7A62C00C81CF352A2A4E40B2C4133F8B7B62C0A75ECF35DE294E40CE6E133FED7B62C06F0AD0351A2A4E406030BEE9FF7B62C02DB979E0AC2A4E401875BEE9D77B62C0D32CD035662B4E40B2C4133F8B7B62C044D2258B172C4E40E0D5133F217B62C047D2258B572C4E40F2F16894427A62C0A87A248BDF2B4E40BC52BEE9CB7962C08471D0357E2C4E40060EBEE9137B62C0D4B2CE35E22E4E40321FBEE9897B62C013E8CF354E304E40B4C4133F1B7B62C0204FD035F2304E406130BEE93F7A62C09B8D258BFF304E407E256994A47962C0B0107BE064314E402A91133F297962C038D5CE356E324E4056A2133FAF7862C00717268B6F344E408E41BEE9257962C0F8CB7AE08C344E40A05D133F477A62C0DFB2CE3522334E40FC7F133FE37A62C0F816268BAF324E406230BEE9FF7962C0AC5ECF351E394E404F1469945E7962C0D0B2CE35623C4E4056A2133FAF7862C0E4B2CE35223E4E4020036994B87862C0770AD0351A3A4E403CAD6894DA7862C0E193D0358A384E407E256994247962C0AF107BE024374E40BE52BEE95B7762C0948D258B7F384E402891133FB97662C02FD5CE35EE394E404F1469940E7762C07871D035BE3C4E402791133F297762C049D2258B173F4E402991133FA97662C0A75ECF35DE404E404E1469940E7662C088F7CE357A404E4001030000000100000028000000BD52BEE93B0163C0670AD035DA2C4E4020036994F80163C08471D0357E2C4E407D256994540263C0D8FD79E0C42C4E404E146994AE0263C0A35ECF355E2D4E404F146994DE0263C070BF248BF72D4E40C4E06894BC0263C07C71D0353E2E4E408AFA6894350163C01804258BCF2E4E406D05BEE9E00063C0A75ECF351E2F4E406C05BEE9B00063C0D848258B27304E40EA63BEE9B10063C0403CCF3552314E40CA27BEE9BC0063C06CBF248B77324E40244ABEE9A80063C088F7CE357A334E40EA63BEE9610063C0918D258B3F344E406030BEE9AFFF62C0C0107BE0A4354E40BD52BEE98BFF62C00C81CF35AA364E406ABE689460FF62C0A77A248B5F384E40F638BEE912FF62C0A45ECF35DE394E4089FA6894F5FE62C0B77A248B9F3B4E4030D8689459FF62C0E4B2CE35223E4E4068BE689480FE62C043B6D03516414E40D2B568942DFE62C068557BE07C414E40B60B69947BFD62C0F8CB7AE08C414E40545BBEE9EEFC62C0780AD0355A414E40321FBEE949FC62C09CF7CE35BA404E401875BEE9B7FB62C0E548258BA73F4E408BFA689465FB62C0E4B2CE35223E4E4085B3133FD5FB62C0E4B2CE35223E4E4089FA6894D5FB62C0E4B2CE35223E4E4096CF689426FC62C06B0AD0351A3D4E40A5A4689487FC62C02FB6D035963A4E40806CBEE9B4FC62C038D5CE35AE394E40806CBEE914FD62C0F735248BC7384E408D41BEE965FD62C073557BE07C384E4069BE6894C0FD62C0680AD0355A384E40C827BEE93CFE62C034D5CE35EE374E40816CBEE9D4FE62C003CC7AE08C364E406D05BEE950FF62C0B0C5CF3542344E40D5FCBDE96DFF62C07C0AD035DA314E402ED86894E9FE62C0473CCF3512304E40BD52BEE93B0163C0670AD035DA2C4E4001030000000100000037000000FFC66894139165C087427AE01C324E40B70B69941B9065C074557BE0BC314E40816CBEE9248D65C00881CF356A334E40A2A46894278C65C0F816268BAF324E40FFC66894838965C080DB79E0F82C4E40FFC66894838965C070BF248BF72C4E40B07DBEE91A8965C0670AD035DA2B4E402ED86894398765C017B979E06C294E40C5E06894AC8665C0B37A248B1F284E40EA63BEE9218765C0E048258B27284E40BB52BEE96B8865C0908D258B3F274E40C6E06894EC8865C0DF48258BA7274E40040EBEE9B38965C074BF248B77294E403CAD6894BA8B65C044D2258B172C4E40806CBEE9548C65C08471D0357E2C4E40A3A46894978D65C037B6D035D62B4E404E1469942E8F65C0F735248BC72C4E40EA63BEE9419065C0D42CD035E62B4E40535BBEE94E9165C02404258B8F2A4E40D1B568944D9265C0A75ECF35DE294E40F838BEE9329365C060BF248B372A4E408C41BEE9059465C0D0B2CE35222B4E409C16BEE9969565C053D2258BD72D4E4089FA6894F59565C0D893D0354A2E4E40E61C6994C19665C057A3CF35B62E4E404E1469941E9765C0A75ECF351E2F4E4098CF6894869765C02804258B0F304E40CA27BEE90C9865C0F019CF3546324E40D5FCBDE96D9865C088F7CE357A334E406C05BEE9109965C0F035248BC7344E40F2F1689422A065C08471D035BE3E4E401975BEE9D7A165C001CC7AE0CC3F4E4097CF689466A165C007E8CF358E404E408AFA689435A165C0908D258BBF404E406ABE689450A165C0204FD03532424E40BD52BEE95BA165C0FF35248B87434E407E25699454A165C0E719CF35C6444E408AFA689435A165C08071D035FE454E40C827BEE92CA165C0DFB2CE35E2464E402203699438A165C087F7CE35BA474E407E25699434A165C0A05ECF355E484E40D1B56894FDA065C0A95ECF359E484E4068BE6894B0A065C074BF248BB7484E4068BE689470A065C097F7CE35FA484E402003699418A065C08C71D0357E494E402DD86894799E65C029B979E0EC4C4E40321FBEE9999D65C0E048258BA74D4E40E61C6994419D65C08471D0353E4B4E409C16BEE9A69D65C0503CCF3552494E40C6E068947C9D65C0730AD0355A464E4001C76894039D65C09F5ECF359E434E40D6FCBDE97D9C65C018B979E06C424E40B60B69940B9C65C09CF7CE35BA414E403AAD6894FA9965C028D5CE352E3D4E40FFC66894139165C087427AE01C324E4001030000000100000022000000311FBEE9194362C0C02CD035663D4E4039AD68946A4962C058A3CF35363A4E40826CBEE9A44A62C0AFC5CF35823B4E40C5E068942C4A62C060A3CF35363F4E4022036994C84962C00CCC7AE04C414E403AAD68942A4962C05FBF248B37424E401875BEE9D74362C07771D0357E424E403BAD6894FA4262C007CC7AE04C434E40826CBEE9344362C00C81CF35AA434E40341FBEE9D94362C0E093D0350A454E40A05D133F174162C054A3CF3576474E404E1469945E3E62C0A95ECF359E484E404E1469945E3E62C08C71D0357E494E40C6E068949C3E62C091427AE0DC494E408D41BEE9C53E62C010E8CF354E4A4E4098CF6894063F62C08471D0353E4B4E40AE7DBEE97A3B62C070557BE03C4C4E4020036994C83962C053D2258B974D4E40B3C4133F3B3862C094F7CE357A504E404D146994FE3762C0FF35248B874F4E407D256994A43862C0D3B2CE35224E4E40FB7F133FE33862C098427AE0DC4D4E40826CBEE9443862C0D893D0350A4D4E404D146994FE3762C077557BE0FC4C4E408F41BEE9353862C037D5CE35EE4B4E40030EBEE9733862C0D32CD035264B4E40CE6E133FBD3862C0975ECF359E4A4E408E41BEE9153962C0E093D0354A4A4E4085B3133FE53B62C0AC5ECF359E454E40C827BEE93C3D62C05CA3CF35B6444E4050146994CE3E62C018B979E06C424E401875BEE9774062C0BF107BE024414E40816CBEE9044262C0978D258B7F3E4E40311FBEE9194362C0C02CD035663D4E400103000000010000000F000000EA63BEE9B1A165C08C427AE0DC4F4E4050146994DEA165C0F019CF35864F4E40F638BEE932A265C0C82CD035E64F4E408F41BEE955A365C0DF93D0358A524E40F1F16894A2A365C030B6D03596534E4068BE689490A365C0DCFD79E004554E405AE96894FFA265C0D7FD79E004574E40B60B69944BA265C033B6D035D6574E405CE96894FFA165C0700AD035DA564E40C827BEE9FCA165C064A3CF35B6554E40525BBEE9EEA165C0B47A248B5F544E4050146994FEA165C02FD5CE35EE524E40515BBEE90EA265C08871D0353E524E40BC52BEE9BBA165C05CA3CF35B6504E40EA63BEE9B1A165C08C427AE0DC4F4E400103000000010000001F000000F638BEE9026D62C0B47A248B1F594E40FA7F133F536C62C03CB6D03516564E403CAD6894FA6B62C0780AD0351A554E401875BEE9A76B62C0E493D0354A554E40B4C4133F4B6B62C07771D0353E564E40264ABEE9D86A62C04C877AE0F4564E40050EBEE9636A62C0BF2CD03566574E40EA63BEE9016A62C017E8CF358E574E4098CF6894666A62C0A85ECF351E544E40525BBEE9DE6A62C0DCB2CE35A2524E40F838BEE9826B62C07F71D0357E524E40264ABEE9686C62C0780AD0351A534E40826CBEE9E46C62C08071D035FE524E4068BE6894606E62C038D5CE35AE514E40806CBEE9446F62C088427AE05C514E406C05BEE9C06E62C06F557BE0FC524E40515BBEE98E6E62C0707479E0D4534E4084B3133F656E62C06F0AD035DA544E40B2C4133F2B6F62C0B77A248B9F544E40C927BEE9EC6F62C01BE8CF350E544E40A05D133F976F62C0B8107BE0A4544E4084B3133F656E62C094F7CE35BA554E40321FBEE9596E62C00381CF352A574E40F2F16894926E62C0DC93D0350A584E40C5E06894EC6E62C028B979E06C584E40806CBEE9446F62C040D2258B57584E40BB52BEE9EB6E62C0780AD0355A594E4022036994B86D62C013E8CF350E5B4E4087B3133F756D62C0C4C5CF35825A4E401775BEE9376D62C098427AE0DC594E40F638BEE9026D62C0B47A248B1F594E400103000000010000001C0000003AAD6894FA7D62C0E893D0354A5D4E40AE7DBEE9BA7D62C017B979E0EC5B4E40C6E068949C7D62C039D5CE35AE5D4E40C4E068946C7D62C033D5CE35EE5E4E40CD6E133F1D7D62C044B6D035565F4E40FC7F133F337C62C0DCB2CE35A25D4E40EA63BEE9B17B62C02CB979E02C5C4E409F5D133F477B62C057A3CF35765A4E40B4C4133F1B7B62C05F7479E0D4584E406D05BEE9707B62C05BA3CF35F6574E40F638BEE9827D62C017E8CF358E574E40B4C4133F8B7D62C0D32CD03526574E409A16BEE9967D62C003CC7AE04C564E40826CBEE9B47D62C0C0107BE064554E40F638BEE9F27D62C06F0AD035DA544E406C05BEE9207E62C0D8B2CE3522554E406D05BEE9F07E62C0677479E014574E40040EBEE9638062C007CC7AE0CC5C4E40040EBEE9D37F62C09B427AE09C5D4E40F4F16894527F62C017B979E0EC5C4E40244ABEE9D87E62C099F7CE35BA5B4E40F4F16894627E62C013E8CF350E5B4E4085B3133FE57E62C035D5CE35EE5D4E40806CBEE9047F62C04C3CCF35925F4E40B4C4133FBB7E62C0F8CB7AE04C604E406C05BEE9607E62C043B6D035D65F4E40234ABEE9287E62C06BBF248BB75E4E403AAD6894FA7D62C0E893D0354A5D4E4001030000000100000017000000F738BEE9728362C06F0AD035DA544E40D5FCBDE9FD8362C0E4FD79E044534E40545BBEE97E8462C0F035248B07534E409B16BEE9F68462C057A3CF35B6534E4086B3133F658562C06F0AD035DA544E408AFA6894658562C06F0AD035DA544E402ED86894398662C090F7CE353A574E40C5E068941C8762C0D8B2CE35625A4E40C927BEE95C8762C0E448258B675D4E403CAD68944A8662C044B6D035565F4E408D41BEE9C58662C0F419CF35C6604E40EB63BEE9F18662C0F880CF352A614E40040EBEE9138562C0D0B2CE35E2614E408BFA6894858462C0F880CF352A614E4022036994F88362C0BB107BE024604E40501469948E8362C090F7CE357A5E4E4089FA6894858362C048D2258BD75C4E40AE7DBEE91A8462C017B979E0EC5B4E40AE7DBEE91A8462C013E8CF350E5B4E40806CBEE9748362C04CD2258BD75A4E40254ABEE9288362C0304FD03532594E40C4E068942C8362C03CD5CE35EE564E40F738BEE9728362C06F0AD035DA544E400103000000010000000E000000A4FF26C0825762C05797BF2E42684E409FF9B2A07F5862C040246E7BA6664E4062699D747F5962C0B0C2420129674E40622546CCF55962C0C829BB7FBD684E405FBBD9F13F5A62C0D4B3949EBC6B4E40F1756C46CE5962C0A9449FF7556D4E4024DC6856CF5862C027D7F249B56D4E400FEFBC315D5862C098247A86216F4E40A6E91A305F5862C0AF3342428B704E40AF994BC3A35762C0E0369A3D7F6F4E407E60DCADCF5662C03F8BD159376D4E4071EFCFAF875662C088164444746B4E40DC4D0DEDF95662C031352EC8086A4E40A4FF26C0825762C05797BF2E42684E400103000000010000000F000000B2C4133F2B5962C00081CF352A734E402891133FC95862C058A3CF35F6714E404E146994CE5862C0988D258B7F714E40EEAA133FF25862C0F8647AE068714E408AFA6894155962C0A7A97AE000714E40A2A46894475962C0A7A97AE000714E40EB63BEE9615962C043207AE090714E40BE99133F6C5962C01704258B0F724E40C6E06894AC5962C0F735248B07724E406ABE6894205A62C0F0647AE028724E40F838BEE9325A62C03FD2258BD7724E404E1469940E5A62C08326258B9B724E40F3F16894D25962C0C0E1248BC3724E40FC7F133FB35962C03F207AE010734E40B2C4133F2B5962C00081CF352A734E400103000000010000003A000000525BBEE95E6462C0BCC5CF3542744E402A91133F596462C0A95ECF355E734E406C05BEE9106462C0888D258B7F734E4068BE6894D06362C017B979E0EC734E407C256994D46362C058A3CF35F6724E40264ABEE9386462C0A87A248B9F714E405F30BEE90F6562C02704258B0F704E40F838BEE9E26462C02004258BCF6F4E408E41BEE9356462C0DCB2CE3562704E407D256994E46362C0AD5ECF35DE704E401875BEE9976362C050877AE034714E40FC7F133F736362C0737479E094714E4086B3133F456362C0DC48258BE7724E40B4C4133F1B6362C0DF48258B27734E40FB7F133F036362C00717268BEF724E406C05BEE9806262C0E119CF3546724E40050EBEE9736262C0E719CF3586714E402A91133FA96262C02C4FD03572704E40806CBEE9546362C0A05ECF35DE6E4E401775BEE9776462C0CFFD79E0846D4E40E963BEE9516562C02FD5CE356E6D4E4020036994D86562C0700AD035DA6D4E409C16BEE9166662C04FA3CF35766E4E404E146994EE6562C0E493D0354A6F4E40301FBEE9D96562C047D2258B17704E406130BEE90F6662C0413CCF3552704E401875BEE9B76662C033D5CE352E704E40C4E06894EC6662C0E0FD79E044704E403AAD68941A6762C018E8CF350E704E409A16BEE9066762C0E793D0358A6F4E402A91133F596762C0677479E0146F4E40525BBEE91E6862C09C5ECF351E6F4E406030BEE9EF6962C03BD5CE35EE6F4E407C256994346A62C0DF93D0354A704E40F838BEE9326A62C048D2258B97704E40545BBEE9EE6962C08371D035BE704E408C41BEE9B56962C078557BE0FC704E4056A2133F8F6962C079557BE07C714E4022036994486962C05F7479E0D4714E4068BE6894E06862C034D5CE35AE714E40040EBEE9836862C0403CCF35D2714E40F638BEE9326862C0E019CF35C6724E407C256994E46762C02CD5CE356E734E408E41BEE9756762C00CCC7AE0CC734E40F638BEE9426762C0503CCF3512744E40FA7F133FE36662C0D0B2CE3522744E4050146994CE6662C057A3CF3576734E408F41BEE9F56662C0E3FD79E084724E404E146994DE6662C070557BE03C724E40040EBEE9936662C06F7479E014734E4020036994386662C08071D035BE734E403AAD6894CA6562C0750AD0359A734E4068BE6894A06562C0244FD03532734E40F638BEE9C26562C0CFFD79E0C4724E4056A2133FAF6562C087F7CE357A724E4068BE6894606562C07F71D0353E724E40D7FCBDE98D6462C0B77A248B5F744E40525BBEE95E6462C0BCC5CF3542744E400103000000010000001D0000009C16BEE9068162C043D2258B17774E409B16BEE9F67E62C0F880CF35EA734E4022036994187E62C0DCB2CE3562714E4056A2133F2F7E62C0FF35248B476E4E40B4C4133F6B7D62C007E8CF354E6B4E40EB63BEE9317D62C0D048258BA7694E40B07DBEE94A7D62C06F7479E014684E40BD52BEE9BB7D62C050A3CF3536674E40CA27BEE92C7E62C063A3CF35F6674E409A16BEE9967E62C08C71D0353E694E406D05BEE9F07E62C0E448258BE7694E4089FA6894458062C038D5CE35EE654E40F838BEE9C28062C0E019CF3546654E40B5C4133FCB8262C00981CF356A664E40B90B6994CB8262C00981CF356A664E4096CF6894B68362C043B6D03516664E40E61C6994118462C087F7CE357A664E40F638BEE9528462C06F7479E014684E406C05BEE9608462C0E719CF35C6694E40B80B69944B8462C09C427AE01C6B4E40B07DBEE92A8462C0A45ECF355E6C4E40AE7DBEE91A8462C040B6D035D66D4E4068BE6894908362C0413CCF3552704E40B80B69949B8262C030D5CE352E724E40C4E068943C8262C08071D035BE734E40F738BEE9728362C06C0AD0355A754E40F738BEE9728362C0B0107BE024764E40CA27BEE9DC8262C0403CCF3512764E409C16BEE9068162C043D2258B17774E400103000000010000000C0000001675BEE947C762C0F835248B47904E40CA27BEE97CC862C008CC7AE0CC8F4E4022036994D8C862C00BE8CF354E904E40EA63BEE951C862C0DF93D0350A914E40244ABEE9D8C762C0284FD035B2924E403AAD68946AC762C0700AD035DA944E40D5FCBDE92DC762C01F04258BCF954E4058A2133FBFC662C0D42CD03526964E40A4A46894E7C562C00FE8CF354E964E405F30BEE9AFC562C0D748258BA7944E40A3A4689447C662C02FB6D03516924E401675BEE947C762C0F835248B47904E400103000000010000000C0000001775BEE977BF64C054A3CF3536F04E40BA52BEE97BBF64C0C9777BE088EF4E40C927BEE9DCBF64C02B04258BCFEF4E408AFA689435C064C0F980CF356AF14E40BD52BEE93BC064C028D5CE35EEF24E40CE6E133F9DBF64C0E1FD79E0C4F94E40501469944EBF64C077DB79E0F8FB4E408AFA689405BF64C0E8AF258B8BFC4E40CE6E133FFDBE64C0A45ECF359EFB4E409188133F86BF64C08BDB79E078F64E40B07DBEE9AABF64C058EE7AE058F34E401775BEE977BF64C054A3CF3536F04E4001030000000100000016000000D1B568944DBE64C0D793D0354A034F402003699438BE64C0F8CB7AE04C024F407D25699454BE64C0EB93D0350A024F40B80B69949BBE64C04C3CCF3592024F40806CBEE9D4BE64C0D893D035CA024F40B70B6994FBBE64C0CB2CD035A6024F403CAD68942ABF64C0CF2CD03566024F4068BE689460BF64C08F8D258BFF014F40AF7DBEE98ABF64C071BF248BF7014F401875BEE9A7BF64C0F8CB7AE04C024F40EA63BEE9F1BF64C0A45ECF355E024F406ABE689450C064C00417268BEF024F40A4A4689447C064C0E0FD79E0C4044F40BD52BEE9DBBF64C02B4FD035F2064F40030EBEE973BF64C00817268B6F084F40B70B69941BBF64C070557BE03C094F40311FBEE9E9BE64C0C3C5CF3502094F401875BEE917BF64C0985ECF359E074F40CA27BEE93CBF64C054877AE0B4054F4021036994C8BE64C063A3CF3536044F40D3B568945DBE64C00336248BC7034F40D1B568944DBE64C0D793D0354A034F40010300000001000000090000001875BEE9679D64C0DC48258B67464F40A4A46894C79D64C038B6D03516464F409288133F369E64C09FA97AE040464F405CE968947F9E64C0FCAF258BCB464F4021036994989E64C0B4A97AE080474F40331FBEE9C99D64C060BF248B37484F406577133F409D64C0274FD035F2474F401875BEE9279D64C0740AD0351A474F401875BEE9679D64C0DC48258B67464F400103000000010000000B000000FC7F133FF39B64C025B979E0AC454F406477133F509C64C0F9647AE068454F40BF99133FCC9C64C07726258B9B454F40FA7F133F239D64C0C9777BE008464F40040EBEE9439D64C0DF48258BA7464F40D0B56894ED9C64C0DF48258BA7474F40535BBEE9CE9C64C0A85ECF355E484F40826CBEE9A49C64C0E893D035CA484F405CE968944F9C64C010337BE0B0484F40321FBEE9F99B64C0DC777BE048474F40FC7F133FF39B64C025B979E0AC454F4001030000000100000005000000F638BEE902A064C08071D0357E4E4F40301FBEE989A064C00CCC7AE08C4D4F40E2D5133F11A164C05C58248B934E4F404D1469945EA064C0F4AF258B4B4F4F40F638BEE902A064C08071D0357E4E4F400103000000010000000D000000E0D5133FB19C64C08526258BDB4D4F409388133FF69C64C08FF7CE35FA4C4F402891133FC99D64C043B6D035564E4F40FC7F133F239E64C0D7777BE0884F4F40F2F16894329E64C0F4AF258B4B504F409F5D133F479E64C0C72CD035A6504F4020036994089E64C04FD2258B57514F4097CF6894A69D64C0B7C5CF3502514F401BBC133F389D64C06BBF248BF7504F40C099133F0C9D64C0C72CD035A6504F4021036994089D64C0BF9679E0604F4F403CAD68940A9D64C0E8647AE0A84E4F40E0D5133FB19C64C08526258BDB4D4F4001030000000100000007000000B80B69947B9B64C081DB79E038524F405CE968943F9B64C0F4AF258B4B4F4F40F2F16894929B64C03FB6D035D64F4F40EDAA133FF29B64C017B979E02C504F40ECAA133F129C64C0C02CD03566514F40D7FCBDE9FD9B64C00881CF356A524F40B80B69947B9B64C081DB79E038524F400103000000010000000A000000806CBEE9249264C027B979E0EC854F405DE96894AF9264C0D8B2CE3562854F4068BE6894309364C089F7CE357A854F40020EBEE9939364C088F7CE35FA854F40EB63BEE9919364C0DF48258B27874F408F41BEE9159364C04FD2258B17884F401675BEE9C79264C09C8D258B3F884F401F036994789264C04FD2258B17884F4097CF6894069264C0204FD03532874F40806CBEE9249264C027B979E0EC854F400103000000010000000C000000BA0C22F93A8C64C02B492121EE854F40A0EADD733E8C64C05021500A2E844F40448CCE946E8D64C05FE33490A3844F40F1D8CEAB858E64C0282C2127A5854F40FC56ADAAC98F64C0E05236684C854F407F746C95649064C0137C795FA7854F404EE50AA8CD9064C06F7196D149874F40BFEE7531F18F64C078127D502D884F40E66E43312E8F64C0ABE71A96E1884F40961D6A5A508E64C08F3B1BB5AC884F4088C190C30A8D64C0588D494CBE874F40BA0C22F93A8C64C02B492121EE854F400103000000010000000B000000BF99133FFC9264C028B979E0AC8A4F40F538BEE9029464C0F816268B6F894F40F638BEE9929464C0AFA97AE0008A4F40F1F16894729464C030B6D035968B4F40CC6E133F2D9464C05D58248B938C4F406477133F909364C067557BE0BC8D4F40C5E068942C9364C0E793D0358A8D4F406ABE6894C09264C0B47A248B5F8C4F402FD86894B99264C03B207AE0908B4F40EEAA133FE29264C0C4107BE0E48A4F40BF99133FFC9264C028B979E0AC8A4F400103000000010000000A00000096CF6894063965C007E8CF358E854F40D5FCBDE9DD3865C078557BE07C844F40EA63BEE9613B65C0740AD0355A8B4F405CE968942F3C65C0EB19CF35068E4F40EA63BEE9D13D65C02B04258BCF914F40BB52BEE9AB3D65C09FA97AE0C0914F40D1B56894CD3B65C03CB6D035968D4F40B4C4133FEB3965C0EC19CF3546884F401975BEE9473965C094427AE09C864F4096CF6894063965C007E8CF358E854F4001030000000100000006000000F0F16894423065C0DC93D035CAAF4F40576333341C2E65C00F28587988AE4F4021036994A82F65C0607479E014AF4F40816CBEE9643065C047D2258BD7AF4F40D2B56894ED3065C04B3CCF3512B14F40F0F16894423065C0DC93D035CAAF4F40010300000001000000070000001775BEE9374C65C0687479E094A64F403AAD68947A4965C0C1107BE0A49E4F406030BEE9CF4B65C0274FD03532A54F40FEC66894634E65C087427AE09CA94F4097CF6894A65665C03BB6D03596B24F40244ABEE9884F65C0A45ECF351EAC4F401775BEE9374C65C0687479E094A64F40010300000001000000060000005CE96894EF6065C0CF2CD03526B84F409A16BEE9165965C0E493D0354AB44F40826CBEE9345F65C02F4FD03532B74F405DE96894DF6165C007E8CF350EB74F403A83E928556265C03093C848FAB74F405CE96894EF6065C0CF2CD03526B84F4001030000000100000004000000040EBEE9436265C09C5ECF351ECD4F4089FA6894656265C03CB6D03516CD4F40E1D5133FE16265C004CC7AE04CCD4F40040EBEE9436265C09C5ECF351ECD4F4001030000000100000004000000BB52BEE99B6465C00FE8CF354ECE4F40E41C6994E16265C004CC7AE04CCD4F40E70700840B6565C0273D26DB0BCE4F40BB52BEE99B6465C00FE8CF354ECE4F4001030000000100000028000000CA27BEE93C4C64C08071D035BECF4F401675BEE9E74A64C09C5ECF351ECD4F40525BBEE9EE4A64C02CB979E06CCC4F40826CBEE9044B64C08C71D035FECB4F40264ABEE9284B64C058A3CF35B6CB4F401875BEE9574B64C0204FD03572CB4F40806CBEE9744B64C030B6D03516CB4F401975BEE9874B64C06B557BE0BCCA4F404E1469949E4B64C0B0C5CF3582CA4F40A3A46894C74B64C08071D0357ECA4F404F1469942E4B64C08871D035BEC74F405F30BEE91F4B64C0C0C5CF3502C74F405E30BEE97F4B64C0F880CF35EAC54F406030BEE9EF4B64C0A75ECF355EC64F40B07DBEE94A4C64C0B7107BE064C74F403BAD68946A4C64C060A3CF35F6C74F406E05BEE9F04F64C04FA3CF3536C64F40CA27BEE9AC5364C04FA3CF3536C64F406130BEE90F5464C068557BE07CC64F40050EBEE9C35464C03BD5CE35AEC74F40FDC66894B35564C0BF2CD03526C84F4098CF6894F65664C0BC7A248B9FC94F408C41BEE9A55564C0EF19CF3546CE4F4068BE6894505564C02C4FD035F2CE4F40826CBEE9445464C0304FD035B2CF4F40F3F16894E25364C08071D035BECF4F4022036994885364C0B3C5CF3542CF4F401875BEE9475364C018E8CF358ECE4F40E41C6994015364C074557BE03CCE4F40F638BEE9925264C02C4FD035F2CE4F40FEC66894B35264C0284FD03572D04F4050146994CE5164C0A35ECF359ED04F40D7FCBDE96D4F64C0680AD0359ACF4F408D41BEE9C54E64C0607479E0D4CF4F40806CBEE9344E64C04F3CCF3592D04F409C16BEE9F64D64C057A3CF35F6D14F40F638BEE9B24D64C01F4FD03532D24F409916BEE9164D64C03CB6D035D6D14F405DE96894FF4B64C0304FD035B2D04F40CA27BEE93C4C64C08071D035BECF4F40010300000001000000260100008C41BEE9857565C03CD5CE35EEE54F404E146994DE7465C017B979E02CE54F401775BEE9577465C08071D0357EE34F408E41BEE9057465C0A87A248B5FE14F40D6FCBDE95D7465C0F019CF3586E04F407D256994A47465C053877AE0F4DE4F408C41BEE9C57465C0D793D0350ADD4F40D2B56894AD7465C034D5CE352EDB4F40244ABEE9487465C0C82CD035A6D94F40244ABEE9B87365C0F019CF35C6D84F40311FBEE9496E65C018E8CF354ED44F401675BEE9076D65C0354FD03572D24F40C727BEE9BC6D65C0878D258B7FD24F40BD52BEE9FB6E65C047D2258BD7D34F409B16BEE9A66F65C00B17268B2FD44F40FFC66894237065C0A05ECF359ED34F40A3A46894F77065C01BE8CF35CED04F4095CF6894667165C08071D035BECF4F4095CF6894667165C02C4FD035F2CE4F4068BE6894F07065C0533CCF3592CF4F401775BEE9977065C0403CCF3552CF4F407E6CBEE9447065C024B979E0ACCE4F40535BBEE9DE6F65C0473CCF3512CE4F409A16BEE9966F65C02C4FD035F2CD4F40AF7DBEE9FA6A65C0C0C5CF35C2CE4F40525BBEE9EE6965C08071D035BECF4F402ED86894696A65C0730AD0359AD04F402ED86894F96A65C0780AD035DAD04F40F838BEE9226C65C0304FD035B2D04F40F838BEE9226C65C07871D0357ED14F40264ABEE9186565C017E8CF350ECE4F406D05BEE9406565C0E093D035CACD4F40FFC66894636565C02CB979E06CCD4F404D1469947E6565C00B81CF35EACC4F405F30BEE98F6565C07871D0353ECC4F408E41BEE9056465C07871D0353ECC4F401F036994986365C060BF248BF7CB4F4021036994186365C0F319CF35C6CA4F40D2B56894CD6265C08071D0357ECA4F40826CBEE9345F65C0204FD03572CB4F401775BEE9475F65C0DF19CF3506CB4F40B80B69944B5F65C0E0B2CE35E2CA4F40F3F16894525F65C0D793D035CACA4F40EA63BEE9715F65C08071D0357ECA4F40B80B6994FB5D65C028B979E02CC94F406ABE6894705C65C030D5CE35EECA4F40E61C6994E15A65C0677479E094CD4F4069BE6894C05865C028B979E06CCF4F403CAD68941A5765C02804258B4FD34F40040EBEE9335565C0607479E014D64F40D5FCBDE9AD5465C00717268BAFD74F40C827BEE9FC5365C037B6D035D6D54F40E61C6994115365C06CBF248BB7D54F40040EBEE9E34F65C08B427AE09CD94F40D0B568940D4F65C0A87A248B1FDA4F40AF7DBEE91A4E65C010E8CF354EDA4F407D256994B44D65C0E793D0350ADA4F40C4E06894DC4C65C0707479E0D4D84F40826CBEE9744C65C018E8CF358ED84F40525BBEE9CE4A65C0BBC5CF3582D94F40BB52BEE9EB4965C03CD5CE356ED94F40040EBEE9834965C0FD35248B07D94F401775BEE9D74865C0CC2CD03526D74F4096CF6894864865C08971D035BED64F40BD52BEE92B4865C06F557BE07CD64F40B07DBEE9BA4765C00317268BEFD54F4089FA6894054665C01CE8CF35CED14F40244ABEE9584565C0304FD035B2D04F40C727BEE98C4365C0D0FD79E0C4CF4F4001C76894A34265C08471D035BECE4F40816CBEE9244265C008CC7AE00CCC4F40E963BEE9B14165C00781CF352ACA4F401875BEE9974165C0C02CD03526C94F403AAD6894AA4165C0B8C5CF35C2C74F4089FA6894C54165C050D2258B17C74F40B70B6994BB4165C0700AD0359AC64F406030BEE95F4165C09BF7CE35BAC54F40BB52BEE93B4165C044B6D03516C44F40040EBEE9B34165C0D8FD79E004C24F401875BEE9574265C00B81CF35EABF4F407C256994B44265C00817268B2FBE4F407C256994344265C0C0107BE0E4BE4F40FFC66894A34165C0274FD03532BF4F407E256994843E65C01BE8CF358EBE4F4001C76894833C65C0533CCF35D2BB4F406030BEE91F3B65C0D0B2CE35A2BA4F40D1B568942D3865C0C82CD035E6B94F4096CF6894C63865C0A75ECF355EB94F40F838BEE9423A65C00036248B87B94F405CE96894FF3A65C0294FD035F2B84F401975BEE9073965C09CF7CE35BAB74F40264ABEE9083565C0DF19CF3546B84F40CA27BEE91C3365C03F3CCF3552B64F40501469948E3265C0677479E094B44F402FD86894193265C0D1FD79E084B04F4089FA6894953165C054877AE074AE4F406ABE6894B03065C03BD5CE352EAD4F40826CBEE9642F65C068BF248B77AC4F40311FBEE9192E65C004CC7AE08CAC4F409A16BEE9362D65C0D448258BA7AD4F40FEC66894932D65C00C81CF352AAE4F40826CBEE9F42D65C08571D0357EAE4F40B07DBEE96A2A65C094F7CE357AAE4F40040EBEE9532965C07771D035FEAD4F40FFC66894632865C03F877AE0B4AC4F409B16BEE9962665C03FB6D03556A74F402FD86894F92565C03BB6D03596A64F40A5A46894F72365C09CF7CE357AA64F408F41BEE9F52265C018B979E02CA74F405F30BEE93F2265C0E0B2CE3522A94F403CAD68944A2365C045B6D03596AA4F408AFA6894952465C0CC2CD03566AB4F40FFC66894132765C031B6D035D6AB4F40FFC66894132765C03F877AE0B4AC4F405F30BEE93F2265C031B6D035D6AB4F404E1469943E2065C03F877AE0B4AC4F40EA63BEE9C11F65C0C72CD03566AC4F407C256994C41E65C0DF48258B27AB4F40F638BEE9E21665C03BD5CE35EEA74F407C256994F41565C03BB6D03596A64F40050EBEE9631665C043B6D035D6A54F401875BEE9471765C00336248BC7A44F40020EBEE9B31765C071BF248BF7A34F40F3F16894F21665C0B8107BE064A14F40F738BEE9521765C038D5CE35EE9D4F406D05BEE9D01865C0DF19CF3586984F403AAD6894FA1965C0E719CF35C6954F40311FBEE9391B65C04CD2258BD7944F4000C76894731E65C09C8D258B3F954F401775BEE9172065C02704258B4F964F40A1A46894972065C05CA3CF3536974F40E51C6994412165C04B3CCF3512984F4000C76894132965C0543CCF35D2964F40A5A46894972A65C090427AE01C954F4097CF6894362965C0D3FD79E004974F40D7FCBDE97D2865C07F71D0357E974F40C927BEE9FC2565C08071D035FE974F4020036994182565C0F7CB7AE0CC984F40F4F16894A22465C06F0AD0355A9A4F40E863BEE9312965C07B71D035BE984F40C4E068943C2B65C00FE8CF358E964F409A16BEE9362D65C0EC93D0354A934F409C16BEE9C62C65C06B7479E054924F409C16BEE9C62C65C0F835248B87914F405BE968944F2D65C0F716268BAF904F40F738BEE9422E65C07C557BE07C8E4F401875BEE9273065C0204FD035F28C4F40254ABEE9D83065C0274FD035B28B4F408BFA6894253165C01F04258B0F8A4F409916BEE9563165C098F7CE353A894F40244ABEE9383265C0CF2CD035A6864F403BAD68947A3265C06FBF248B37854F406E05BEE9803265C0C02CD035E6824F409A16BEE9463265C040877AE074814F40D0B568945D3165C038D5CE352E7F4F4096CF6894E63165C0E819CF35467E4F40525BBEE91E3365C0F716268BEF7D4F40B80B6994AB3365C051877AE0F47C4F406C05BEE9603465C04CD2258B577A4F401775BEE9C73465C0CC2CD03566794F40E51C6994513565C077557BE0FC784F40EB63BEE9B13665C0503CCF35127B4F4039AD68946A3765C0CFB2CE35A27B4F40D1B568942D3865C06F0AD0359A7B4F40264ABEE9E83765C023B979E06C7D4F408E41BEE9E53765C0908D258BFF7E4F4000C76894133865C00081CF356A804F406ABE6894603865C015E8CF35CE814F40D0B568949D3765C0E893D0350A824F40B07DBEE9EA3665C033D5CE352E834F40EB63BEE9913665C0BF107BE024854F40D5FCBDE9DD3665C04CD2258BD7874F40B90B69941B3765C0E893D0354A884F4097CF6894C63765C06F0AD0359A884F40525BBEE90E3865C02B4FD03532894F408BFA6894D53865C0D793D0354A8C4F4020036994283A65C090F7CE353A904F40D6FCBDE9BD3B65C07B71D0357E924F4068BE6894303F65C090427AE01C954F4068BE6894303F65C0DF48258B27944F402ED86894C94065C049D2258BD7954F4096CF6894464165C05CA3CF3536974F40FFC66894934165C049877AE0B4974F40254ABEE9484265C07C0AD0359A974F408E41BEE9954265C02FB6D03516984F408F41BEE9B54265C030D5CE35EE984F401775BEE9B74265C0D848258BA7994F40816CBEE9C44265C0F880CF352A9A4F408C41BEE9054365C06F0AD0355A9A4F406C05BEE9A04365C040877AE0F4994F402ED86894A94465C0DC48258B27984F40BA52BEE91B4565C0CC2CD035A6974F408D41BEE9E54565C043B6D035D6974F40D2B568948D4765C0F419CF3546994F40F2F16894624865C0CF2CD03566994F40515BBEE92E4865C0EF19CF35C69A4F40816CBEE9D44765C04CD2258B179B4F404E1469946E4765C07771D0353E9B4F40F638BEE9124765C0680AD0351A9C4F40C727BEE9FC4665C023B979E02C9D4F402ED86894E94665C06F0AD0359AA04F409A16BEE9F64665C04BD2258B57A14F40F4F16894224765C0B8107BE0E4A14F40D6FCBDE94D4765C043D2258B17A34F40806CBEE9844765C0D793D0354AA44F409C16BEE9D64765C043B6D035D6A44F40CA27BEE95C4865C0B0C5CF3502A54F40D6FCBDE98D4A65C0C72CD03526A74F40EA63BEE9314D65C0770AD0355AAB4F401875BEE9374E65C093F7CE35FAAD4F408D41BEE9155365C04DD2258B17B34F40A3A46894375565C0334FD035B2B34F40FEC66894535565C07B557BE0FCB34F40F638BEE9625565C087427AE09CB44F40321FBEE9795565C074557BE03CB54F40C4E06894AC5565C0E719CF3586B54F401775BEE9D75865C05F7479E0D4B54F40C4E068947C5965C03F3CCF3552B64F4001C76894D35965C0B9C5CF3502B74F40EA63BEE9515A65C07771D035FEB84F402FD86894995A65C0C82CD035E6B94F40A5A46894075B65C0204FD035B2BA4F408AFA6894655B65C018B979E0ECBA4F40535BBEE9AE6265C0294FD035F2B84F40244ABEE9A86265C0204FD035B2B84F406030BEE99F6265C087F7CE357AB84F4020036994886265C044B6D03516B84F4096CF6894E66365C04C3CCF3552B74F406E05BEE9806465C037D5CE356EB64F40E51C6994016565C037B6D03516B54F406C05BEE9E06565C08C71D0357EB34F409A16BEE9166865C0284FD035B2B24F40020EBEE9136965C04B3CCF3512B14F40BB52BEE94B6965C04B3CCF3512B14F405AE968946F6965C048D2258B57AE4F40A2A46894676A65C054877AE0F4AC4F40D3B568948D6B65C01F4FD03532AC4F40C5E068943C6C65C0770AD0355AAB4F40D6FCBDE90D6D65C0DF93D0354AA94F40545BBEE90E6E65C038D5CE35EEA84F4096CF6894D67165C0D8B2CE35E2AA4F40F538BEE9E27165C0740AD0351AAB4F40F2F16894527265C02B04258B4FAC4F40FFC66894837265C03F877AE0B4AC4F40040EBEE9C37265C097427AE0DCAC4F4020036994987365C03F877AE0B4AC4F4021036994087465C093F7CE35FAAC4F4067BE6894F07465C03CD5CE352EAE4F40D6FCBDE98D7665C0607479E014AF4F40311FBEE9897765C0AC5ECF351EB04F40B07DBEE94A7865C054A3CF35F6B14F40A2A46894477A65C0D893D0358AB84F40D6FCBDE97D7A65C0204FD035B2B94F40AE7DBEE98A7A65C088427AE0DCBB4F406030BEE9EF7A65C0780AD0351ABE4F40CA27BEE91C7B65C097427AE09CBF4F40C6E068943C7B65C094F7CE353AC14F40AF7DBEE94A7B65C060A3CF35B6C24F401775BEE9377B65C0C4107BE0A4C24F4068BE6894107B65C0D793D0350AC34F40244ABEE9E87A65C00417268BAFC34F408BFA6894D57A65C0D7B2CE3562C44F40D2B56894DD7A65C0740AD0351AC54F40D7FCBDE90D7B65C0C0C5CF3502C74F40C4E06894EC7A65C0740AD035DAC94F40254ABEE9C87A65C027B979E0ACCA4F405AE968947F7A65C04FD2258BD7CB4F40AF7DBEE93A7A65C04CD2258B97CC4F4022036994E87965C013E8CF354ECD4F40F738BEE9A27965C00481CF352ACE4F408E41BEE9857965C040D2258B57CF4F40BB52BEE99B7965C0E0B2CE3522D04F409A16BEE9C67965C070557BE0BCD04F4096CF6894E67965C00CCC7AE04CD14F40331FBEE9D97965C057A3CF35F6D14F40D3B568949D7965C07871D0357ED24F40050EBEE9F37865C029D5CE35EED24F4097CF6894A67865C02804258B4FD34F40D3B568940D7865C0938D258BFFD44F4050146994EE7765C0D02CD03566D64F405DE96894FF7765C07F71D035FED74F402DD86894F97765C010E8CF354EDA4F402DD86894497765C0E3FD79E004DE4F40515BBEE90E7765C048D2258B57E04F4068BE6894707765C0A87A248B5FE14F4020036994887765C0D42CD035E6E14F407D256994A47765C06B7479E014E34F40806CBEE9B47765C0D3B2CE3562E44F4021036994A87765C0EF19CF3546E54F40BD52BEE94B7765C0D348258BE7E54F408AFA6894E57665C0F880CF35AAE54F408AFA6894857665C094F7CE353AE54F40311FBEE9397665C0EF19CF3546E54F408C41BEE9857565C03CD5CE35EEE54F40010300000001000000080000008AFA689495C664C0B2D1E71A5B1E50406E05BEE9F0C664C0BEAA3D703E1E5040C6E068944CC764C0D5543D70001F50404CCD133F7EC764C0ECFE3C70821F5040CE6E133FCDC664C0DAE2E71AE11F50404F1469944EC664C0DFE2E71AA11F50401675BEE957C664C09E6AE71A371F50408AFA689495C664C0B2D1E71A5B1E504001030000000100000009000000C4E068948C0165C0BC38E81A5F3D5040806CBEE9840265C0CD7BE71A3D3D504020036994180365C0249EE71AC93D5040D2B56894CD0265C0F049E81AA53E5040254ABEE9180265C00E8292C5073F5040F538BEE9220165C04CAFE71A0F3F5040F638BEE9E20065C09C6AE71AB73E50402ED86894D90065C086C0E71AF53D5040C4E068948C0165C0BC38E81A5F3D50400103000000010000000A0000002DD86894C91C65C09927E81AD96F5040D2B568941D1D65C07CC0E71A556F504000C76894A31D65C0A4433D705A6F50408E41BEE9251E65C09427E81A996F50407E256994741E65C068A492C533705040CA27BEE92C1E65C06E59E71AF1705040E71C6994711D65C084C0E71A35715040D0B568940D1D65C020E992C52B71504001C76894E31C65C0CC7BE71ABD7050402DD86894C91C65C09927E81AD96F50400103000000010000000E0000001F03699478FA64C0F549E81A456F5040C6E06894FCFA64C0800B93C5376F50402003699428FB64C034BA3C708A6F5040C4E06894ACFA64C050AFE71A2F7050402003699438FA64C09827E81A99705040CC6E133FDDF864C09427E81A797150402CD8689409F864C094DC3C70B67150406030BEE99FF764C0C47BE71ABD715040301FBEE9C9F764C06E59E71A717150408AFA689455F864C05E3D92C5EF7050408E41BEE9F5F864C0C87BE71A9D705040264ABEE968F964C0DEE2E71A41705040F638BEE9E2F964C090DC3C70B66F50401F03699478FA64C0F549E81A456F5040010300000001000000110000008E41BEE935F564C03A05E81A0D725040AE7DBEE91AF564C09427E81A797150403AAD68947AF464C0CCC692C57F7150406C05BEE940F664C0205BE81A6B6F5040E51C6994F1F664C0C038E81A3F6F50406ABE689460F764C09027E81AB96F5040254ABEE928F764C0F449E81A857050408AFA689405F764C094DC3C7036715040535BBEE9FEF664C00C8292C5C77150406B05BEE980F664C0021B92C5437250402003699478F564C028E992C5CB7250401DBC133F78F564C030773D70CC72504068BE689420F264C0FA1A92C5437450404F146994CEF164C05E3D92C54F745040FDC6689453F264C02FBA3C70CA73504096CF6894B6F464C0F349E81AA57250408E41BEE935F564C03A05E81A0D72504001030000000100000011000000E71C6994C1E664C03ABA3C706A7A5040B80B69943BE764C04CAFE71A2F7A5040311FBEE9A9E764C06F59E71A317A5040C827BEE96CE764C0C038E81ABF7A50408E41BEE9D5DB64C054AFE71A4F8250406D05BEE980DB64C01E5BE81A8B8250405BE96894DFDA64C034BA3C70CA825040535BBEE9BEDA64C03805E81AAD825040515BBEE99EDB64C036BA3C70CA8150409A16BEE996DF64C05C883D70F27E5040D3B56894DDE064C0D8E2E71A617E5040B80B69947BE364C086C0E71AB57C50409A16BEE906E464C00AF4E71A277C50407C256994F4E364C09427E81A197C5040AE7DBEE92AE464C06859E71AF17B50409C16BEE946E564C0E2E2E71AA17B5040E71C6994C1E664C03ABA3C706A7A5040010300000001000000140000008B41BEE975D764C0986AE71A57845040D4FCBDE99DD964C024E992C54B835040050EBEE973D964C0AED1E71ABB8350402103699468D864C04A213D708E8450405DE968944FCA64C0800B93C5578C5040F3F1689412C964C09C6AE71AD78C5040EFAA133F12C964C09C6AE71AD78C5040C6E06894FCC564C082C0E71A758D504098CF689436C764C01C5BE81AEB8C5040535BBEE9FEC764C09027E81A598C5040D6FCBDE9BDC864C07CC0E71AF58B50401F03699408CA64C05C3D92C5AF8B50404E1469945ECC64C02A9EE71A498A50406D05BEE900CF64C08CDC3C7056895040E71C699491CF64C0A0433D70FA88504097CF689426D064C0A8D1E71A7B8850404F1469947ED164C0ACD1E71ADB875040AD7DBEE91AD364C081C0E71AB5865040264ABEE9F8D564C03C05E81A6D8550408B41BEE975D764C0986AE71A578450400103000000010000000B000000A4A4689417C464C070A492C5738E5040A4A46894B7C464C0A4433D701A8E5040535BBEE9FEC464C0A8D1E71A7B8E5040A4A46894B7C464C06C59E71A118F50407D25699414C464C0AA433D709A8F504083B3133FD5C264C0F049E81A65905040321FBEE9B9C164C0EC49E81AC590504098CF689456C164C0F81A92C5A3905040EB63BEE981C164C04BAFE71A4F905040C4E068944CC364C0249EE71A498F5040A4A4689417C464C070A492C5738E50400103000000010000000D000000CA27BEE9DCBE64C03C05E81AED905040826CBEE954C064C0BBAA3D707E905040F638BEE932C064C080C0E71A159150407C25699474BF64C0C47BE71AFD9150403CAD68940ABF64C09027E81A5992504021036994A8BB64C0168292C5479450401CBC133FA8BB64C0168292C547945040E61C699411BA64C0FA8CE71AE3945040C3E068940CBA64C0F98CE71AA39450406C05BEE9F0BB64C082C0E71A359350408E41BEE9B5BC64C06016E81AD3925040F1F1689432BE64C0AAD1E71A5B915040CA27BEE9DCBE64C03C05E81AED9050400103000000010000000D0000007E25699414B164C0F88CE71A839950404E1469943EB364C0A8D1E71A1B985040AE7DBEE90AB464C01E5BE81A2B9850408D41BEE955B464C0840B93C5F79750402CD86894B9B464C09227E81A999750409A16BEE9C6B564C0C438E81AFF965040030EBEE953B664C092DC3C70D6965040BC52BEE98BB664C000663D7026975040B60B69941BB664C0A4433D70BA97504001C76894A3AF64C03305E81A2D9A5040B80B6994ABAF64C00C8292C5279A504022036994D8AF64C0E7FE3C70029A50407E25699414B164C0F88CE71A83995040010300000001000000050000005B43BAE990AD64C0787DE81AF79A50401A30895FA3AF64C05D8FB1362D9A5040FA7F133F83AF64C0E8FE3C70429A50402003699458AE64C03C05E81ACD9A50405B43BAE990AD64C0787DE81AF79A50400103000000010000000500000096CF689436AC64C0B8AA3D703E9B5040D80C198A89AD64C08B773205F99A50409916BEE9F6AA64C06016E81AF39B5040B70B69941BAC64C06816E81A739B504096CF689436AC64C0B8AA3D703E9B504001030000000100000004000000FEC6689453AA64C0583D92C52F9C50405CEEF8CEF6AA64C0C7B4ED23F39B5040EA63BEE971AA64C03805E81A2D9C5040FEC6689453AA64C0583D92C52F9C504001030000000100000018000000F638BEE962A864C050AFE71A6F9C5040EAF77F6644AA64C0F0A7947E329C50405BB3C9D258A164C0BC67BECC959F5040CE6E133F6D9864C09627E81AF9A250406ABE6894109864C0209EE71AE9A25040545BBEE9DE9764C0BAAA3D709EA25040FFC66894439864C050AFE71A6FA25040D6FCBDE9AD9864C07C0B93C557A250406ABE6894E09864C086C0E71A35A250405CE968940F9964C01E5BE81A0BA25040FFC66894739964C0CA7BE71ADDA15040C5E068949C9A64C06CA492C5D3A15040806CBEE9049B64C07CC0E71A95A150409A16BEE9369B64C0E2E2E71A21A1504001C76894739B64C0B0D1E71ABBA0504098CF6894969B64C06EA492C593A05040B07DBEE9BA9B64C06816E81A73A050406E05BEE9409C64C056AFE71A4FA05040C827BEE9BC9D64C056AFE71A4FA050406B05BEE900A264C06416E81AB39E50408AFA6894F5A364C090DC3C70969E5040F738BEE982A464C06816E81A539E504050146994CEA564C09827E81A599D5040F638BEE962A864C050AFE71A6F9C504001030000000100000010000000EA63BEE9916564C03405E81A0D645140040EBEE9A36564C0C87BE71ADD5E514020036994E86564C07CC0E71AB5605140CA27BEE90C6664C04C213D708E625140D4FCBDE91D6664C0A0433D70FA6251404E146994EE6564C048213D700E6751404ACD133FEE6564C048213D700E675140D5FCBDE97D6564C09A27E81A196A51407C256994E46464C0209EE71A696B5140BB52BEE95B6464C04B213D70AE6B5140E61C6994216464C0B8AA3D709E6B5140E61C6994E16464C0ECFE3C70C26A51405CE968945F6564C0C47BE71ADD685140F638BEE9926564C05C3D92C5AF6651406E05BEE9706564C0B55F92C5FB645140EA63BEE9916564C03405E81A0D64514001030000000100000010000000E2D5133FB1AC61C03605E81A2D6D5140F638BEE952AC61C06416E81A736C514096CF689436AD61C0CEC692C51F6D514058A2133F1FAF61C0DCE2E71A216E5140EA63BEE9B1B261C03405E81A0D715140A15D133FA7B461C062883D70927151407D256994D4B661C0EC49E81AC57251406D05BEE980B861C054AFE71A2F735140BC52BEE99BB961C0209EE71AC97351407C25699474BB61C034BA3C702A7451406030BEE9BFBC61C0185BE81ACB74514086B3133FE5B961C0A6433D709A7451403AAD6894EAB061C0209EE71AA9705140321FBEE989AD61C06A16E81A336E5140826CBEE914AD61C0F0FE3C70C26D5140E2D5133FB1AC61C03605E81A2D6D51400103000000010000000A000000D6FCBDE90D6364C054AFE71ACF6E5140E61C6994216464C03B05E81AED6C5140244ABEE9C86164C0CA7BE71A7D7351409C16BEE9F66064C04C213D704E7551405CE96894FF5F64C0F449E81AC57651403CAD6894EA5A64C06616E81AD37B51401675BEE9175C64C07CC0E71AB579514068BE6894606064C0F649E81A457551402DD86894596164C03805E81A4D735140D6FCBDE90D6364C054AFE71ACF6E51400103000000010000000E0000009C16BEE9965764C09827E81A997E5140D2B56894CD5964C05A883D70B27C5140C927BEE94C5764C0249EE71AE97F51409E5D133F775664C02A9EE71A69815140816CBEE9745664C03C9392C56D815140C827BEE9AC5564C06416E81AD38251402ED86894895464C058883D7032845140301FBEE9395364C03A05E81A4D855140B07DBEE9EA5164C034BA3C70EA85514050146994CE5164C00AF4E71AC7855140806CBEE9645364C04E213D706E845140C6E068949C5564C0FA8CE71AE38151406C05BEE9605664C0BA5F92C5FB7F51409C16BEE9965764C09827E81A997E51400103000000010000000A0000006ABE6894405164C008F4E71A47875140B07DBEE9EA5164C01F9EE71AC9865140AE7DBEE91A5064C062883D70528A5140E1D5133F814F64C080C0E71A158B51405CE96894DF4964C06859E71A718F5140806CBEE9344564C0FB653D70469151405F30BEE9FF4A64C0840B93C5178E514096CF6894B64F64C09827E81AD98951406E05BEE9505064C0F68CE71A038951406ABE6894405164C008F4E71A4787514001030000000100000008000000B80B69946B3C64C008F4E71AA7965140F638BEE9A23164C0C47BE71ADD9451405DE96894CF3A64C0A0433D70FA9551405E30BEE92F3D64C0DEE2E71AC19551407D256994443F64C0A8433D70FA935140311FBEE9093F64C054AFE71A8F945140D2B568942D3E64C0B05F92C5BB955140B80B69946B3C64C008F4E71AA7965140010300000001000000120000005DE968948FA762C0209EE71A69A35140FFC66894D39F62C028E992C58B9F51401875BEE9179F62C0A8D1E71A9B9F51406130BEE92F9E62C0F88CE71A03A0514020036994889D62C0860B93C517A051404E1469949E9C62C0F049E81AC59F5140AE7DBEE93A9A62C07059E71A119E51404E1469944E9A62C0BE38E81AFF9D51406E05BEE9309D62C0F249E81A459F51402ED86894699E62C0C638E81A1F9F5140806CBEE9549F62C009F4E71AC79E514068BE689480A062C0289EE71A099F51408AFA689435A662C0CA7BE71A5DA25140020EBEE923A862C0205BE81AEBA251408BFA689405AA62C0C238E81ADFA25140264ABEE9B8A962C0543D92C50FA351406ABE6894E0A862C0C238E81A5FA351405DE968948FA762C0209EE71A69A351400103000000010000009D230000331FBEE9E98D63C0F81A92C503DA51404E146994BE8C63C052AFE71A2FD951407B256994E48B63C09B6AE71A57D85140D4FCBDE9CD8C63C0148292C527D85140BA52BEE9AB8E63C036BA3C704AD951406ABE6894A08F63C0986AE71A37D95140AE7DBEE9AA9163C0B05F92C55BD75140A3A46894D79263C054AFE71AEFD65140A2A46894579363C0E8FE3C70A2D651405CE968944F9263C004F4E71A87D551404E146994CE9163C0148292C5C7D451401975BEE9979163C004663D70C6D3514022036994189163C080C0E71A35D351406C05BEE9E08D63C06816E81AB3D251406ABE6894508E63C0946AE71AB7D151405AE968942F8E63C03605E81A2DD1514089FA6894B58D63C07CC0E71AF5D051408AFA6894958763C0AA433D703AD1514000C76894838463C036BA3C706AD05140D2B568941D8363C0A8433D709ACF514000C76894738363C01C5BE81A8BCE5140C827BEE98C8363C01C5BE81A4BCE51407F6CBEE9E48163C0BB38E81A1FCE5140D4FCBDE95D8163C06B59E71AD1CD51403CAD6894DA8163C08DDC3C7016CD5140C827BEE98C8363C01C5BE81AABCB5140C827BEE98C8363C07259E71A31CB514069BE6894508263C050AFE71A4FCB5140A1A46894178163C072A492C5B3CB51403AAD6894FA7F63C06816E81A73CC5140F2F16894127F63C0B4AA3D709ECD5140A4A46894B77E63C07F0B93C5F7CD5140C5E068943C7E63C0AA433D701ACE514067BE6894D07D63C0001B92C5E3CD5140EA63BEE9A17D63C06816E81A33CD51406030BEE94F7D63C06616E81A93CC51407B256994947C63C080C0E71AB5CC51405CE968943F7B63C0205BE81A6BCD51406E05BEE9A07963C0C47BE71A5DCD5140D6FCBDE9FD7363C0C238E81ABFCB5140244ABEE9187363C0DEE2E71AE1CA51402DD86894597263C0C8C692C59FC95140B80B6994CB7163C0F0FE3C7022C851408C41BEE9A57163C080C0E71A75C65140E863BEE9217263C07C0B93C537C551405F30BEE9FF7263C08BDC3C7076C45140AE7DBEE97A7463C038BA3C700AC45140C827BEE9EC7463C0F08CE71AA3C35140EB63BEE9C17563C008F4E71AA7C251404E1469940E7663C0CCC692C57FC251406C05BEE9B07663C068A492C573C25140F838BEE9F27663C09C6AE71A37C251405CE968940F7763C0C4C692C5DFC15140BB52BEE94B7763C080C0E71AB5C051407E256994D47763C0269EE71A49C05140D4FCBDE97D7863C0C8C692C5FFBF5140545BBEE9CE7963C0185BE81ACBBF514001C76894037A63C00B8292C5A7BF5140264ABEE9587A63C048213D700EBF51408AFA6894957A63C01C5BE81AEBBE51404E1469944E8263C086C0E71A55BE5140D2B568941D8363C0DFE2E71A01BE5140321FBEE9598363C0DFE2E71A01BE5140264ABEE9888263C0800B93C597BD514000C76894B38163C0800B93C597BD51403CAD6894EA8063C0C038E81A5FBD51406D05BEE9408063C024E992C54BBC5140F838BEE9828163C0B05F92C57BBB5140040EBEE9A38463C06859E71AB1BB51404F146994FE8563C0CC7BE71AFDBA51405D30BEE9EF8463C05C883D70D2BA51403AAD6894CA8263C06CA492C553BB5140D2B56894CD8163C0CC7BE71AFDBA51405CE968941F8263C0583D92C5AFBA5140D2B568941D8363C0C47BE71A1DBA5140C6E068942C8263C0E8FE3C70C2B95140A3A46894278063C052AFE71A2FBA514096CF6894667F63C0C87BE71A3DB951408C41BEE9D57F63C0F88CE71AC3B851404E1469946E7F63C09E6AE71A17B8514068BE6894807E63C0F08CE71A63B751409A16BEE9167E63C070A492C593B651407B256994847E63C030BA3C702AB65140545BBEE9FE7E63C01F9EE71AE9B551408E41BEE9657F63C03405E81A8DB551402FD86894997F63C06CA492C5D3B45140B90B69948B7F63C03A05E81A2DB451406C05BEE9207F63C020E992C54BB3514095CF6894F67E63C0F449E81AA5B25140EA63BEE9117F63C004663D70E6B15140D6FCBDE94D7F63C0A8D1E71A1BB15140C6E068944C7F63C0B8AA3D709EB051406C05BEE9907D63C04A213D700EB151409B16BEE9167D63C0B05F92C55BB15140A4A46894C77C63C07CC0E71A35B251408F41BEE9357D63C0860B93C597B25140A4A46894877D63C062883D7032B35140FFC66894A37D63C07FC0E71AF5B35140535BBEE96E7D63C06CA492C5D3B4514096CF6894867C63C024E992C58BB55140F2F16894E27963C032BA3C702AB5514000C76894D37863C0DBE2E71A81B551407F6CBEE9047863C00E8292C507B65140D0B568940D7763C000663D7026B651404F1469941E7663C082C0E71AD5B551407E256994147563C0C638E81ABFB45140FEC66894D37463C0249EE71A09B551407E256994B47463C0C438E81A7FB551408C41BEE9C57463C0BCAA3D70BEB551409A16BEE9F67463C06016E81AF3B5514068BE6894207563C056AFE71A6FB65140545BBEE93E7563C0C6C692C5FFB651405AE968944F7563C06416E81A73B7514020036994A87463C048213D708EB75140C927BEE94C7363C0108292C527B651401875BEE9777263C0FA1A92C523B65140B60B69945B7163C06416E81A73B75140B60B69941B7163C0F449E81A25B851405F30BEE90F7163C06416E81AB3B851401F036994287163C0EC49E81AE5B951407D256994247163C0BDAA3D703EBB51404E146994FE7063C0FE653D7046BC5140F4F16894927063C05C3D92C5EFBC51403BAD6894FA6E63C0840B93C577BD5140C827BEE9FC6C63C0185BE81ACBBF5140D3B568947D6C63C052AFE71A2FC0514088FA6894056B63C080C0E71AB5C05140515BBEE99E6A63C004663D7006C151405F30BEE9DF6963C0946AE71AD7C15140244ABEE9786963C0F449E81A05C25140C6E06894CC6863C0F88CE71AA3C15140C4E06894CC6763C06E59E71AD1BF5140F838BEE9F26663C0EE49E81A65BF5140F3F16894226663C04CAFE71AAFBF514001C76894D36563C0593D92C56FC051403AAD6894EA6563C0B05F92C57BC15140B60B69944B6663C008F4E71AA7C25140F838BEE9F26663C0CE7BE71A9DC35140D6FCBDE98D6863C01E5BE81AABC451406C05BEE9406963C0F88CE71A83C55140D0B568949D6863C0840B93C557C6514088FA6894B56663C0BC38E81ADFC75140816CBEE9F46563C0F0FE3C7022C851401675BEE9376563C0205BE81AABC751401875BEE9F76363C000663D70C6C55140D6FCBDE91D6363C0F88CE71A83C55140CA27BEE94C6363C02AE992C5ABC6514068BE6894406363C028E992C5ABC75140BB52BEE95B6363C0860B93C577C85140F2F16894026463C0ECFE3C7002C951405BE968947F6363C0C8C692C59FC9514050146994DE6263C036BA3C70EAC95140AE7DBEE93A6263C052AFE71ACFC951405BE96894AF6163C0A4433D703AC95140E963BEE9616163C0E0E2E71A61C851408D41BEE9756163C01E5BE81ACBC75140D7FCBDE9AD6163C080C0E71A35C751404F146994CE6163C0F48CE71A63C65140F3F16894B26163C0CC7BE71A9DC551408C41BEE9456163C0289EE71A09C45140F2F16894426163C07059E71A91C35140D6FCBDE9BD6163C0F049E81AE5C2514097CF6894C66263C0BCAA3D70FEC15140D6FCBDE91D6363C0ACD1E71A1BC151407E256994146263C006663D70C6C051405DE968943F6163C0C47BE71A1DC15140E763BEE9B16063C07259E71A11C25140525BBEE96E6063C0A0433D701AC451408AFA6894256063C0850B93C557C55140525BBEE90E6063C06A16E81AF3C55140C6E068942C6063C0B45F92C5DBC65140264ABEE9686063C0D8E2E71A41C75140AF7DBEE95A6063C0205BE81A6BC75140311FBEE9995F63C0289EE71AA9C751401A75BEE9175F63C050AFE71AAFC751401575BEE9675D63C0F08CE71A43C75140826CBEE9045D63C0B45F92C5DBC65140D8FCBDE99D5C63C0840B93C517C651408BFA6894255C63C0EE49E81AA5C55140C3E068948C5B63C01B5BE81A2BC651406E05BEE9E05A63C0B0D1E71A7BC65140C4E06894DC5963C0FB1A92C523C65140525BBEE9CE5863C0CCC692C55FC55140331FBEE9395763C004F4E71A87C35140F838BEE9325463C0F449E81A05C251408D41BEE9755363C07E0B93C557C151407D256994345363C06316E81AD3C05140B80B69941B5363C0108292C507C05140FFC66894435363C0C138E81A7FBF51406030BEE99F5363C06016E81AD3BE51409A16BEE9065463C0BB38E81A3FBE51408BFA6894955463C048213D70CEBD51408F41BEE9B55463C06816E81A53BD51408D41BEE9C55463C0ECFE3C70C2BC5140AE7DBEE9DA5463C024E992C54BBC5140F738BEE9325563C0B05F92C53BBB5140E863BEE9615563C0205BE81AEBBA51406030BEE9BF5563C0F08CE71A83BA51406130BEE9CF5663C07FC0E71AF5B95140C727BEE93C5963C0C67BE71A5DB95140BA0B6994EB5963C0CC7BE71A5DB85140806CBEE9645663C07C0B93C5B7B85140E51C6994A15563C0CEC692C51FB85140D5FCBDE95D5563C00AF4E71AC7B75140F838BEE9325463C070A492C593B65140B90B69942B5463C072A492C553B651403AAD68943A5463C0F449E81A85B55140F838BEE9325463C0FE1A92C543B5514000C76894E35263C06CA492C5D3B45140D6FCBDE93D5163C0C4C692C5DFB45140C827BEE9EC4D63C093DC3C70B6B55140B80B69944B4C63C0BCAA3D70BEB55140030EBEE9E34963C028E992C52BB551403CAD6894AA4863C0205BE81A6BB45140C727BEE9EC4763C0C438E81A1FB351409B16BEE9364863C0DFE2E71A81B2514050146994EE4763C06016E81A13B25140535BBEE95E4763C06859E71AD1B1514089FA6894D54663C0B1D1E71ABBB15140525BBEE97E4563C002663D7006B251406C05BEE9304463C0F449E81AA5B25140234ABEE9584163C0AA433D705AB551401875BEE9873F63C068A492C533B6514088FA6894153E63C07259E71A71B851408E41BEE9653D63C0C87BE71A3DB951401675BEE9973C63C0C038E81A7FB95140F638BEE9723063C0F88CE71AC3B85140D6FCBDE95D2E63C06E59E71A91B95140A4A46894272C63C0ACD1E71A9BB95140AE7DBEE96A2B63C008F4E71AC7B95140D2B56894AD2963C050AFE71A6FBB51404E1469942E2863C058883D70B2BB514096CF6894462563C0F0FE3C7062BB5140F738BEE9C22463C050AFE71A2FBB5140F2F16894322463C05B3D92C54FBA5140545BBEE9BE2363C0C47BE71A1DBA5140B80B69946B2363C0185BE81A0BBA514098CF6894C62263C0C038E81ABFB95140C827BEE96C2263C03405E81AADB951402FD86894392263C0185BE81ACBB951405DE96894AF2163C08EDC3C7056BA514089FA6894552163C0F08CE71A83BA5140806CBEE9941E63C0C47BE71A1DBA51403AAD68942A1E63C06C59E71AD1B95140D2B56894ED1D63C0CCC692C51FB9514095CF6894B61D63C06859E71A51B85140C4E068945C1D63C01E5BE81AABB7514098CF6894E61C63C0225BE81A4BB75140501469944E1C63C0ACD1E71AFBB65140F838BEE9B21B63C09827E81AD9B65140EA63BEE9311B63C0021B92C503B7514097CF6894E61A63C048213D708EB75140F2F16894D21A63C0148292C527B851401F036994A81A63C0C438E81A9FB851403AAD68941A1A63C0F88CE71AC3B851402ED86894D91963C06859E71A91B85140E71C6994911963C0FE1A92C523B85140321FBEE9191963C0ACD1E71A3BB75140F638BEE9C21863C0F48CE71AC3B65140A2A46894E71763C0AED1E71AFBB5514068BE6894E01663C026E992C58BB45140C827BEE94C1663C04C213D708EB45140321FBEE9091563C0FA1A92C523B65140321FBEE9891563C0936AE71A77B751408F41BEE9351663C0CEC692C51FB85140F838BEE9021763C0800B93C557B851408E41BEE9E51763C0CC7BE71A5DB85140C827BEE9CC1663C0B85F92C5FBB85140A4A46894771163C03805E81ACDB85140AD7DBEE97A0A63C0986AE71AD7B65140040EBEE9030763C0A4433D705AB45140040EBEE9030763C0C038E81AFFB351408E41BEE9C50863C06A16E81A33B35140010EBEE9030C63C068A492C5F3AF5140331FBEE9C90D63C092DC3C7096AF5140331FBEE9C90D63C0B2D1E71A1BAF51402CD86894490D63C01E5BE81ACBAE51403AAD68943A0D63C0986AE71A37AE5140B90B69947B0D63C004F4E71AA7AD514020036994E80D63C0FC653D7066AD5140321FBEE9490F63C004F4E71A27AD51409C16BEE9061063C0CAC692C5BFAC5140FEC66894731063C09E6AE71A17AC5140B07DBEE94A1063C0C47BE71A7DAA5140D5FCBDE96D0F63C06416E81A13A951408AFA6894550E63C06B59E71A11A85140BC52BEE91B0863C0BCAA3D705EA65140A4A46894F70463C0AED1E71A9BA65140F4F16894520363C058883D7052A6514021036994680263C04FAFE71A0FA551406C05BEE9700363C028E992C5CBA451408D41BEE9550563C0289EE71A49A55140AE7DBEE95A0D63C03805E81A8DA55140D3B568949D0E63C0B2D1E71A3BA55140C827BEE98C1063C04CAFE71AEFA551406ABE6894701163C0F049E81AC5A55140040EBEE9931263C050AFE71A4FA55140BA0B69949B1363C0C038E81A9FA45140331FBEE9291463C0C438E81ABFA351409C16BEE9C61363C062883D7092A351404E146994BE1263C0C438E81ABFA35140F838BEE9521263C0D8E2E71AA1A3514000C76894831163C04CAFE71A0FA35140AD7DBEE91A1163C0C238E81ADFA25140D6FCBDE93D1063C000663D70E6A25140244ABEE9980E63C06A16E81A93A35140F738BEE902FF62C080C0E71A95A451402003699428FB62C0C438E81ABFA35140826CBEE954F862C0EC49E81A45A451409A16BEE976F762C0C438E81ABFA351408E41BEE9F5F762C0EC49E81A85A35140D4FCBDE95DF862C082C0E71A15A351401875BEE917F962C0F08CE71AC3A15140040EBEE9B3F962C06816E81A33A151405F30BEE91FFB62C09027E81A79A1514089FA6894D5FB62C0E2E2E71A21A15140E41C699421FB62C0CCC692C59FA05140AD7DBEE94AF962C005F4E71A27A05140C4E068945CFC62C0205BE81A8B9F51405BE968942FFE62C0C4C692C5BF9E514030D8689459FF62C0860B93C5B79C51406E05BEE990F762C0E0E2E71AE19B51402003699488EE62C07C0B93C5179C5140C827BEE90CED62C05C883D70529B5140A3A4689447EB62C036BA3C704A9B5140CA27BEE99CEA62C0C8C692C5BF9A5140B70B69941BEA62C04CAFE71A2F9A5140B60B6994EBE862C084C0E71A95995140B70B6994CBE762C0FC653D7046985140CA27BEE91CE762C02AE992C50B985140AF7DBEE9AAE562C048213D704E985140AF7DBEE9AAE562C0128292C5C79851404F1469945EE662C09A6AE71AB79951404E146994AEE662C0269EE71A099B51404F1469947EE662C086C0E71A359C51405E30BEE9AFE562C0860B93C5B79C5140826CBEE954DF62C06E59E71A319D5140E863BEE921DF62C092DC3C70569D51406E05BEE9B0DE62C006663D70E69D51406030BEE96FDE62C07059E71A119E5140264ABEE998DB62C07059E71A119E5140B90B69945BDB62C0C47BE71A3D9E514020036994E8DA62C0001B92C5C39E5140244ABEE9B8DA62C00CF4E71AE79E51405F30BEE9FFD962C0205BE81ACB9E514068BE689480D862C09427E81A399E51401775BEE9D7D762C0E2E2E71A819E5140F838BEE9C2D862C0289EE71A099F51401875BEE927D962C0E0E2E71A819F51407C25699464D962C092DC3C7036A051405CE96894CFD362C0543D92C5AFA05140C827BEE97CD362C0BCAA3D709EA05140E863BEE9E1D262C0185BE81A4BA051402DD8689499D262C092DC3C7036A051401875BEE927D262C058883D7052A051402DD8689449D162C0B85F92C5BBA05140331FBEE9D9D062C0543D92C5AFA05140BA0B69946BD062C0CAC692C53FA051402BD8689439D062C0FC1A92C5A39F5140F2F1689412D062C0F88CE71A039F5140F4F16894C2CF62C0E2E2E71A819E5140321FBEE9D9CE62C0946AE71AB79E514068BE689470CD62C0BA5F92C57B9F5140040EBEE923CC62C050AFE71ACF9F5140E71C699491CB62C06CA492C5B39E51405BE96894CFCB62C0269EE71AE99D51408C41BEE955CD62C0820B93C5F79A51408C41BEE955CD62C0108292C5879A51401875BEE947CC62C0DCE2E71AA19A5140264ABEE918C862C01C5BE81A4B9C51406130BEE9CFC362C07C0B93C5579C51402203699478BC62C06C59E71AD1A05140BC52BEE9CBBB62C0F049E81AC5A05140254ABEE9F8B962C0E0E2E71AC19F5140B90B69941BB962C0C438E81ADF9F51406D05BEE930B762C0543D92C5AFA051408AFA689425B262C0543D92C5AFA051408AFA689475B062C080C0E71A75A15140E963BEE9A1AF62C09027E81A79A15140244ABEE9D8AE62C0543D92C5AFA051409A16BEE906AF62C0EAFE3C7042A05140321FBEE939AF62C0BAAA3D70FE9F51407C25699474AF62C0B65F92C5DB9F5140264ABEE9B8AF62C0583D92C5CF9F51401875BEE947AC62C0B4AA3D703E9F5140806CBEE954AB62C0583D92C5CF9F5140301FBEE9C9AB62C092DC3C7036A051408E41BEE905AB62C0EC49E81AA5A05140C6E068946CA162C0C47BE71AFD9D5140E863BEE981A062C0185BE81A6B9D51406D05BEE9C09F62C0860B93C5B79C5140A3A46894579F62C0E0E2E71A219C5140BB52BEE91B9F62C0986AE71AB79B5140D2B56894DD9E62C09027E81A799B5140BD52BEE96B9E62C00C8292C5679B5140BD52BEE95B9D62C06016E81A339C51407C256994E49C62C00CF4E71A479C514039AD68946A9A62C0F649E81AC59A5140A2A46894779962C0108292C5879A5140F2F16894129762C0E8FE3C70029B514097CF6894D69562C0F98CE71AE39A5140FFC66894E39462C0DCE2E71AE199514000C76894839462C084C0E71A9599514021036994C89262C09A27E81A39995140806CBEE9A49162C07FC0E71A95985140816CBEE9949062C0D8E2E71AA1975140EA63BEE9219062C04CAFE71ACF9651401875BEE9079062C0DEE2E71AC19551406D05BEE9609062C0CCC692C55F9451407C256994348C62C0C8C692C5FF9351408F41BEE9E58A62C0CCC692C55F945140C4E068943C8862C05E3D92C5AF9651407F6CBEE9248762C0C438E81AFF965140F638BEE9D28462C0543D92C5CF96514050146994CE8362C01C5BE81A4B965140F638BEE9128262C00B8292C567945140F638BEE9B28162C0FC1A92C523945140545BBEE93E8162C0A8433D70FA935140D6FCBDE9BD8062C0175BE81A0B9451408C41BEE9458062C008F4E71A47945140C4E06894CC7F62C0B45F92C55B9451409E5D133F477F62C0A8433D70FA93514057A2133F7F7F62C0CAC692C57F9351403AAD6894CA7E62C030BA3C704A935140AD7DBEE96A7C62C0A8433D70FA93514085B3133FB57B62C01C5BE81AEB9351401A75BEE9F77A62C044213D70AE935140C927BEE93C7A62C0BAAA3D703E935140545BBEE98E7962C096DC3C7096925140E0D5133FD17962C070A492C553925140AD7DBEE9FA7962C038BA3C700A925140B952BEE93B7A62C0FB653D7046915140535BBEE9EE7962C0108292C5279151409A16BEE9A67962C0A4433D70FA905140FA7F133F637962C0B65F92C5BB9051407E256994247962C06E59E71A7190514022036994687962C0C638E81ABF8F514068BE6894907962C0205BE81A6B8F5140BC52BEE9CB7962C0F0FE3C70228F5140C5E068940C7962C08EDC3C70968E514058A2133FBF7562C084C0E71A958D5140040EBEE9536D62C05C883D70F28C514086B3133F956762C09027E81A998B51401875BEE9676762C0E8FE3C70A28B514097CF6894166762C0001B92C5038C5140F4F16894F26662C06816E81A138C5140826CBEE9C46662C0F449E81AE58B5140D5FCBDE96D6662C0A2433D705A8B51408E41BEE9456662C05E883D70328B514087B3133FF56362C09327E81AB98A51404E1469942E5C62C05E883D70328B5140525BBEE90E5C62C025E992C52B8C51402891133F295B62C0DEE2E71A618C51409E5D133FB75762C050AFE71A4F8C5140CE6E133FDD4D62C03C05E81AAD8B51406E05BEE9604762C0148292C5E78B5140806CBEE9A44262C094DC3C70F68951408E41BEE9753F62C09827E81AD98951401775BEE9F73E62C01C5BE81A0B8A51407C256994143E62C0E8FE3C70A28A51409C16BEE9B63D62C09327E81AB98A5140020EBEE9733C62C0DBE2E71AC1895140C827BEE9EC3B62C0148292C5C78951403AAD68942A3C62C05E883D70328B5140826CBEE9E43A62C09C6AE71AB78A5140D7FCBDE9AD3862C07CC0E71A95885140FA7F133FD33662C0EBFE3C70E28751407C256994F43462C050AFE71A4F86514058A2133F9F3362C054AFE71AAF8551406ABE6894303362C0185BE81A2B855140806CBEE9A43362C07059E71A91845140DFD5133F213362C07059E71A918451404F146994CE3262C07059E71AD184514068BE6894503262C0A4433D707A855140CE6E133FDD3162C038BA3C70CA855140826CBEE9843162C0249EE71AE98551401775BEE9A73062C034BA3C70EA8551401875BEE9073062C0E1E2E71A81855140030EBEE9132F62C06016E81AB38351407C256994942E62C01C5BE81A4B8351402991133FA92D62C07CC0E71A15835140B07DBEE9CA2B62C003F4E71A27825140B07DBEE9DA2A62C07059E71AF18151407C256994E42662C06B59E71AD18251407C256994E42662C0E2E2E71A618251404E1469948E2762C0986AE71AF7815140806CBEE9A42962C0AA433D70FA7F5140BC52BEE9CB2862C048213D708E7F5140C927BEE9EC2462C05C883D7032805140E2D5133F211E62C0986AE71A977E5140D5FCBDE95D1C62C05C883D70B27F5140050EBEE9E31B62C0C638E81ADF7F51409F5D133F671A62C0E8FE3C70227F5140B5C4133F9B1662C09C6AE71A777E5140F2F16894E21262C006663D70E67E5140040EBEE9131262C060883D70527F5140BC52BEE94B1062C008F4E71A47815140B3C4133F5B0C62C06B59E71AD1825140B2C4133FFB0562C034BA3C70CA825140E963BEE9F10462C09A27E81A19835140D4FCBDE97D0462C03E05E81AED83514084B3133F250462C082C0E71A55845140CE6E133F5D0362C0C238E81A1F8451402A91133F890262C01C5BE81A8B835140C6E068940C0262C06B59E71AD18251401875BEE9370262C05C883D705282514096CF6894460262C06816E81AF38151401875BEE9370262C06616E81A93815140C6E068940C0262C058883D70128151407C256994340262C0ECFE3C70A28051406E05BEE9400262C0F0FE3C70428051402A91133F490262C060883D70527F5140040EBEE9D30162C00CF4E71AE77F5140F4F16894620162C07C0B93C5F7805140C927BEE9BC0062C01C5BE81A4B835140040EBEE9830162C0F049E81A258451407D256994D40162C06616E81AB3845140C6E068940C0262C0A4433D707A855140545BBEE98E0062C03C05E81AED855140806CBEE9140062C05C883D70B2855140F1F1689472FF61C0225BE81A0B8551409C16BEE936FF61C0B45F92C5FB845140D6FCBDE9CDFE61C05A3D92C50F855140CE6E133F8DFE61C0225BE81A0B855140B07DBEE9CAFD61C024E992C58B8451401875BEE967FD61C07059E71A91845140D6FCBDE93DFD61C0F2FE3C70428551403AAD6894FAFC61C026E992C5AB8551404F1469945EFC61C07CC0E71AB5855140E0D5133F41FB61C0A4433D707A85514084B3133F65FA61C0946AE71AB78551401F036994A8F861C04CAFE71AAF865140F0F16894C2F761C01F9EE71AC98651409041BEE935F661C034BA3C70EA8551407D25699494F561C0279EE71AC9855140F738BEE972F261C0F88CE71A038651405AA2133F0FF261C050AFE71A4F86514056A2133FEFF161C09C6AE71AD7865140BA52BEE90BF261C024E992C56B875140D6FCBDE90DF261C0EC49E81AE587514058A2133F9FF161C0A4433D701A885140826CBEE974F161C0CCC692C5DF87514096CF6894D6F061C03805E81A8D86514097CF689456F061C0563D92C52F8651408E41BEE975EB61C0205BE81ACB865140826CBEE954EB61C0F0FE3C70C28651401875BEE947EB61C0F049E81A85865140F938BEE922EA61C0533D92C58F83514086B3133F85E961C00CF4E71AC78251401875BEE9D7E861C01C5BE81A4B8351409E16BEE946E961C03ABA3C700A845140D5FCBDE9ADE961C080C0E71A15855140AF7DBEE9DAE961C002663D7046865140BB52BEE99BE961C0996AE71A77875140D6FCBDE9DDE861C0B8AA3D70BE87514037AD68948AE761C06E59E71A91875140050EBEE953E561C01F9EE71AC9865140F2F16894F2E461C0148292C567865140E1D5133FA1E461C0BC38E81AFF8551401875BEE947E461C0138292C5A7855140C4E06894CCE361C0A4433D707A855140B07DBEE92AE161C034BA3C70EA855140CA27BEE9BCE061C0C4C692C5BF855140545BBEE96EE061C0800B93C5578551409C16BEE9F6DF61C0B7AA3D705E845140D7FCBDE97DDF61C006F4E71A078451408E41BEE9D5DE61C0ECFE3C7002845140B07DBEE92ADE61C09627E81A398451402991133FA9DD61C07059E71A91845140E2D5133FE1DD61C0225BE81A0B85514087B3133F25DC61C0C47BE71ABD845140F738BEE9D2D461C07C0B93C537815140301FBEE939D361C09C6AE71AD7805140FC7F133F13D361C0C4C692C53F805140F1F1689492D361C05E883D70727E51406030BEE91FD361C03E05E81A2D7E5140D3FCBDE99DD261C06A16E81A137E514058A2133F1FD261C09427E81A397E51402A91133FB9D161C054AFE71AAF7E5140B2C4133F3BD161C038BA3C700A7F51407F6CBEE994D061C0976AE71AD77E514097CF689466CF61C03405E81A0D7E5140B4C4133FBBCF61C0BCAA3D703E7E51406D05BEE910D061C044213D704E7E51409D16BEE966D061C0BCAA3D703E7E5140AE7DBEE9BAD061C03405E81A0D7E514096CF6894E6CF61C024E992C50B7D5140F2F1689402CE61C0B05F92C5BB7C51409C16BEE936CD61C06616E81AD37B5140826CBEE964CD61C0C47BE71A9D7B51402B91133F79CD61C00C8292C5677B5140A15D133F87CD61C04CAFE71A2F7B5140EA63BEE9A1CD61C02A9EE71AE97A51401875BEE9B7CC61C06F59E71AF17A51403AAD68944ACC61C094DC3C70D67A5140F1F16894E2CB61C0F88CE71A837A5140060EBEE913CC61C034BA3C70EA7951402B91133F09CC61C028E992C58B795140F638BEE9D2CB61C050AFE71A4F7951406E05BEE900CB61C0CE7BE71ADD785140B07DBEE9AACA61C06A59E71AD178514067BE689460CA61C0168292C5A77851408F41BEE965C961C0CC7BE71A3D775140B4C4133FABC861C0249EE71AC976514059A2133F6FC361C07BC0E71A5576514087B3133F95C161C04A213D706E755140B3C4133F5BC161C0B2D1E71A7B735140BC52BEE97BC061C08CDC3C70F672514057A2133F9FBF61C0ACD1E71ABB72514095CF6894D6BE61C03C05E81AED72514068BE689430BE61C06416E81AB373514084B3133F75BD61C04CAFE71A2F7451407B25699484BC61C0FF1A92C5C3735140264ABEE9C8BA61C0B05F92C59B7251401875BEE9E7B461C00CF4E71AC7705140C2E068945CB261C0B0D1E71ABB6E51403AAD6894CAB061C082C0E71AF56D5140321FBEE909B061C0CC7BE71A5D6D5140D4FCBDE97DAF61C0F449E81AA56C5140A05D133F17AE61C04CAFE71A4F6A514096CF689436AD61C0C4C692C59F69514066BE689450A961C06EA492C593685140CB6E133F8DA861C0C8C692C53F695140E2D5133FE1A761C03405E81A4D6A51405AA2133F0FA761C0FA1A92C5236B51405F30BEE9EFA761C070A492C5936B5140F738BEE992A861C00F8292C5A76B5140020EBEE953A961C0F649E81AE56B51404C1469941EAA61C0021B92C5036C51404C1469941EAA61C06416E81A736C5140C4E068947CA061C0B4AA3D70DE695140826CBEE934A061C048213D70AE695140D2B568942DA061C0289EE71AA969514072DD55742DA061C05F065B05A9695140BAD3D5D12CA061C09ADE959C54605140AFD0462F2CA061C074A73D2A005751403444B78C2BA061C05070E5B7AB4D5140829887562BA061C04C268C4557445140B9B727EA2AA061C022EF33D3023B5140AEB498472AA061C01CA5DA60AE315140362809A529A061C0F86D82EE59285140BB9B790229A061C0D4362A7C051F5140B098EA5F28A061C0889B8FE2B1155140350C5BBD27A061C0885136705D0C5140BA7FCB1A27A061C0641ADEFD080351407C5D9CE426A061C040E3858BB4F95040B27C3C7826A061C088EA6D405FF0504037F0ACD525A061C01E62D4A60BE750402CED1D3325A061C0BCC01BC8B6DD5040B2608E9024A061C0531F63E961D4504036D4FEED23A061C08C3F6AE30DCB504028D16F4B23A061C00CB1B204B9C15040B044E0A822A061C00C67599264B85040950FB07222A061C0C0CBBEF810AF504038B8500622A061C0FCD2A6ADBBA5504029B5C16321A061C07C44EFCE669C5040B22832C120A061C0BF64F6C812935040389CA21E20A061C0F784FDC2BE8950402C99137C1FA061C0509203BD6A805040B40C84D91EA061C02C5BAB4A167750403680F4361EA061C0082453D8C16D50404EB295CA1DA061C0FCD9F9656D645040327D65941DA061C0A2384187185B5040AFF0D5F11CA061C0409788A8C35150403864464F1CA061C0344D2F366F4850403061B7AC1BA061C01016D7C31A3F5040B2D4270A1BA061C0ECDE7E51C63550403A4898671AA061C08056E5B7722C5040334509C519A061C0CA5DCD6C1D2350406664A95819A061C0C41374FAC819504028427A2219A061C0A0DC1B88741050403C2CEA7F18A061C0E8E3033D1F07504031295BDD17A061C08859579595FB4F402A26CC3A17A061C0B0482462EEE84F403F103C9816A061C040956EE048D64F40340DADF515A061C0D0A33E4A9EC34F402A0A1E5315A061C0BB0F8C65F5B04F405C29BEE614A061C04B1E5CCF4A9E4F403EF48DB014A061C003B0ABEAA18B4F4036F1FE0D14A061C0B741FB05F9784F4027EE6F6B13A061C0B0AD482150664F4040D8DFC812A061C0D79C15EEA8534F4037D5502612A061C067ABE557FE404F402AD2C18311A061C01F3D3573552E4F4042BC31E110A061C0D0574167AD1B4F4056EED27410A061C09CB752F801094F4038B9A23E10A061C00CF860EC59F64E402CB6139C0FA061C0BC126DE0B1E34E40AE2984F90EA061C073A4BCFB08D14E40369DF4560EA061C020BFC8EF60BE4E402D9A65B40DA061C05425D9E3B8AB4E40B00DD6110DA061C00340E5D710994E403881466F0CA061C0D89FF66865864E40297EB7CC0BA061C04BE0045DBD734E40B2F1272A0BA061C0879D939F13614E403A6598870AA061C0AF8C606C6C4E4E40306209E509A061C0AF6FF1AEC23B4E406381A97809A061C02C077EF118294E402A81AD75D69F61C084A226FFF5264E400E3A9C84589F61C04B6D41E7DC254E409605F1B9179D61C0279C51F84E244E40D41C8B33979861C0FF3E77B72F214E403473A6DB229561C0E0BE6409C91E4E4053BFDC6B149161C0777CB95EF91B4E405ECC383B999061C0E89188C8A71C4E40AC993C98369061C03DDF6CE03F1E4E40A1EFCED7358F61C0A42CC19863234E4045D9462FCF8E61C058159D7602254E401AC7026B548E61C098506EE0B0254E405CFAD551928D61C04B91188B86254E400CBA9827668A61C008F867A63E224E40DF548E706A8561C048929BD9151D4E40DC26F159818061C0D0E63D4AFC174E40A8A3EDDCF77E61C03C049D761C184E4059E3C183577D61C0BBA899D99A1A4E401A861D33717A61C0E824D446D4204E40CAD4D5314F7761C06F3C8D658E274E4066E1B60CC17561C0DCC442E7D4294E40ECADE0681B7461C01015D0A9C32A4E4030B46F2B937061C0D016FB051A2B4E40BC084A6C3F6D61C0F78EA74D6B2B4E40644A9FE1636861C0E42AB224E02B4E40DE577D5F406361C087E533735D2C4E409CC283F98A6261C0978BEB91A62B4E401254ADB5326261C0484ADF1D39294E4094E1278A576261C030E9BCFB60264E40594F2B87A16361C0C00FA84D081D4E40682F51A6C96461C0FC8C1FC5A1144E40C0FD2A07DD6561C0BB4680F1D10C4E40B0875423D46561C08006F2CB64094E40CA4CC500986361C0B784DE1D04044E40E7F66F36ED6161C0B9FC23EE01004E40EE454ACCA66161C0A0D9939F58FF4D40EAFD94CA1E6061C0D031DB8015FD4D4008600925F55A61C03C28741A06F84D404B42C143C35761C03B109F76E3F44D402BB468718E5661C08CC003DD00F34D40807FC85D4F5661C0BC6BA21365F24D40B44C02AB255661C0EFAF818E85F14D40CCDD496CF05461C0AD62818E1AE74D404C9435FE655461C07483C6D25BE44D40B441F1B92C5361C0A8AD2C397DE04D40C328E0E8A44F61C04903983C22D94D400B55EABFA24B61C047DD0040C9D04D407C00107F064761C04965B1242BC74D404C5E76E5294261C053D562090EBD4D400C67E762233D61C0382B717D95B24D40B870E008443861C07B7CABEA6FA84D40BA3F4D49903361C0FC2C8E65A29E4D40E3822B87033361C0777E5DCFD59C4D40F7E5CE77A03261C0D85BC8D2709A4D40704FEEDC933161C0D09F125138914D4003BD8716AC3061C05CD8973C43894D406A2E0628802F61C0FF4A79B7F67E4D408F1DC5803F3061C08051ABEA50784D4092900CC2473061C0E07868A61B754D40704CF179942F61C08B48D0A935734D408ADB94CA822E61C0A088EE2E17734D40BA0B40158A2D61C0D8BDD34630744D400FFA1DB3D12A61C05BFDABEA4C7A4D40B4801D53052961C06FD015EE5A7E4D403C48A6DB832561C000BAED9179834D40515BBEE9FE2161C0C12CD035A6884D40E963BEE9812161C0A3D8D03562894D404091912D271E61C0E8DC178B378E4D4062C287F6E71A61C0C8CB4F5BF7924D40B061E0C8221961C030BBA3B01F944D403A4A4A4C801561C0C8A778B74D934D408C7A3CB8A11361C0A705097ABD934D404AD65740391261C067A6361009964D40A4E37268830F61C02038B0877CA04D40A4547D3F790F61C0FC8EB5C1F4A04D40FED2A9F8ED0E61C04F454CBED6A44D40080E956AF20E61C0307D53F836B14D40FF45F139F60E61C04F8DDE1D17BB4D40CE1B2B874F0D61C0D47814EEE2B94D4082225126BD0B61C0603F6EE08AB94D40844DE3653D0A61C0C30E3373C2BA4D4006171719CD0861C0036DACEA43BE4D40221521D0D40761C01CD048219CC34D40B421706B450861C0F845AE872EC74D40D821BE46940961C0544E27FFB1C94D408C8409E5350B61C088550140D3CB4D40F2439FA1450861C0A88ABCFB8FCF4D402A10952AA70461C0F7F1438483D14D40BEA9270ADC0061C0FF00357390D34D40C0F7BAE98FFD60C08F4BE9F457D54D40000FD92E97FA60C09721FCA2BCD84D40A8DB572085F460C0D03C848EA9DF4D40A85B54C372EF60C0D4542FD66FE54D407F120668E2EE60C0BB3A8C6514E54D40D42A2BC7F0EC60C048703E4A6CE04D40F21FCFB710EB60C0B0B19E7692DD4D40FA4924ED50E860C0685D59325FD94D4012BFBDC619E760C0A3FD4E5B6FD64D40E8D2F41625E660C04F43707DD4D24D402E2A9FA10CE560C0B0A603DDC7CF4D40126D65F469E360C047B953F87BCE4D4044EC80DCCFE260C0E4BE2C39A3CD4D400E37A6DB0DE160C0904CFCA25BC94D40A20B7DBF97E060C0C065C43599C74D401B7DB0B284E060C06837D0A98FC54D40492765949FE060C05C22CE0C20BF4D40983EA67BBEE060C01339DF1D13BD4D4066A5801C33E160C0EB2F616C15BB4D40F94A7DDF83E260C0272E606C1BB84D40225C6F6B10E360C0A88963099DB54D4026E5EDBCC8DF60C0A4FEA74DE2B04D404A698E9027E060C080518F02FEAE4D40BC5EFF4D76E060C0DCEA939FFEAC4D401B7DB0B284E060C0177D0DB407AB4D40019AFBF05BDF60C064F50DB411A64D40C204028BA6DE60C05FAF2D39F7A34D4076FA8379D6DD60C0A000848EA4A24D40FE62E3E5DCDA60C0750A1EC50AA14D40C8C63C58CAD760C05C22CE0C609F4D403C93359E93D660C00089F3CBBB9E4D40202F248D25D660C0DF2D939F1C9E4D4012F880FCD9D560C0DDA1A84D8B9C4D407803FF6D7CD560C07CE96DE0CC984D4020981AD621D560C0279C89C834974D40B931B46F8BD360C0A0ACC5D280924D4054BE8A33A6D260C06065CD0C7E904D40269532A1D0D160C0334A8B65C08F4D406EBDFB504AD060C0385116EEB78F4D40DA836F4B48CF60C0B91A198BB68E4D4092ED8AB36ECE60C0F9904BBE878C4D40CFA4B092BCCC60C0F073B95EA6864D405E204AAC63CC60C0A04AACEAB7844D402F3DE7C256CC60C0C47D7DF168824D4022A195CAC7CC60C0DDA1A84DCB7C4D40C8434352FDCA60C0C7E46F7D037C4D40888BC4808CCA60C0F791B224447B4D40861F54C33DCA60C038E3087AF1794D40868EBA2957CA60C0BFA47B547E794D40D7339F0192CA60C018EAF90501794D4052F7383BA8CA60C0BDFEED9191774D407B8987167ACA60C0283133734E754D40FC39EE5C24CA60C098225595AF734D40064F6C2E1CC760C017593610DE6B4D40925384997BC360C0F86B299C74674D40D84732A175BF60C001411B288C624D4062F7ED1CE1BB60C0D0337FF1315E4D404C4E399B98BA60C0BFCACC0CE85B4D40E4C157207CB960C018D2FA05C2584D40C5F3720867B660C037761C28B84C4D40646654830AB460C0E701727DF0454D401152028B81B160C00839B5C1B6404D40165F57A0D1AE60C0D874CC0C2A3B4D4035B1803C8DAC60C0F367D346B2334D40F403288AC3AD60C0F7D96EE0A02F4D40333024ED47AD60C07712CA6F4F2A4D404087D274FCAB60C057ABE5573E254D404E395B7D3BA860C0C15CCD0CEB1A4D40AA11107F4CA560C0FBB56DE0DA124D405EEA914D8CA460C0E8F85E6C6F0F4D407C12F8F308A360C06014289C3C044D400C79BAA967A260C098FD6A4302014D40860EBE86C99F60C0442A2DB990F84C4026664352599D60C01C105932B4F04C405C1FF1B9A09A60C0202E52F851E54C403E2BA6BBB39660C0AB29E01DE7D44C40F68AED3C219460C098DAB4C125CA4C40638B76A5AD9160C0AF910FB4E1BF4C40BE11C560958E60C0D89BA013E3B54C404E42C8FD978B60C0CCE5D6E33FAC4C40BFFE83F9BF8960C0703084ABE2A34C4088A9244D648760C088BB8C6531994C40A5C0EDFCD78860C0408F7BD40E934C40528A7645EB8A60C084C011514A8A4C4086C5CB7A318560C0D328F2CB70864C40F1BB80FC048160C0AC69C6D2A2834C40724521B06F8360C098DB299CEB6D4C40C63C6CCEE37B60C070A9561590654C4094775B3DB57B60C08853561592644C40462095CAEA7B60C018133AADF0624C408D3151663E7C60C050FAC3B52B614C4096A2F4366A7C60C0EC97741ABD5F4C4096BFF4565A7C60C088285DCF575E4C40C87080BC2E7C60C0BFF2EB914A5D4C40A3EE8359AC7B60C0B3AA67A6535B4C401E8D09E5D87A60C098B76EE054574C4085EB3FD5927A60C0EB4D30D616554C40BC476F4B737A60C01708C96F82524C40D8066297A07A60C07CE21A283B4D4C40668057406B7A60C0B8D567A6F24B4C409576024B927960C0309B2262384B4C40D1235443277660C0A41C77B7E34A4C40B2B1A29EBF7260C0BFF1AE872A4C4C401D3A357EEE7160C058D44F5B0A4C4C4040645B7D2A7160C07C80F3CBE84A4C4089DFDCABBB6F60C01882AE87B3474C4056FF61F70F6B60C08872852B6B404C40E8498439E66660C0382CD129ED394C4002FE49AC376360C0B838DA802E344C4050943CB88A6060C0C43804DD8A314C4005CF68D1D95A60C0349E267FAC2F4C40217C73A8545860C013F56A432F2C4C40E813C520AA5460C0A44DA94D87214C4053536CAE455360C0E8BF939F9F1F4C40088D4D49DB4F60C09376F768C01D4C40BD817DFF1C4F60C028BCEE2EC91C4C40EC1AA35EA84E60C0FC2085ABF61A4C403554FB90B14D60C0E04E5F6C6D124C40B0586C8E614D60C0E00437109A104C403849F159ED4C60C09451B95E9A0F4C40BF2ECC3A4A4960C0BCAFEC91EC0C4C40B83A21F0C74760C0847A077AD30B4C40F2A99887C24660C0C05FD8E3830B4C401C10F576BC4360C05FF811D1850D4C408007EEBC044360C010EDDA80FD0C4C4015FF490C4A4260C020E7188BC40A4C40454F8419424160C0789D939FD3054C408796DC2BDA4060C0F76C97BC15034C4052EECBBA9B4060C0705C2A9C48004C40FE9B9F61784060C0701331D64BFB4B40840EBE86894060C0D731E9F49EF54B40FEF2B9A8A04060C0EC38169F38F44B40E029DCB6A04060C05C4226C437F44B40AF7DBEE9BA4060C0BC7A248B5FF34B407E256994944160C0EC93D0358AEF4B40331FBEE9594360C0D4B2CE35A2E94B4059A2133F5F4460C090F7CE353AE74B40FC7F133FC34460C010E8CF35CEE54B40B5C4133F3B4560C048877AE0B4E24B4039AD68945A4560C06C7479E014E24B40A05D133F774560C0B8C5CF3542E14B404D1469948E4560C0F816268BEFDF4B40A05D133F774560C04BD2258BD7DE4B40D5FCBDE93D4560C0F019CF3506DE4B4058A2133F1F4560C0503CCF3512DD4B40B4C4133F5B4560C0533CCF3592DB4B40CD6E133FFD4460C0985ECF359ED94B40F3F16894924460C0BFC5CF3542D84B401775BEE9374460C0770AD0359AD64B40BC52BEE90B4460C05CA3CF35B6D34B40CE6E133F1D4460C064A3CF3576D14B40F738BEE9524460C0908D258B3FCF4B4094CF6894E64460C0BF107BE0E4CA4B40E963BEE9C14460C0AFC5CF3502CA4B40FB7F133FB34460C0B37A248BDFC84B40030EBEE9B34460C0E493D0350AC64B409C16BEE9964360C0304FD03532C14B406E05BEE9404360C030B6D03596BD4B40AE7DBEE90A4360C02FD5CE356EBC4B401A75BEE9174260C0700AD0351AB94B40A15D133FD74160C00081CF35AAB74B404F146994AE4160C08871D035FEB44B40C927BEE9BC4160C034D5CE35EEAE4B4039AD68949A4160C060BF248B37AC4B40EA63BEE9414160C030B6D03556AA4B401775BEE9A73F60C0740AD0355AA44B405E30BEE9FF4060C038B6D035D6A14B40321FBEE9994160C09C5ECF355EA04B40274ABEE9284260C054D2258B979E4B406F05BEE9804260C028B979E0EC9D4B40A05D133F374360C087F7CE357A9D4B40331FBEE9594360C0DCB2CE35E29C4B40EA63BEE9614360C0E819CF35069B4B40D6FCBDE97D4360C0344FD035B2994B4080256994B44360C0E019CF3586984B40BC52BEE90B4460C00881CF352A974B40C927BEE9DC4460C0D42CD035E6944B404E1469941E4560C02CB979E0AC934B40C827BEE95C4560C044B6D03596904B40525BBEE98E4560C0543CCF35128F4B401E036994684660C0707479E0548D4B409D16BEE9C64660C0E4FD79E0C48A4B40F838BEE9524760C094427AE09C854B40FC7F133FA34760C0DC48258B67844B40C927BEE95C4860C038D5CE35EE824B40F0F16894A24860C0975ECF351E824B40F2F16894D24860C0B4107BE0E4804B40321FBEE9294960C0740AD035DA7D4B40B6C4133F6B4960C0D42CD035667C4B40FC7F133F734A60C0A85ECF35DE794B40CA27BEE9BC4A60C0E048258B27784B40E2D5133FB14B60C0E4B2CE3522744B40040EBEE9534C60C0C3C5CF35C2724B402891133FC94D60C0F8CB7AE0CC704B40030EBEE9A34F60C007E8CF350E6C4B40EA63BEE9915260C074BF248B37674B40274ABEE9585360C017B979E0AC664B401A75BEE9475360C0C0C5CF3542684B4066BE6894305260C05FA3CF35B66B4B40FD7F133FF35160C088F7CE35FA6C4B4097CF6894265260C098427AE05C6D4B40E3D5133F815260C0BBC5CF35426D4B402891133FB95260C014E8CF350E6D4B4021036994685360C040D2258B576B4B40C4E068947C5560C0473CCF35D2624B40264ABEE9C85560C094F7CE35FA614B40535BBEE91E5660C0A05ECF359E614B40826CBEE9845660C094F7CE35FA614B40CE6E133FFD5660C02F4FD035F2624B40F738BEE9525760C0985ECF355E644B405F30BEE94F5760C04C3CCF3512664B40FC7F133FD35660C0D0B2CE35E2664B40B07DBEE91A5660C0E0FD79E044674B406D05BEE9B05560C0C0C5CF3542684B40535BBEE91E5660C0BC7A248BDF6A4B4068BE6894905660C098427AE0DC6C4B401975BEE9E75660C0D0B2CE35226F4B40A05D133F275760C030B6D03596714B405F30BEE94F5760C0E4B2CE3522744B40F2F16894525760C0C02CD03566754B40F2F16894425760C00081CF352A784B405F30BEE94F5760C0A85ECF355E794B40D6FCBDE97D5760C064A3CF35767A4B40B4C4133FCB5760C00B17268BAF7B4B407E256994145860C05F7479E0147C4B40826CBEE9345860C06F0AD0359A7A4B40040EBEE9235860C0F319CF3546724B40E863BEE9015860C038D5CE35AE6F4B40040EBEE9A35760C018E8CF354E6D4B40CD6E133F7D5760C00881CF35EA6B4B40CB27BEE98C5760C00C17268B6F6A4B401E036994D85760C034D5CE352E694B40EA63BEE9315860C0C02CD035E6684B40CA27BEE98C5860C0AF107BE064694B40C4E06894DC5860C00C17268B6F6A4B404F1469943E5960C0DF48258BE7664B406030BEE9CF5960C038D5CE35AE634B40555BBEE99E5A60C073BF248BF7614B40244ABEE9B85B60C070BF248BF7624B40F838BEE9625D60C0F319CF35C6664B4084B3133FE55D60C0F735248B87694B4068BE6894B05D60C014E8CF350E6D4B40F638BEE9D25D60C07C557BE03C6D4B40806CBEE9245E60C0FB16268BEF6D4B404E146994DE5D60C00881CF35AA704B40F838BEE9225E60C0780AD0359A724B406D05BEE9905E60C0C32CD03566744B401775BEE9C75E60C0948D258BBF764B404E1469941E5E60C02C4FD03572764B401E036994D85D60C040D2258B57784B40EA63BEE9115E60C08C71D035BE7A4B40030EBEE9E35E60C00481CF35EA7B4B40B2C4133F2B5F60C00881CF35AA7D4B404E1469946E5F60C093427AE0DC7E4B408E41BEE9C55F60C00081CF356A7F4B40C827BEE94C6060C00436248BC77F4B4058A2133F4F6060C0FC16268BAF804B407E256994E45F60C08871D035FE824B4084B3133F955F60C0503CCF3592854B40F1F16894125F60C038B6D035D6874B40040EBEE9635E60C0304FD03572894B409B16BEE9D65C60C037D5CE35AE8A4B4086B3133F555B60C0344FD035328D4B406D05BEE9A05A60C098F7CE357A8D4B409C16BEE9465A60C0707479E0D48C4B401875BEE9275A60C0503CCF35D28B4B40321FBEE9195A60C00436248BC78A4B407F256994F45960C01F04258B0F8A4B408F41BEE9955960C037B6D035D6894B40CE6E133F6D5860C0403CCF35128A4B40B4C4133F1B5860C07F71D0357E8A4B4067BE6894D05760C0BC107BE0A48A4B4020036994685760C068BF248B378A4B40CC27BEE90C5760C0A45ECF355E8A4B40C4E06894CC5660C0C82CD035A68D4B406030BEE98F5660C05FA3CF35368F4B4067BE6894005660C02CD5CE35EE914B40FC7F133FC35460C0607479E014964B40C827BEE91C5260C038B6D035969C4B4096CF6894264F60C0304FD035B2A74B4087B3133FC54E60C088F7CE357AAA4B40CF6E133F5D4F60C030B6D03556AA4B40F2F16894C24F60C0DB48258B67A94B40F838BEE9125060C07B0AD0355AA84B406E05BEE9C05060C050D2258B57A74B404F146994AE5160C0707479E0D4A44B408E41BEE9F55160C0B47A248BDFA34B40FA7F133F035360C0DCB2CE35E29C4B40E863BEE9B15360C0E793D0358A994B40040EBEE9635560C040D2258B17974B409C16BEE9365660C0D0B2CE35A2944B40E2D5133F515860C00081CF356A8C4B409A16BEE9C65860C054D2258BD78B4B40E1D5133F515960C028D5CE35AE8C4B4086B3133F855960C0D0B2CE35E28D4B408E41BEE9C55960C0274FD03572914B407F256994F45960C008CC7AE0CC924B401675BEE9F75A60C0503CCF3592914B40040EBEE9435B60C0F8CB7AE00C914B40F638BEE9425C60C0204FD035F28D4B40C4E068947C5C60C098F7CE357A8D4B406D05BEE9105F60C00317268BEF8A4B407E256994E45F60C030D5CE35EE8A4B406C05BEE9806060C09CF7CE35FA8B4B402A91133F396160C0B07A248BDF8D4B40FD7F133FD36160C00481CF352A904B40040EBEE9136260C098427AE05C924B409B16BEE9166260C043B6D035D6974B401975BEE9D76160C03CD5CE356E994B405F30BEE90F6060C070557BE0BC9E4B403CAD68945A5F60C02CB979E02CA04B40BA52BEE9AB5E60C0FC35248BC7A04B40D4FCBDE99D5E60C048D2258B57A14B4094CF6894065E60C0888D258BBFA44B409E5D133F975D60C0D8B2CE35A2A54B4066BE6894205D60C0C0C5CF35C2A54B40264ABEE9285C60C0D848258B27A54B4039AD68943A5460C0888D258B3FA54B40244ABEE9E85360C0DCFD79E084A54B402A91133F995360C0EC19CF3506A64B407F256994045560C00881CF356AA84B40B952BEE96B5560C0F7CB7AE00CAA4B406D05BEE9B05460C04BD2258B57AB4B40E0D5133F015560C050D2258B17AD4B40050EBEE9735560C0E793D035CAAC4B40BC52BEE9CB5660C0543CCF3512A94B40D6FCBDE93D5760C0F019CF3546A84B40535BBEE9AE5A60C050A3CF35F6A64B407D256994945B60C04C877AE0F4A74B406D05BEE9F05B60C0FC35248BC7AB4B4067BE6894605C60C017E8CF35CEB94B40040EBEE9F35B60C0A85ECF355EC44B40244ABEE9B85B60C0F816268B6FC64B406D05BEE9F05B60C06F557BE0BCCF4B40CB27BEE91C5C60C053877AE074D14B404E146994DE5C60C058A3CF3536D54B4021036994085D60C00336248B47D74B40D4FCBDE9ED5C60C0700AD0355AD84B40C4E068947C5C60C0D42CD035A6D94B4067BE6894605C60C0304FD035B2DA4B40331FBEE9795C60C008E8CF358EDB4B40D4FCBDE9ED5C60C0A45ECF351EDD4B40816CBEE9445D60C0700AD0359ADF4B408F41BEE9655E60C048877AE0B4E24B401775BEE9C75E60C094F7CE353AE44B40FB7F133FB35D60C038D5CE356EE64B40030EBEE9735D60C06F557BE0BCE74B401875BEE9E75D60C0B0C5CF35C2E84B40321FBEE9195E60C0F7CB7AE08CE84B406030BEE9FF5E60C0B7C5CF3502E74B4020036994785F60C0A87A248B1FE74B40F1F16894E25F60C0908D258BBFE74B409B16BEE9366060C038D5CE356EE84B40D8FCBDE96D6060C0B0C5CF35C2E84B409E5D133FB76060C04B3CCF35D2E94B401875BEE9F76160C088F7CE353AF04B40BC52BEE97B6260C094F7CE35BAF14B4020036994486460C0A85ECF35DEF54B407E256994346460C04BD2258B57F64B40B4C4133F0B6460C0A05ECF359EF74B404E146994AE6460C0D348258BA7F74B402A91133F496560C0B8107BE064F84B401E036994A86560C0680AD035DAF94B401875BEE9976560C04C3CCF3512FC4B40254ABEE9486660C054D2258B57FC4B40B17DBEE9EA6560C004CC7AE04CFE4B40B5C4133F7B6460C030D5CE352E024C40BA52BEE96B6160C02FD5CE356E074C406E05BEE9B06160C044B6D03556074C40020EBEE9836260C02FD5CE356E074C40CE6E133F2D6260C048877AE034094C4058A2133F4F6060C00881CF356A0E4C4096CF6894066260C00036248B470C4C40D6FCBDE9BD6260C0FC35248B070B4C4021036994686360C018B979E02C094C406130BEE9FF6360C050877AE074064C40B17DBEE95A6460C0E893D0354A054C40B952BEE94B6560C0BCC5CF3542044C409D16BEE9266660C098427AE0DC014C40311FBEE9496960C0BCC5CF3582FE4B40836CBEE9B46960C0D848258BA7FD4B40F3F16894126A60C0908D258B7FFC4B4066BE6894F06A60C0908D258BFFFA4B406E05BEE9E06B60C09BF7CE35FAFB4B4097CF6894B66C60C00C81CF356AFE4B40F2F16894426D60C01BE8CF354E014C40BD52BEE9DB6D60C0F816268BAFFF4B406130BEE9AF6E60C0E893D0350AFE4B40846CBEE9746F60C09F5ECF355EFD4B40EA63BEE9E16F60C0F716268BAFFE4B40CE6E133F0D7260C06CBF248B37F94B40C2E06894DC7260C08471D0357EF84B40C4E06894CC7360C00C81CF35AAF84B40F638BEE9127460C08471D0357EF84B4086B3133F357460C0700AD0351AF84B404E1469944E7460C004CC7AE08CF74B40BB52BEE96B7460C0E493D0350AF74B4020036994F87460C0C82CD03566F64B408E41BEE9C57560C0D893D0358AF44B40EA63BEE9817660C0B4C5CF35C2F34B4096CF6894367760C02704258B0FF24B40C3E068948C7760C09C8D258B7FF14B404C1469941E7860C0E493D0354AF14B401975BEE9277960C03BB6D03596F14B406D05BEE9C07960C09C8D258B7FF14B401875BEE9277A60C0EC19CF3506F14B40CE6E133FED7A60C0CF2CD03566EF4B40CD6E133F4D7B60C0E0B2CE35E2EE4B40E963BEE9D17B60C0E4FD79E0C4EE4B40836CBEE9547C60C0E0B2CE35E2EE4B40EB63BEE9D17C60C00436248BC7EE4B40806CBEE9447D60C0B0C5CF3502EE4B408E41BEE9957C60C073557BE07CED4B40274ABEE9687A60C027D5CE356EEA4B40826CBEE9E47860C0D02CD035A6E94B40EA63BEE9817860C01804258B8FE84B40E1D5133F717860C02704258B0FE64B4096CF6894C67860C0B87A248B9FE24B40C4E068940C7960C0948D258B7FE04B40BC52BEE94B7960C0443CCF3512DF4B404E146994DE7960C0B87A248B5FDD4B401F036994687A60C098427AE0DCDC4B40CE6E133FBD7B60C04C3CCF3552DD4B4068BE6894A07A60C064A3CF3536D94B40C4E068947C7A60C070557BE07CD54B40F3F16894227B60C00B81CF352AD24B40826CBEE9647C60C0B0C5CF3542CF4B40545BBEE94E7C60C0F8CB7AE08CCE4B40CA27BEE93C7C60C040B6D03556CD4B40CC6E133F2D7C60C0E4B2CE35A2CC4B406D05BEE9208060C050877AE074D54B40826CBEE9D47F60C07B0AD0351AD44B40D6FCBDE9FD7E60C03FB6D03516D14B40E1D5133FD17E60C06F557BE0BCCF4B40F738BEE9827E60C0E419CF3546CE4B408E41BEE9F57D60C018E8CF358ECC4B40301FBEE9B97D60C03CD5CE356ECB4B40C4E068945C7E60C0E0FD79E0C4CB4B40C4E068945C7E60C0BF107BE0E4CA4B4020036994E87D60C0740AD035DAC94B40E863BEE9A17D60C0AF107BE024C84B40525BBEE98E7D60C004CC7AE00CC64B40826CBEE9B47D60C0CB2CD035E6C34B40040EBEE9E37D60C0DC48258B67C34B4059A2133F2F7E60C08771D035FEC24B408C41BEE9757E60C0908D258B3FC24B407C256994947E60C000CC7AE0CCC04B40020EBEE9C37E60C0E4B2CE3522C04B404D1469942E7F60C0975ECF359EC04B40040EBEE9E37F60C0D42CD03526C24B40555BBEE94E8460C048D2258B57C84B40D6FCBDE97D8560C0707479E054CB4B40D8FCBDE9ED8560C0FFCB7AE0CCCE4B401775BEE9C78660C0700AD0355AD94B406030BEE93F8760C0533CCF3592DB4B40F2F16894D28760C0D893D0358ADC4B404F1469945E8860C02CB979E0ACDE4B407E256994848860C00CE8CF35CEE04B4086B3133FE58760C0E819CF35C6E14B4097CF6894468760C08471D035FEE04B40301FBEE9098660C087F7CE357ADD4B4056A2133F5F8560C0F419CF3586DC4B40C827BEE9AC8560C098F7CE353AE04B407F256994D48560C00017268B6FE34B40254ABEE9A88560C08371D035BEE54B40A05D133F678560C0304FD035B2E64B406030BEE97F8460C0B7C5CF3502E74B40AF7DBEE95A8260C0C0C5CF35C2E64B4067BE6894E08160C0B7C5CF3502E74B4038AD68947A8160C094427AE09CE84B40341FBEE9B98160C0F419CF3506EA4B406ABE6894C08260C0B8C5CF3542EC4B40525BBEE93E8260C0304FD03572EE4B4095CF6894968160C02FD5CE356EF04B409E5D133F278160C0CF48258B67F24B40F2F16894528160C0740AD0359AF44B40CD6E133FCD8160C040B6D03516F74B40E963BEE9D18160C0D42CD035E6F84B4086B3133F658160C02C4FD03532FA4B40BB52BEE98B8060C0A85ECF351EFB4B40CA27BEE9FC7E60C058A3CF35B6FA4B407C256994947E60C0A85ECF351EFB4B40816CBEE9647E60C030D5CE356EFC4B40826CBEE9847E60C0687479E014FF4B40D7FCBDE93D7E60C02804258B8FFF4B40E2D5133F317E60C0DCB2CE35E2004C40E1D5133FD17E60C018B979E02C094C40E1D5133FD17E60C0BC107BE024144C40264ABEE9687E60C044B6D03556154C4068BE6894707C60C0FC35248B87174C403BAD68940A7A60C038B6D03516194C402991133F597660C0985ECF351E194C40B4C4133F2B7360C0A05ECF35DE164C40B5C4133F8B7260C02CB979E0EC164C404C146994DE7160C088427AE01C184C405F30BEE9EF7060C0BC107BE0641B4C40D7FCBDE96D7060C017B979E06C1C4C40311FBEE9A96F60C094F7CE357A1C4C40CF6E133F6D7060C06B0AD0355A1D4C408E41BEE9357160C0780AD035DA1C4C40FD7F133FC37260C06F557BE0BC1A4C407C256994A47360C0B0C5CF35421A4C40321FBEE9697460C00881CF356A1A4C40311FBEE9097660C0FF16268BAF1B4C40545BBEE90E7C60C014E8CF358E1C4C40CB27BEE90C7D60C0E893D035CA1D4C40F838BEE9B27E60C0304FD035B2254C40FA7F133FE37E60C0F035248BC7274C40836CBEE9147F60C0B87A248B9F2D4C40CE6E133F5D7F60C040B6D035D62E4C40EA63BEE9318060C0BBC5CF35022F4C406C05BEE9F08160C0E0FD79E0C4304C409A16BEE9768260C0CFB2CE35E2304C402A91133FD98260C094F7CE353A304C40C927BEE95C8360C040B6D035D62F4C40301FBEE9998460C0C0C5CF35C2314C40806CBEE9F48460C0F880CF35AA304C40A15D133F278560C0F880CF35AA304C40D8FCBDE9ED8560C0A87A248BDF364C409F5D133F078660C044B6D035D6394C40E1D5133F818660C0503CCF35523C4C404E1469948E8760C040B6D035D63D4C4096CF6894168960C00481CF352A3F4C40F838BEE9428960C01CE8CF35CE3F4C40321FBEE9C98A60C0E393D0350A434C402A91133F098B60C05CA3CF35B6434C406C05BEE9308B60C098F7CE35BA444C40B17DBEE94A8B60C00881CF35AA464C40806CBEE9348B60C00481CF352A4A4C4059A2133FCF8A60C00336248B074D4C40F838BEE9C28960C0304FD035F2514C40D6FCBDE98D8A60C01704258BCF514C40826CBEE9E48B60C0C82CD035E64F4C40E1D5133F518E60C060BF248BB74D4C40F2F16894428F60C0B87A248B5F4D4C40040EBEE9A39060C047D2258B57504C402A91133F499160C0737479E0D4504C40331FBEE9999160C0D893D035CA514C40B07DBEE93A9160C0C72CD035A6544C40050EBEE9B39060C0AF107BE064564C40B5C4133F1B9060C0607479E0D4564C40BC52BEE99B8E60C0C02CD03566564C405D30BEE9FF8E60C01804258B8F584C401775BEE9978F60C038D5CE356E594C40331FBEE9499060C0A85ECF35DE594C40D7FCBDE9FD9060C0204FD035B25A4C401675BEE9578F60C06B7479E0145F4C404D146994CE8E60C0D0B2CE35E2604C40D3FCBDE9CD8E60C0C42CD035E6614C409B16BEE9468D60C05BA3CF3576644C406E05BEE9308D60C00881CF356A654C40D4FCBDE93D8D60C01704258B8F664C40F638BEE9328D60C0E493D0358A674C407D256994D48C60C064A3CF35F6674C40FD7F133F238C60C094F7CE35FA674C40F838BEE9D28B60C03F877AE034684C40F2F16894828B60C0BCC5CF35C2684C40BA52BEE91B8C60C0E893D035CA694C40E963BEE9C18C60C040B6D03596694C40E863BEE9618D60C014E8CF358E684C40321FBEE9E98D60C03FB6D03516674C40244ABEE9D88D60C0503CCF3592654C404F1469947E8E60C0AC5ECF35DE644C4038AD68944A8F60C08771D0357E644C404C146994AE8F60C078557BE0FC634C40274ABEE9E88F60C01F4FD03572614C402991133F799060C0284FD035B2604C406130BEE92F9160C0E893D0350A614C40B07DBEE98A9560C0B0C5CF35C2664C40CE6E133F5D9860C0C4C5CF35426C4C40301FBEE9C99860C0D7B2CE35A26D4C40A05D133FE79860C050D2258B576E4C40B3C4133F0B9960C0F835248B07704C40CE6E133F1D9960C0985ECF359E704C4057A2133F4F9960C02FB6D03556714C401675BEE9079B60C0E4B2CE35E2744C40254ABEE9689B60C02404258B0F754C4021036994889B60C090427AE09C754C40E2D5133F819B60C0D0FD79E004784C40FD7F133FA39B60C02C04258B8F784C401775BEE9179C60C02CD5CE352E794C4067BE6894B09C60C0E4B2CE35A27A4C40254ABEE9389D60C0AC5ECF355E7C4C40E3D5133F819D60C00FE8CF35CE7D4C401875BEE9A79C60C0B37A248B9F7E4C408E41BEE9359C60C098427AE0DC7E4C40EA63BEE9C19B60C030D5CE35AE7E4C407E256994449B60C024B979E0AC7C4C40311FBEE9E99A60C09F5ECF35DE7B4C40BA52BEE98B9A60C0E893D0358A7C4C40311FBEE9F99960C0304FD035B27C4C4020036994289960C06F0AD035DA7B4C406F05BEE9909860C0985ECF351E7C4C40D4FCBDE9AD9860C0D4B2CE35A27F4C40321FBEE9E99960C0B77A248B1F874C40E0D5133FE19960C0A05ECF355E884C408E41BEE9959960C027B979E0EC884C40545BBEE95E9960C0985ECF351E8A4C404F1469944E9960C04C3CCF35528B4C40010EBEE9739960C0A85ECF35DE8B4C409B16BEE9C69960C0707479E0948B4C40244ABEE9989A60C0D893D0350A8A4C40CA27BEE9DC9A60C03F3CCF3552894C40D4FCBDE98D9B60C0DC48258BA7844C408E41BEE9159C60C098F7CE35BA824C40B17DBEE9BA9C60C0E419CF3586834C40D7FCBDE97D9D60C09CF7CE357A854C40FA7F133F439E60C08071D035FE854C40264ABEE9789F60C0888D258BBF854C40CE6E133FCD9F60C098427AE01C864C40B4C4133F5BA160C09C427AE0DC884C4068BE689420A260C03F3CCF35D2894C40CB27BEE98CA260C054D2258B978A4C40321FBEE9F9A260C0503CCF35128B4C4038AD68949AA360C01BE8CF354E8B4C402003699438A460C00317268B2F8B4C40CE6E133F9DA460C054D2258B978A4C40B07DBEE9CAA460C038D5CE356E8A4C40CB6E133F0DA560C0A45ECF359E8A4C402791133F49A560C0C4C5CF35028B4C40040EBEE963A560C067BF248B778B4C40F3F1689452A560C0B8107BE0648C4C40C4E068942CA560C0E493D0350A8D4C40040EBEE9F3A460C0A05ECF359E8D4C406F05BEE9D0A460C088427AE0DC8E4C4066BE6894A0A460C038D5CE35AE8F4C40B5C4133F8BA460C02FB6D03596904C40BB52BEE9BBA460C02C04258B0F924C406030BEE9DFA360C05FBF248B77924C40C4E068945CA460C0985ECF359E944C40C2E068945CA560C060A3CF35B6954C40B4C4133F0BA660C00017268BEF924C40BA52BEE99BA560C00017268BEF924C40BA52BEE99BA560C02C04258B0F924C407E256994C4A660C01CB979E02C924C40CE6E133F0DA760C0D02CD035E6924C40FD7F133FB3A660C087427AE09C944C404E146994EEA660C0DBB2CE35E2954C40B07DBEE93AA760C0C02CD03566964C40B17DBEE98AA760C0948D258B3F964C406030BEE9CFA760C02804258B8F954C40F838BEE902A860C098427AE01C914C409C16BEE986A860C073557BE07C8E4C402003699448A960C014E8CF350E8D4C40826CBEE924AA60C0A05ECF351E8D4C40F2F16894A2AB60C034D5CE356E904C40D5FCBDE98DAD60C0780AD0359A924C40826CBEE944AE60C00017268BEF924C4056A2133F7FAE60C050D2258B57934C40C5E068943CAF60C0D42CD03526954C407E25699494AF60C02804258B8F954C401E036994A8B060C00CE8CF350E964C402003699438B160C038B6D03596964C40301FBEE9A9B160C090F7CE353A974C40301FBEE9A9B160C0730AD0351A984C408C41BEE9F5B060C07871D0357E984C409A16BEE926B060C0E393D0350A9A4C40F838BEE9A2AF60C0E719CF35469C4C40515BBEE9CEAF60C0284FD035B29E4C40321FBEE929B060C0D848258B27A04C408D41BEE915B060C097F7CE357AA04C40A05D133FD7AF60C0E493D035CAA04C40F938BEE9B2AF60C0EF19CF3546A24C408B41BEE985AF60C048877AE074A34C40321FBEE919AF60C0707479E014A44C4096CF689426AE60C00881CF356AA44C40A05D133F27A860C088F7CE35FAA34C40020EBEE9D3A560C0A05ECF351EA74C40F1F16894A2A560C0EF19CF3586A74C40CB27BEE96CA560C0F816268B6FA84C406F05BEE930A560C0985ECF35DEA84C40525BBEE96EA360C0985ECF35DEA84C40F838BEE9C2A260C0F735248B47A94C404E146994DEA160C09CF7CE357AAA4C407B25699434A160C0C0107BE064AC4C401875BEE937A160C078557BE0FCAE4C40F2F16894A2A160C0DDB2CE35E2AE4C40CE6E133F2DA360C02FD5CE356EAB4C40C4E06894DCA360C0EC93D0358AAA4C401675BEE9B7A560C0EC93D0358AAA4C40A15D133F17A660C0F8CB7AE04CAA4C4086B3133FC5A660C04B877AE034A94C401E03699428A760C0985ECF35DEA84C409F5D133FB7A760C0B4C5CF3502A94C40020EBEE9B3A860C08771D0353EAA4C402991133F39A960C0EC93D0358AAA4C409B16BEE986AC60C0D02CD035E6AA4C40C2E068946CAD60C0EB19CF3506AC4C408E41BEE925AE60C02B4FD035F2AD4C40B2C4133F9BAE60C06F557BE0BCB04C40A05D133F77AD60C0E593D0358AB24C407F256994E4AC60C0AF7A248B1FB34C40301FBEE969AB60C07871D0357EB34C402003699408AB60C0B8107BE0E4B34C4056A2133FDFAA60C04C877AE0B4B44C40C4E06894BCAA60C0E0B2CE35E2B64C405F30BEE9BFAA60C03CB6D03516B84C40B3C4133FFBAA60C0770AD0359AB84C40E963BEE941AB60C0503CCF3552B84C40B07DBEE9CAAB60C0B77A248B1FB74C403AAD68941AAC60C0730AD035DAB64C40CA27BEE9ECAC60C0234FD03572B74C40FB7F133F43AD60C0CF2CD03566B74C40CA27BEE99CAD60C0FF80CF356AB64C4055A2133FFFAD60C058A3CF3536B64C40244ABEE988AE60C0E3FD79E044B74C40C4E068940CAF60C00036248BC7B84C40FC7F133F03B060C038D5CE35EEBC4C4086B3133F25B060C02B04258B4FBE4C401775BEE927B060C064A3CF3576C04C40AF7DBEE9EAAF60C0EC93D0350AC44C40F738BEE9C2AF60C0204FD035F2C44C40F838BEE942AF60C0F880CF35AAC64C40C4E068940CAE60C0BB107BE0E4C84C40311FBEE929AB60C071BF248BB7C94C40826CBEE904AA60C0C82CD035E6CB4C40545BBEE9AEAA60C0E793D0354ACC4C406D05BEE950AD60C01F4FD03532CC4C40C827BEE90CAE60C064A3CF3576CB4C4059A2133FBFAE60C09CF7CE353ACA4C40D5FCBDE90DB160C0DF19CF3546C94C40CA27BEE9ECB260C0F7CB7AE08CC94C40CB27BEE95CB360C0CF2CD03526CA4C406D05BEE9C0B460C08171D035FECE4C40826CBEE914B560C08FF7CE357ACF4C40545BBEE90EB560C07F71D035FED04C40E0D5133FB1B460C064A3CF35F6D74C404E146994BEB460C060A3CF35F6D94C401875BEE957B460C0B0107BE0A4DA4C401E036994E8B360C0E0B2CE35E2DA4C40311FBEE9F9B260C037B6D035D6DA4C40C4E06894BCB260C0938D258BFFDA4C40826CBEE954B260C0DC48258BA7DB4C4059A2133F1FB260C058A3CF35B6DB4C40545BBEE9EEB160C0A87A248B5FDB4C40BC52BEE98BB160C05CA3CF3536DA4C40BD52BEE90BB160C0700AD0359AD94C40AF7DBEE9BAB060C098F7CE35BAD84C40E3D5133F41B060C0DD48258BE7D64C409B16BEE9D6AF60C0F319CF3506D64C4096CF689426AE60C0D7FD79E084D54C40BC52BEE9BBA660C0D7B2CE3562CB4C40040EBEE963A560C0CF2CD03526CA4C40FC7F133F13A560C098427AE05CC94C40321FBEE969A460C0975ECF351EC74C4068BE689430A460C0F880CF35AAC64C4066BE689490A360C0C0C5CF35C2C54C402A91133F39A260C0BB7A248B9FC14C40806CBEE974A160C064A3CF3576C04C40274ABEE918A160C00036248B87C04C4096CF6894A6A060C0E448258BE7C04C408F41BEE945A060C0E1FD79E084C14C4068BE689420A060C0D793D0354AC24C40FC7F133F63A060C068BF248BB7C24C404E1469949EA260C00436248BC7C44C405E30BEE92FA360C0ED19CF3586C64C407C25699414A460C0CF2CD03526CA4C402A91133FF9A460C0DDFD79E0C4CC4C408D41BEE945A560C0E348258B67CE4C406F05BEE930A560C0F419CF3546D04C40264ABEE9D8A560C054D2258BD7CF4C40AE7DBEE9CAA660C0F419CF3546D04C40826CBEE9A4A760C07C557BE07CD14C40F838BEE902A860C00C81CF356AD34C40A05D133F87AB60C04BD2258B57D74C40311FBEE9B9AC60C00CE8CF35CEDA4C40CB27BEE95CAD60C06B7479E014DC4C40E963BEE901AF60C098427AE01CDD4C406030BEE9FFAF60C00C81CF356ADE4C40C827BEE9ECB060C0975ECF351EE04C409F5D133F77B160C0607479E0D4E14C40C4E06894ACB160C0F880CF356AE54C40C1E06894DCB160C0AB7A248BDFF14C40301FBEE9A9B160C0D7B2CE3522F54C40E963BEE941B160C030D5CE356EF54C40F938BEE9B2AF60C0B8C5CF3542F44C40B4C4133FBBAD60C0B8C5CF3542F44C406F05BEE9C0AC60C04B877AE0B4F34C40AF7DBEE9FAAA60C09B8D258B3FF14C40826CBEE904AA60C030D5CE35AEF04C404C146994BEA960C0A95ECF35DEF04C40B17DBEE93AA960C040B6D03596F14C401875BEE9E7A860C0B3107BE0A4F14C406030BEE98FA860C0E893D0354AF14C40E0D5133FD1A760C0C1107BE024F04C4058A2133F8FA460C0CF48258B67ED4C4020036994F8A360C060A3CF35B6ED4C40B3C4133F3BA460C08F8D258BBFEE4C40E2D5133FF1A560C08C427AE0DCF14C40311FBEE999A660C0DFFD79E084F24C40CA27BEE9BCB160C060BF248BF7F64C40826CBEE954B260C00336248B47F64C40816CBEE9B4B260C031B6D03596F44C40311FBEE9F9B260C0B3107BE0A4F14C40BB52BEE9EBB260C03CB6D035D6F04C406030BEE9DFB260C0F7CB7AE00CEF4C409C16BEE9F6B260C01F04258BCFED4C40F738BEE952B360C0A35ECF359EEE4C40B2C4133F8BB360C0B87A248B5FEF4C40264ABEE908B460C0B17A248B9FF04C404D1469944EB460C0B3107BE0A4F14C40BB52BEE97BB460C053D2258B17EF4C401675BEE907B460C04C3CCF3512EA4C404D1469944EB460C03F3CCF3512E74C40301FBEE929B560C00B81CF35AAE44C4096CF6894F6B560C050A3CF3536E54C40C2E06894ACB660C060A3CF3576E74C4066BE6894C0B760C0F880CF352AEC4C40F838BEE9B2B960C0BFC5CF3502F34C404C146994DEB960C037B6D035D6F34C40244ABEE9F8B960C0A45ECF35DEF44C40EB63BEE901BA60C0E048258B67F64C408B41BEE935BA60C0D02CD03566F74C40501469948EBB60C05BA3CF3576FA4C40321FBEE9E9B960C0B07A248B1FFE4C40301FBEE959B960C09D8D258BBFFE4C40BC52BEE9CBB860C0443CCF3592FE4C40FB7F133F73B860C00036248B87FD4C404E1469941EB860C0F419CF3506FC4C403AAD68949AB760C05BA3CF3576FA4C40B07DBEE9FAB660C0E4B2CE3522F94C4085B3133F75B660C0433CCF3552F84C406030BEE91FB660C0677479E094F84C40D5FCBDE90DB660C05BA3CF3576FA4C40F2F1689452B660C060BF248BB7FE4C4087B3133F25B660C0988D258B3F004D40B4C4133F6BB560C050877AE074014D40B4C4133F6BB560C07C71D0353E024D40B5C4133F6BB760C08F8D258B7F024D40CB27BEE92CB860C06F0AD035DA034D403AAD68947AB860C068BF248BF7074D40836CBEE9F4B760C0BFC5CF35020A4D4094CF6894F6B660C0F019CF35860C4D401875BEE957B660C053D2258BD70E4D40F838BEE9F2B660C013E8CF354E104D40F838BEE9F2B660C0C0C5CF3542114D40545BBEE93EB660C00FE8CF35CE114D40BB52BEE9EBB560C00036248B47124D40264ABEE998B560C037D5CE35EE124D408E41BEE9D5B560C0DCB2CE35E2134D401F03699468B660C0B7C5CF3502134D40F2F1689442B860C0C0C5CF3542114D40F2F1689442B860C013E8CF354E104D40BB52BEE9BBB760C0503CCF35520F4D40836CBEE9F4B760C0607479E0940D4D40C2E06894ECB960C090F7CE35BA054D409A16BEE906BA60C064A3CF35B6034D40EA63BEE991B960C050877AE074014D40284ABEE9A8BB60C0677479E054FE4C4056A2133F4FBC60C053877AE0F4FD4C40040EBEE913BD60C0FC16268BEFFD4C40020EBEE963BD60C00C81CF352AFE4C40D6FCBDE9BDBD60C09D8D258BBFFE4C40050EBEE9E3BD60C00B17268B2FFF4C40C827BEE90CBE60C033B6D03516004D40CC6E133F2DBE60C0948D258B7F004D40F838BEE962BE60C0F735248BC7004D406C05BEE9E0BE60C00781CF352A014D40CE6E133F0DBF60C050877AE074014D40CD6E133F3DBF60C04B3CCF3592024D4058A2133F3FBF60C064A3CF35B6034D40BB52BEE94BBF60C03CB6D03596044D40254ABEE998BF60C0204FD035F2044D403AAD68940AC060C017E8CF350E054D40284ABEE958C060C078557BE07C054D4095CF689486C060C0C02CD03566064D40806CBEE994C060C068BF248BF7074D405E30BEE9BFC060C0D3B2CE3522094D40050EBEE923C160C0B0C5CF3542094D4085B3133F95C160C0F7CB7AE00C094D402C91133FE9C160C070557BE03C094D40B07DBEE90AC260C0CFB2CE35220A4D407E25699454C260C070557BE07C0E4D4096CF6894D6C160C058A3CF35360E4D40CB27BEE98CC160C04C3CCF35920E4D40545BBEE96EC160C054D2258B570F4D407E25699474C160C013E8CF354E104D4085B3133FA5C160C093F7CE353A114D40CA27BEE94CC260C061A3CF35B6124D40E2D5133F91C260C0DCB2CE35E2134D40BB52BEE9ABC260C057A3CF35F6144D406030BEE9BFC260C0B8107BE064164D402A91133FC9C260C0E4B2CE35E2174D40040EBEE9C3C260C0BB7A248B1F194D40C4E068949CC260C0CC2CD035A61A4D40846CBEE964C260C054A3CF35761B4D408B41BEE925C260C048877AE0341C4D402C91133FE9C160C08C71D0357E1D4D40FB7F133FD3C160C06FBF248BB71E4D40B6C4133FDBC160C08FF7CE35BA1F4D403CAD6894EAC160C05FA3CF35B6204D402C91133FE9C160C0A75ECF35DE214D408E41BEE9F5C160C06D7479E054224D40020EBEE913C260C064A3CF35F6224D403BAD68942AC260C0204FD035B2234D40E0D5133F21C260C08471D0357E244D4094CF6894E6C160C02F4FD035F2244D40826CBEE904C160C08471D0357E244D40806CBEE954C060C028B979E0AC254D40826CBEE9B4BF60C097427AE01C274D405D30BEE96FBF60C0D12CD03566284D406D05BEE970BF60C0483CCF3512294D40FD7F133F93BF60C0B9107BE0A4294D40826CBEE9B4BF60C0670AD0359A2A4D406130BEE92FC060C00C81CF35AA2F4D40E963BEE951C060C04B877AE034324D40826CBEE924C060C0F8CB7AE04C344D409A16BEE9E6BF60C0D893D035CA344D40545BBEE91EBF60C0BCC5CF3582354D4067BE6894D0BE60C0E893D0350A364D40826CBEE974BE60C0B0107BE064374D407D25699464BE60C0F019CF3546384D40545BBEE96EBE60C0E0B2CE3522394D4085B3133F65BE60C00981CF356A3A4D40E0D5133F71BD60C00817268BAF3F4D40B3C4133F0BBC60C044B6D03556414D40F2F16894B2B860C090427AE05C424D40F2F16894B2B860C0D748258B27434D40264ABEE968BC60C0D748258B27434D40F2F16894E2BD60C02BB979E06C424D4086B3133FB5BE60C0A75ECF359E414D4068BE689440BF60C0A75ECF359E404D405D30BEE96FBF60C00481CF356A3E4D4067BE689430BF60C044B6D03596394D40254ABEE998BF60C00481CF35AA384D40FC7F133F53C060C0E193D0354A384D40C2E068949CC160C0E793D0358A364D407E25699454C260C0E893D0350A364D407E25699454C260C04CD2258B17354D4020036994A8C160C0F319CF3546344D40EA63BEE981C160C0985ECF35DE314D40E2D5133FB1C160C0C3C5CF35022F4D4084B3133F05C260C05F7479E0D42C4D40A05D133F97C260C090F7CE353A2B4D4066BE689400C460C0E493D035CA284D402003699488C460C097427AE01C274D4086B3133FB5C460C094F7CE357A244D409E5D133F37C460C064A3CF35F6224D40D5FCBDE98DC360C02FD5CE35AE214D40244ABEE938C360C070BF248BB71F4D409C16BEE956C360C0E548258BA71E4D40C4E068949CC360C053877AE0B41D4D40FB7F133FA3C460C0A45ECF35DE1A4D40CF6E133F0DC560C0CB2CD035261A4D40F838BEE982C560C0D52CD035E6194D4085B3133F15C660C0908D258BFF194D40B2C4133FBBC760C030D5CE356E1B4D40CE6E133F1DCE60C0D748258B27294D40BD52BEE9BBCE60C015E8CF35CE294D40826CBEE914CF60C0710AD0355A2A4D40C2E06894ACCF60C0AFC5CF35C22C4D4059A2133FEFCF60C01BE8CF354E2D4D40020EBEE9B3D160C01BE8CF354E2D4D4096CF689436D260C044B6D035962D4D40CE6E133F1DD360C0F035248BC72E4D4058A2133F8FD360C013E8CF350E2F4D4085B3133FE5D360C044B6D035962E4D409C16BEE906D460C0CF2CD035A62D4D4037AD68942AD460C077557BE0FC2C4D408D41BEE985D460C01BE8CF354E2D4D40F838BEE9A2D460C0B77A248B5F2E4D40321FBEE9B9D460C0D0B2CE3522304D40E1D5133FF1D460C060A3CF3576314D405E30BEE96FD560C08871D0353E314D401775BEE9E7D560C014E8CF358E304D406E05BEE900D760C0D848258BE72F4D40FC7F133F83D760C04CD2258BD72F4D40F2F1689432D860C038B6D035D6304D40D5FCBDE98DD860C08971D0353E334D406E05BEE9B0D860C0F019CF3546364D402A91133FC9D860C0F880CF35EA3C4D40CE6E133F0DD960C09D427AE01C3F4D408C41BEE995D960C0E0B2CE3562404D4096CF689476DA60C0E048258B67414D4096CF689476DA60C090427AE05C424D40FC7F133F53DA60C08C71D0357E424D40CE6E133F3DDA60C028D5CE35AE424D402991133F29DA60C0D448258BE7424D40B4C4133F0BDA60C0D748258B27434D40C5E068941CDB60C0B7C5CF3582444D406030BEE9FFDB60C00CCC7AE0CC464D40274ABEE9B8DC60C0FF16268BAF494D40B4C4133FEBDD60C00036248BC74F4D402003699438DF60C04BD2258B57544D40331FBEE9B9DF60C00481CF356A574D404D146994BEDE60C0344FD03572554D404E1469943EDE60C0D748258BE7544D40F1F16894C2DD60C00C81CF35AA554D4020036994A8DD60C0700AD0351A554D408F41BEE975DD60C0F419CF3586544D40CC6E133F4DDD60C0FC80CF35EA534D409B16BEE976DD60C0483CCF35D2564D40264ABEE9D8DD60C044B6D03556594D40264ABEE918DE60C0F880CF35AA5B4D4069BE6894A0DD60C0D3B2CE35A2604D40FC7F133FE3DD60C0BFC5CF3582634D4094CF689446DE60C0A45ECF355E664D40331FBEE969DE60C060BF248BF7684D40264ABEE9C8DE60C02304258B4F684D404E1469942EDF60C08C71D035FE674D40F838BEE992DF60C0D848258B27684D40E0D5133FF1DF60C060BF248BF7684D40C827BEE92CE060C0BF107BE064674D4086B3133FD5E060C0E019CF3586654D402891133F09E160C0E319CF3586644D4096CF6894F6E060C037B6D03556634D40264ABEE9B8E060C0C82CD03566624D40F938BEE9A2E060C0F780CF356A614D402891133F09E160C0CF2CD03526604D401875BEE9E7E060C0F035248B475F4D40E3D5133FD1E060C0D048258B675E4D40B3C4133FABE160C01CE8CF354E604D402A91133F59E360C0A85ECF359E674D401E03699498E460C073557BE0BC6A4D40846CBEE9C4E460C08771D035FE6B4D40BC52BEE9ABE460C050A3CF35B66D4D40CE6E133F1DE460C030B6D03596724D402B91133FA9E460C0EC19CF3506744D40545BBEE9FEE460C0975ECF351E764D402A91133F29E560C08071D035BE784D40826CBEE934E560C018E8CF35CE7B4D40A05D133F57E560C0503CCF35D27E4D40CE6E133FADE560C04CD2258B97804D40B07DBEE91AE660C017E8CF350E824D407E25699484E660C0C4107BE024844D40C3E068949CE660C0304FD03532854D40EA63BEE9C1E660C0DFFD79E084884D4068BE689420E760C0D1FD79E0048C4D40C4E068942CE760C0D02CD035668D4D40264ABEE958E760C087427AE01C904D40244ABEE9B8E860C0304FD03572974D40BB52BEE99BE960C0697479E0149B4D408E41BEE9B5EA60C06F7479E0949E4D40050EBEE993EB60C00881CF35AAA24D40F738BEE9C2EB60C018E8CF350EA84D40545BBEE9DEEA60C014E8CF354EB34D40CD6E133F9DEA60C008CC7AE0CCB94D4087B3133F25EB60C078557BE03CBC4D406F05BEE980EB60C08471D0357EBA4D40806CBEE974EC60C08071D035FEAF4D408F41BEE9D5EC60C02D4FD035F2A84D40F2F1689442ED60C098F7CE357AA64D40A15D133FF7ED60C018E8CF350EA84D40EA63BEE9F1EE60C0E4B2CE3522A74D407C256994E4F060C028B979E0ECA84D4021036994B8F160C037D5CE35EEA84D4086B3133F15F160C027D5CE35AEA74D40C5E068946CEF60C0F419CF35C6A54D406030BEE9BFEE60C0A75ECF351EA44D407C256994C4ED60C0DCFD79E044A04D4057A2133FAFED60C08C71D035BE9F4D40040EBEE9A3ED60C01CB979E0EC9E4D40A05D133F87ED60C0284FD035729E4D402003699448ED60C057A3CF35F69D4D40F2F16894C2EC60C0F8CB7AE08C9D4D40264ABEE948EC60C0DC93D0358A9C4D40E3D5133F81EB60C090427AE05C9B4D402103699458EB60C05FBF248B779A4D40FC7F133F43EB60C017B979E02C994D4067BE6894B0EA60C00B81CF35AA944D40806CBEE9C4EA60C037B6D035D6944D40BD52BEE9DBEA60C0AC7A248B5F944D40B07DBEE9EAEA60C0D12CD035A6934D4020036994E8EA60C0888D258BFF924D409C16BEE9C6EA60C02BD5CE356E924D409C16BEE926EA60C03F3CCF35D2904D40D4FCBDE9EDE960C088427AE09C8F4D40F838BEE9D2E960C073BF248B378E4D40D4FCBDE9CDE960C048877AE0B48C4D408F41BEE9D5E960C0D7B2CE35228B4D40321FBEE939EA60C09B8D258BFF8C4D40B2C4133F8BEB60C02704258B8F8E4D40BB52BEE91BEC60C0BF2CD035E68F4D4056A2133F5FEC60C0D0FD79E0C4914D407A25699484EC60C0E819CF35C6954D401975BEE9A7EC60C0304FD03572974D40BC52BEE98BED60C0878D258B3F9A4D40D6FCBDE90DEF60C09B427AE0DC9C4D406D05BEE9A0F060C0E019CF35469E4D4021036994B8F160C08871D0357E9D4D40C5E068943CF160C018E8CF358E9B4D40020EBEE983EF60C0304FD03572974D408E41BEE925EF60C0670AD035DA954D401875BEE977EE60C0A45ECF351E924D40A15D133FF7ED60C0DBB2CE3562904D40CA27BEE9DCEC60C0E393D0354A8E4D404E1469944EEC60C0FF80CF35EA8C4D406030BEE9FFEB60C0D7B2CE35228B4D40806CBEE914EC60C061A3CF35F6884D409C16BEE956EC60C018E8CF35CE864D40CD6E133F6DEC60C040D2258BD7844D406030BEE9FFEB60C0EF19CF3546834D4068BE689450EC60C017E8CF350E824D4096CF689466EC60C014E8CF35CE804D40264ABEE948EC60C00717268BAF7F4D406030BEE9FFEB60C0D12CD035E67E4D40CA27BEE95CEC60C0533CCF35D27C4D402003699458EC60C0E048258B277A4D40E963BEE911EC60C07C0AD035DA774D402A91133FA9EB60C0BC7A248BDF764D4069BE689480EA60C093F7CE35BA754D4085B3133F45EA60C064A3CF3536754D40040EBEE943EA60C003CC7AE0CC734D40B07DBEE9AAEA60C01F04258B8F714D407B25699494EA60C087427AE05C704D402003699478E960C0BF2CD035E66A4D407C25699464E760C0EB19CF35C6624D406030BEE9BFE760C09CF7CE35BA5F4D40F638BEE9B2E760C05CA3CF35765D4D40BE52BEE95BE760C009CC7AE08C5B4D40030EBEE963E560C0E048258BA7524D40826CBEE934E560C06FBF248B37514D40BE52BEE9CBE560C0FF16268BEF4F4D40D4FCBDE9ADE660C02BB979E06C4F4D40CA27BEE93CE760C0AF7A248B5F4E4D40AE7DBEE9DAE660C08371D0357E4B4D40030EBEE963E560C0304FD035B2454D407F256994E4E460C0FB35248B87424D401875BEE9A7E460C05FBF248BF7414D40CE6E133F8DE460C0E048258B67414D402003699488E460C01704258BCF404D40826CBEE994E460C034D5CE356E3F4D40CE6E133F8DE460C087427AE0DC3E4D40CD6E133F5DE460C0D32CD035E63D4D40545BBEE98EE360C0780AD035DA3A4D4068BE689430E360C010E8CF35CE384D4085B3133FD5E160C0998D258BFF2C4D402891133FB9E160C0687479E0942A4D406E05BEE9B0E160C030B6D03596274D40F2F16894D2E160C08871D0353E264D40FC7F133F23E260C0E119CF3586264D40264ABEE988E260C0A85ECF351E274D409D16BEE9E6E260C028B979E0AC264D40BC52BEE9FBE260C0DB93D035CA254D4067BE689400E360C0A75ECF35DE214D40806CBEE9F4E260C0543CCF3592204D40EA63BEE9E1E260C07C0AD035DA1F4D404E146994DEE260C0C0C5CF35421F4D4067BE689400E360C0A05ECF355E1E4D40A15D133F47E360C094F7CE35BA1D4D40FA7F133F53E460C03BB6D035161C4D40274ABEE9A8E460C0888D258BBF1B4D40321FBEE989E560C0E019CF35061C4D401975BEE9E7E960C0E019CF3546204D409C16BEE936EB60C028D5CE356E234D408C41BEE935EC60C0F7CB7AE0CC274D40826CBEE9E4EC60C01BE8CF354E2D4D40C4E068942CED60C018E8CF354E314D4058A2133F4FED60C00FE8CF358E324D407C25699444EE60C0EB19CF3506364D40EA63BEE991EE60C0A77A248B1F394D408D41BEE9F5EE60C0473CCF35D23B4D407B25699484EF60C0304FD035F23D4D40BC52BEE92BF060C0E448258BE73D4D40030EBEE973F060C03FB6D035963B4D40F0F16894F2EF60C0D7FD79E004394D40341FBEE939EF60C04BD2258B97364D40C4E06894DCEE60C0284FD035B2344D409C16BEE9B6EE60C04C877AE0B4314D40E963BEE9D1EE60C0C72CD03566304D40BD52BEE94BEF60C04CD2258BD72F4D406030BEE9CFEF60C040B6D03516304D40321FBEE939F060C097F7CE35BA304D40B4C4133F0BF160C00FE8CF358E324D40B3C4133FFBF260C0BFC5CF35C2354D407B25699414F460C02804258B8F364D406F05BEE9E0F460C0493CCF3592354D4095CF6894A6F560C01BE8CF350E344D405E30BEE95FFC60C02304258B8F304D40321FBEE919FD60C017E8CF35CE304D403AAD68941AFD60C03F3CCF3592324D404E146994DEFC60C05FBF248BF7354D40B3C4133F7BFC60C0DD48258B67394D40A15D133F07FC60C0EC93D0354A3B4D40E1D5133FA1FC60C01CE8CF354E3B4D402A91133F69FE60C00981CF356A3A4D402A91133F69FE60C0EC93D0354A3B4D402991133FF9FD60C0EF35248B473B4D4067BE6894A0FD60C0A85ECF35DE3B4D40BC52BEE94BFD60C0CFB2CE35A23C4D409C16BEE9E6FC60C0A05ECF351E3D4D406030BEE96FFC60C0D0B2CE35223D4D40F4F1689422FB60C00B81CF352A3C4D40254ABEE988FB60C0680AD035DA3E4D402A91133F69FB60C030D5CE35EE3F4D402103699418FB60C08071D035FE404D4039AD6894EAFA60C0E4B2CE35A2434D40C3E068940CFB60C047877AE0F4454D4086B3133F65FB60C043B6D03596474D40826CBEE9E4FB60C00C81CF35AA484D409F5D133F77FC60C06C0AD0355A494D409F5D133F77FC60C098F7CE353A4A4D40F838BEE942FA60C054D2258BD74C4D40D6FCBDE9ADFA60C00436248B474D4D40806CBEE9F4FB60C0BF107BE0E44D4D40331FBEE939FC60C0D748258B274E4D40EA63BEE961FC60C0E048258B674E4D40EA63BEE911FE60C04B877AE034574D406130BEE98FFE60C00081CF35EA584D404D1469944EFF60C00881CF352A594D40321FBEE929FF60C0F8CB7AE0CC594D40C4E06894FCFE60C0E893D0350A5B4D402C91133FD9FE60C054877AE0B45B4D40D5FCBDE92DFF60C03F3CCF35525D4D40264ABEE9B8FF60C0D7B2CE35625F4D40C3E068944C0061C0CF2CD03526614D40C5E06894BC0061C0C82CD035E6614D409B16BEE9060161C007CC7AE0CC624D40A05D133FD70161C0B47A248BDF664D40CE6E133F5D0261C0DBFD79E004684D40D6FCBDE9ED0161C070BF248BB7694D40E963BEE9D1FE60C04CD2258B576E4D407C25699444FE60C065A3CF35766F4D40E0D5133FC1FD60C037B6D035D6704D40254ABEE9F8FD60C0700AD0359A6E4D40545BBEE95EFD60C0BFC5CF35826E4D4096CF689446F860C058A3CF35B6714D40C4E06894BCF860C00436248BC7734D40311FBEE989F960C0503CCF35D2744D4056A2133FEFFD60C00036248B47754D402C91133FD9FE60C0687479E014764D40CE6E133FADFE60C0C42CD035E6744D40C2E068946CFE60C0BFC5CF3542744D40E0D5133FC1FD60C050A3CF3576734D40E963BEE931FE60C037D5CE352E724D40E2D5133F710061C0F880CF35EA6D4D4086B3133FF50061C088F7CE357A6D4D40D06E133F7D0161C04FA3CF35366E4D4096CF6894860161C0204FD035326F4D40F3F16894A20161C008CC7AE0CC6F4D40B4C4133FBB0161C08FF7CE357A704D40B07DBEE9BA0161C058A3CF35B6714D40CF6E133F9D0161C0284FD035B2724D40EA63BEE9310161C0DBFD79E004754D40D5FCBDE90D0161C0687479E014764D404E146994CE0161C00CE8CF350E774D409041BEE9750261C0E048258B27794D407C256994F40261C0FF16268BAF7B4D40CA27BEE93C0361C02F4FD035F27D4D407C256994540361C0878D258BBF7F4D40FB7F133F530361C03BD5CE35EE804D40FC7F133F630361C01F4FD035F2814D40CA27BEE9AC0361C0EF19CF3546834D40B3C4133F0B0461C00481CF352A844D40264ABEE9880461C08F8D258BBF844D402A91133F090561C02C04258BCF844D40E1D5133F710561C0C4107BE024844D407D256994F40461C04B877AE0F4824D40565BBEE98E0461C0CF2CD035E6804D406D05BEE9700461C0284FD035B27E4D40321FBEE9C90461C03F3CCF35127D4D40F838BEE9820461C060BF248B377A4D407C256994540561C0E148258BA7784D40311FBEE9790661C01904258B8F774D406E05BEE9300761C0687479E014764D40F3F16894E20461C0DCB2CE3562774D40806CBEE9C40361C05BA3CF3576774D40CA27BEE93C0361C064A3CF3536754D403AAD6894BA0361C02CB979E06C744D40331FBEE9E90361C0BFC5CF3542744D40331FBEE9E90361C050A3CF3576734D4086B3133F550361C03FD2258B97724D40545BBEE91E0361C078557BE03C704D40F2F16894320361C0F035248B476D4D40321FBEE9790361C0C4107BE0A46A4D40040EBEE9430461C027D5CE352E674D40545BBEE95E0461C0B47A248BDF654D40FC7F133F630461C0DDB2CE35A2644D40BC52BEE97B0461C0AC5ECF351E644D407D256994B40461C051D2258B97634D40B07DBEE91A0561C03BB6D03556624D408D41BEE9B50661C0740AD0351A604D40C4E068949C0861C02804258BCF614D40C3E068943C0C61C087F7CE353A674D40C3E068943C0C61C0DBFD79E004684D40274ABEE9080A61C0A85ECF359E674D40EA63BEE9E10861C02704258B0F684D40D5FCBDE94D0861C0DFFD79E0C4694D4086B3133F350961C033D5CE35AE694D409C16BEE9060C61C0C4107BE0A46A4D406F05BEE9A00D61C0F835248B87694D409C16BEE9760E61C0D9FD79E084694D40836CBEE9340F61C0737479E0146B4D4095CF6894C60F61C0700AD0359A6E4D406C05BEE9401061C0E5FD79E0C4734D401E036994581061C0D02CD035A6784D4069BE6894C00F61C0473CCF35527B4D4069BE6894C00F61C0E719CF35467C4D4096CF6894D61061C0690AD035DA7B4D402A91133F691161C004CC7AE08C7A4D4056A2133F5F1261C064A3CF3536754D4085B3133F751461C018E8CF35CE7B4D40E0D5133F911561C0700AD0355A804D40D7FCBDE92D1661C0FFCB7AE04C824D4020036994C81661C0EF19CF3546834D409D16BEE9761361C0BFC5CF3542744D4086B3133F451461C0CC2CD03526724D40BD52BEE90B1561C0EC93D0350A734D404C146994CE1561C08C71D035FE744D4066BE6894901661C0687479E014764D4021036994F81661C0938D258B3F764D40FB7F133F831761C060A3CF35B6764D403AAD68940A1861C0CF48258B67774D40AD7DBEE9DA1861C0BC107BE064794D40301FBEE9791A61C054877AE0747A4D40CA27BEE9EC1A61C090427AE01C7B4D409C16BEE9061C61C02F4FD035F27D4D40C4E068945C1D61C0888D258B3F804D401E036994481E61C0B0107BE0E4824D403AAD68946A2061C0BCC5CF35C2864D401775BEE9072161C09FF4258BA3884D402FD86894792161C037B6D035D6884D40A05D133FE72161C0D048258B27884D40B80B69940B2261C050D2258B17874D40050EBEE9032261C0A35ECF359E854D40B3C4133F9B2161C00817268BEF844D40D6FCBDE9ED2061C02004258B4F844D40E863BEE9412061C0FF35248BC7824D408F41BEE9151F61C0D12CD035E67E4D40CB27BEE9BC1D61C0344FD035F27B4D40264ABEE9281D61C0E048258B277A4D40B4C4133FEB1C61C07C0AD0355A774D406030BEE95F1D61C0DFFD79E0C4754D403AAD68946A2061C0687479E014764D40301FBEE9F92061C0700AD035DA744D40D3FCBDE90D2261C0E3B2CE35E26F4D40B27DBEE9BA2261C009CC7AE04C6F4D40A05D133F472361C0B8107BE0E46D4D4096CF6894262461C0C4107BE0A46A4D4096CF6894262461C0DFFD79E0C4694D40C4E068947C2361C0757479E0146A4D401875BEE9C72261C07F71D0353E6B4D4056A2133F1F2261C0D8B2CE35E26C4D406D05BEE9102161C00481CF356A704D4038AD68947A2061C0CB2CD035A6714D407B256994D41F61C0750AD0355A724D40B07DBEE9AA1C61C087F7CE353A724D4059A2133FEF1A61C060A3CF35F6704D4068BE6894801A61C0543CCF3552704D40B3C4133F2B1A61C0334FD035726F4D406030BEE9FF1961C0770AD0355A6E4D40A15D133FF71961C0B7107BE0646D4D40846CBEE9E41961C068BF248B776C4D403AAD68949A1961C0D7FD79E0846B4D40030EBEE9531961C0770AD0355A6D4D40CE6E133FDD1861C018E8CF35CE6E4D4022036994481861C06CBF248BB76F4D401775BEE9A71761C0E3B2CE35E26F4D401775BEE9471761C0F880CF356A6F4D401E036994581661C0B0C5CF35426D4D408F41BEE9951561C0FF80CF352A6D4D40CE6E133F3D1561C02CD5CE35EE6C4D401675BEE9E71461C08771D035FE6B4D40040EBEE9931461C08871D0357E6B4D402A91133F091461C03F3CCF35526B4D40CD6E133F7D1361C077557BE07C6B4D40CF6E133FCD1261C043B6D035966C4D402A91133F791261C00436248B076C4D40A15D133F271261C0975ECF351E6B4D408C41BEE9D51161C0C4107BE0A46A4D40C2E068944C1161C0E548258B276A4D40FD7F133F830F61C0740AD0355A664D403AAD6894DA0F61C00481CF356A644D40E0D5133F611061C0D32CD035E6634D40301FBEE9F91061C050877AE0F4634D40826CBEE9841161C098F7CE35BA634D401775BEE9471161C0EB19CF35C6624D40BB52BEE91B1261C07B0AD0359A644D401775BEE9D71261C0E893D0358A674D40CA27BEE9AC1361C0E448258BA7694D40BD52BEE9CB1461C060BF248BF7684D40040EBEE9931461C087F7CE353A674D40254ABEE9181461C098427AE01C674D4056A2133F5F1261C098F7CE35BA634D402891133FA91261C0E193D0350A634D40CA27BEE9FC1261C050A3CF35B6624D4096CF6894561361C0C02CD035A6624D407A256994B41361C0EB19CF35C6624D4096CF6894061261C0A75ECF355E614D401775BEE9671161C0CF2CD03526604D40D5FCBDE9ED1061C0CF2CD03526604D402991133FB91061C060A3CF35B65F4D40E0D5133FA11061C03FD2258BD75E4D409B16BEE9B61061C0E548258B275E4D40050EBEE9D31061C077557BE07C5D4D40F938BEE9D21061C0C82CD035A65C4D401875BEE9A71061C07B557BE0FC5A4D40E863BEE9811061C0DF48258BE7594D401675BEE9371061C0707479E054594D40EA63BEE9A10F61C00881CF352A594D406E05BEE9400F61C0AD5ECF359E584D40BC52BEE97B0E61C040877AE034564D406F05BEE9000E61C00C81CF35AA554D40806CBEE9740E61C06BBF248B37584D40D6FCBDE91D0F61C0EC93D0350A5A4D4096CF6894B60F61C027D5CE352E5C4D401E036994F80F61C060A3CF35B65F4D40CE6E133FBD0F61C0CC2CD035E65F4D4021036994480C61C02104258BCF5C4D407A256994040C61C027D5CE352E5C4D40321FBEE9C90B61C0EB19CF35065B4D40FC7F133F530B61C043B6D035D6594D4095CF6894F60A61C0D1FD79E084584D40264ABEE9080B61C0F816268BEF564D40535BBEE95E0B61C0334FD035F2554D40E2D5133FB10C61C0FC80CF35EA534D40CA27BEE99C0E61C00036248BC74F4D40F838BEE9A20F61C0FB35248B874E4D405F30BEE99F1061C060BF248B774F4D40F938BEE9D21061C04CD2258B974E4D40BA52BEE99B0F61C058A3CF35364C4D40836CBEE9340F61C0C5107BE0E44B4D401775BEE9D70E61C0740AD0355A4C4D40264ABEE9C80D61C060BF248B774F4D4096CF6894D60C61C047D2258B17504D40F0F16894120C61C0483CCF35124F4D409F5D133F570B61C03FD2258B974D4D40C727BEE97C0A61C054D2258BD74C4D4086B3133FB50A61C0D02CD035E64D4D4086B3133F450B61C0DCFD79E0844F4D40EA63BEE9610B61C02BB979E06C504D40F638BEE9420B61C090F7CE35BA514D40545BBEE9FE0A61C0314FD03532524D40F938BEE9B20A61C061A3CF3536524D40C727BEE97C0A61C037B6D03516524D408C41BEE9250A61C048D2258B97514D40040EBEE9E30961C0BB7A248BDF504D401775BEE9A70961C0E893D0358A504D4069BE6894600961C06FBF248B37514D40F2F16894820961C06C7479E0D4524D401875BEE9870961C0AFC5CF3542544D4069BE6894600961C00C81CF35AA554D40321FBEE9F90861C0C4C5CF3582544D40C3E06894DC0561C04CD2258B974E4D40C3E06894DC0561C068BF248BB74D4D401875BEE9270661C047877AE0B44D4D40B1C4133F5B0661C0B0C5CF35824D4D406C05BEE9C00661C054D2258BD74C4D401F036994780661C0403CCF35124C4D404D146994AE0561C06C0AD0355A494D408E41BEE9250561C02DB979E02C494D40EA63BEE9910461C0F780CF356A494D4039AD68941A0461C014E8CF350E494D40331FBEE9E90361C0E0B2CE3522474D40826CBEE9140461C0CF2CD035A6464D40FD7F133F730461C0FF80CF35AA464D40EA63BEE9D10461C0AFC5CF3542464D40C4E06894FC0461C0E793D0358A444D4084B3133F350561C06F0AD0355A434D40AF7DBEE9BA0561C07D557BE0FC424D406C05BEE9C00661C0D748258B27434D40AE7DBEE95A0661C0CC2CD03526414D40826CBEE9C40561C064BF248BF7404D40EA63BEE9910461C090427AE05C424D4021036994380461C09B8D258B7F424D40040EBEE9A30261C0780AD0351A424D40E1D5133FA10261C040877AE074414D40BC52BEE9CB0261C0770AD0359A404D40F0F16894D20261C08871D035BE3F4D40C927BEE9BC0261C0D32CD035E63E4D40F0F16894B20261C0E093D0350A3E4D40836CBEE9940261C0E3B2CE35623D4D40010EBEE9430261C0A05ECF351E3D4D404F146994FE0161C03F877AE0B43C4D406D05BEE9F00161C050A3CF35B63B4D409C16BEE9F60161C0D893D0358A3A4D40CE6E133FED0161C0D793D0358A394D4020036994280161C033D5CE35EE324D40B17DBEE9DA0061C039D5CE35AE314D4085B3133FD50161C0E4FD79E0042E4D406C05BEE9700261C073557BE03C2C4D40FC7F133F230361C098F7CE357A2B4D407A256994140461C0483CCF35122B4D403AAD6894FA0561C0DFFD79E044294D40AF7DBEE9BA0861C02C04258B0F284D40FC7F133F330961C087F7CE35BA284D406F05BEE9100961C054877AE0342A4D40846CBEE9B40861C034D5CE35AE2B4D4067BE6894800861C07C0AD0355A2C4D401875BEE9B70861C00336248B072E4D40C727BEE97C0A61C0F8CB7AE04C344D40CE6E133F8D0A61C03F877AE0B4304D4038AD6894FA0A61C0C42CD03526304D40264ABEE9180D61C088427AE05C324D4068BE6894B00E61C090427AE05C354D40311FBEE9690F61C0E893D0350A364D402891133FA90F61C0FD35248B87364D40826CBEE9F40F61C078557BE07C384D4067BE6894301061C00481CF35AA384D404F1469946E1061C05F7479E0D4374D40826CBEE9541061C0EF19CF35C6364D401E036994F80F61C04CD2258B17354D40F1F16894021061C0E993D0354A314D40BD52BEE97B1061C03CD5CE35AE304D40FC7F133F331161C063A3CF35F6304D40806CBEE9F41161C04CD2258BD72F4D40BD52BEE9AB1161C0F019CF35862F4D40244ABEE9781161C028D5CE35EE2E4D406D05BEE9501161C098427AE05C2E4D40BA52BEE92B1161C0730AD0351A2E4D40C2E06894CC1061C03FD2258BD72D4D402A91133F391061C00481CF35AA2C4D401E036994F80F61C07C0AD0355A2C4D40515BBEE95E0F61C0BF2CD035662C4D40FD7F133F630F61C0730AD0351A2D4D40545BBEE98E0F61C0FC80CF356A2E4D40311FBEE9690F61C0687479E054304D4086B3133F250F61C037B6D03556314D40535BBEE9EE0E61C090F7CE357A314D40244ABEE9380E61C017E8CF35CE304D40254ABEE9580D61C017E8CF35CE304D4057A2133F1F0D61C014E8CF358E304D40040EBEE9030D61C0878D258BFF2F4D408E41BEE9F50C61C0C72CD035662F4D407C256994E40C61C013E8CF350E2F4D408F41BEE9150C61C088F7CE35FA2D4D40030EBEE9B30B61C0730AD0351A2D4D4083B3133F950B61C008CC7AE08C2B4D40806CBEE9940B61C04FA3CF3576284D40BB52BEE9DB0B61C048D2258B57264D40816CBEE9840C61C087F7CE35BA264D40836CBEE9E40D61C06F0AD035DA284D4085B3133FC50F61C0878D258B3F284D401F036994681061C06F0AD035DA284D40311FBEE9991061C0BCC5CF3582294D402991133FB91061C0D0B2CE35622A4D406F05BEE9E01061C0D32CD035262B4D40BA52BEE92B1161C098F7CE357A2B4D40535BBEE99E1161C0670AD0359A2B4D40F2F16894021261C0988D258BFF2B4D40CE6E133F5D1261C02F4FD035B22C4D408E41BEE9B51261C051877AE0B42D4D403CAD68942A1361C047877AE0F42D4D40B4C4133FDB1361C00DCC7AE04C2D4D40020EBEE9031561C098F7CE357A2B4D4079256994641261C08F427AE01C244D40CA27BEE91C1261C0707479E094234D40E1D5133FF11161C09CF7CE35BA224D40806CBEE9F41161C08871D035FE204D40A15D133F271261C00781CF35EA1F4D4068BE6894F01261C097427AE01C1D4D408B41BEE9251361C008CC7AE08C1C4D40826CBEE9441461C0C82CD035261D4D4085B3133F751461C0ED19CF35061D4D407F6CBEE9D41461C088F7CE353A1C4D408E41BEE9451561C048877AE0341C4D401775BEE9B71561C064A3CF35B61C4D40B2C4133F1B1661C08C71D0357E1D4D4058A2133F9F1661C08571D035BE1F4D40040EBEE9C31661C0F880CF356A224D40C4E068946C1661C0A77A248B5F244D40264ABEE9781561C08471D0357E244D40525BBEE97E1561C0DDB2CE3522254D403AAD68949A1561C02004258B8F264D40BC52BEE9AB1561C097427AE01C274D40020EBEE9331661C01704258B4F264D40E0D5133FC11661C0AB5ECF351E264D4086B3133F351761C0CC2CD035A6264D4069BE6894701761C02C04258B0F284D406130BEE9AF1761C047877AE034274D407B256994041861C050877AE074264D40E2D5133F611861C010E8CF350E264D4039AD6894BA1861C078557BE03C264D40FB7F133F131961C067BF248B37274D40F3F16894F21861C053A3CF35F6274D408E41BEE9B51861C067557BE0BC284D4039AD6894BA1861C015E8CF35CE294D401F036994381961C037B6D035962A4D406ABE6894701A61C0707479E0D4284D40BD52BEE92B1B61C015E8CF35CE294D40BC52BEE9FB1A61C0A05ECF355E2A4D40264ABEE9A81A61C0EF19CF35C62B4D40301FBEE9791A61C07C0AD0355A2C4D40826CBEE9C41A61C0E0B2CE35222E4D40535BBEE91E1B61C050A3CF35B62F4D402991133F891B61C0334FD035F2304D409C16BEE9061C61C039D5CE35AE314D40254ABEE9181C61C0C4C5CF35822E4D40BE52BEE97B1C61C0AFC5CF35C22C4D403BAD6894EA1C61C0DC48258BE72C4D404D1469941E1D61C0344FD035722F4D40254ABEE9781D61C0E893D035CA314D40E963BEE9511E61C0D793D0354A334D409A16BEE9561F61C06C7479E014344D401975BEE9372061C0F8CB7AE04C344D4038AD6894BA2061C0A85ECF351E344D40311FBEE9292261C00FE8CF358E324D40EA63BEE9812261C037B6D03556324D401875BEE9972361C00FE8CF358E324D407D256994342461C0A45ECF355E334D4086B3133F552661C00481CF35AA384D40F0F16894522861C00981CF356A3A4D40301FBEE9992961C0DCFD79E0C43C4D40CA27BEE94C2A61C0EF19CF35863D4D40826CBEE9E42A61C0737479E0543F4D407A256994242B61C08871D035BE3F4D40321FBEE9992B61C0E019CF3506404D408E41BEE9152F61C058A3CF35F6464D401875BEE9973061C0E893D0354A484D40F2F16894023261C0DCB2CE35A24B4D40020EBEE9D33261C054D2258BD74C4D40CF6E133FDD3361C0D8B2CE35224D4D40806CBEE9343461C03FD2258B974D4D40B6C4133FEB3361C04CD2258B974E4D40B2C4133F6B3361C0483CCF35124F4D40E1D5133F413261C0780AD0351A4F4D40C3E06894BC3161C060BF248B774F4D40E2D5133F713061C07F71D0353E524D40C827BEE9FC2F61C058A3CF35F6524D40D5FCBDE97D2F61C00317268B2F534D4097CF6894762E61C05FA3CF3536534D4086B3133F052E61C0FC80CF35EA534D4086B3133FA52E61C003CC7AE00C564D408C41BEE9052F61C073557BE0FC564D40826CBEE9542F61C00481CF356A574D4039AD6894DA2F61C03FB6D03516574D40E2D5133FB13061C00B81CF352A554D40F738BEE9323161C050A3CF35B6544D40EA63BEE9213261C06B7479E054544D40FB7F133F933461C06FBF248B37514D408E41BEE9753561C018E8CF350E514D406D05BEE9B03561C08071D035BE524D40C5E06894DC3561C02704258B4F554D40CD6E133F8D3661C0680AD035DA574D40020EBEE9D33B61C0E0FD79E004624D407A256994943C61C0BC7A248B1F644D404C146994DE3C61C00881CF35AA644D408E41BEE9453D61C00817268B2F654D40F2F16894A23D61C0730AD035DA654D403AAD6894CA3D61C0D993D035CA664D40535BBEE9BE3D61C00C81CF356A684D40E963BEE9913D61C0607479E0D46A4D40F838BEE9923D61C068BF248B776C4D409F5D133F373E61C038D5CE35AE714D406030BEE97F3F61C0C0C5CF35C2754D4039AD6894EA4561C0EF19CF3546834D4095CF6894064861C0B37A248B1F864D4058A2133FFF4861C067557BE0FC874D4096CF6894364961C038B6D035568A4D40B07DBEE99A4B61C05BA3CF35368A4D40030EBEE9C34C61C00881CF35AA8A4D40C827BEE9CC4D61C0AFC5CF35028C4D40EB63BEE9C14C61C0E0B2CE35E28B4D40FC7F133F434C61C0D7B2CE35228C4D4086B3133FD54B61C04FA3CF35F68C4D408F41BEE9B54D61C068557BE03C8E4D4094CF6894E65161C04CD2258B978D4D4086B3133F855361C0DBB2CE3562904D40B4C4133F4B5161C023B979E0AC8F4D40274ABEE9385061C05CA3CF35F68F4D407C256994C44F61C09BF7CE35BA914D40CA27BEE9CC4F61C090427AE01C934D4085B3133FD54F61C003CC7AE08C934D4086B3133F754F61C0C02CD03526954D40E863BEE9214F61C037B6D035D6954D40301FBEE9494E61C0E093D0358A964D40816CBEE9044E61C0304FD03572974D40555BBEE95E4E61C0EF35248B87984D40CD6E133FDD5161C0DB48258B27974D40264ABEE9A85261C0E348258BE7954D40F838BEE9125361C0AB5ECF359E954D40CE6E133F1D5461C0AB5ECF359E954D403AAD68949A5461C0680AD0355A954D403BAD6894EA5461C074557BE0FC944D407D256994845461C04FA3CF35B6934D40C727BEE92C5461C044877AE034924D404E146994FE5461C00117268B2F944D409A16BEE9065661C0D048258BA7964D40EA63BEE9415761C054A3CF3576984D40F0F16894A25861C0677479E094994D40C3E068940C5A61C098F7CE357A9B4D40FB7F133FD35A61C060A3CF35369D4D40321FBEE9695F61C037D5CE352EA34D4097CF6894966661C037D5CE35EEA84D40826CBEE9E46561C0E0B2CE35A2A94D40B4C4133F6B6461C064A3CF35B6A74D4039AD6894BA6361C018E8CF350EA84D404D146994EE6461C0C4C5CF3502AB4D409B16BEE9466561C0F8CB7AE08CAB4D40040EBEE9D36561C02FD5CE35AEAB4D407C256994746661C07771D0357EAB4D40B4C4133F0B6761C01804258B8FAB4D40B6C4133F7B6761C0C0C5CF3582AC4D40826CBEE9946761C040B6D03516AE4D404E1469945E6761C0DDB2CE3522AF4D40F2F16894426761C051877AE0F4AF4D404F146994AE6761C0D893D035CAB04D40B4C4133F1B6861C0513CCF35D2B04D406C05BEE9B06861C0D02CD03566B04D40806CBEE9346961C0DCB2CE35A2AF4D40D5FCBDE96D6961C00B17268BAFAE4D401775BEE9B76961C0A75ECF35DEAC4D40C4E068946C6A61C0E493D0358AAD4D40AF7DBEE94A6B61C0AD5ECF351EAF4D407D256994146C61C08071D035FEAF4D404D1469940E6D61C030D5CE356EB04D401875BEE9476E61C098427AE09CB14D40E963BEE9716F61C00036248B47B34D40D6FCBDE93D7061C08471D0353EB54D40EB63BEE9B16D61C0C42CD03566B34D40040EBEE9736C61C02FD5CE35EEB04D40EA63BEE9B16B61C028B979E0ACB04D40535BBEE9EE6A61C00436248B47B14D40F3F16894526A61C0A95ECF359EB24D4087B3133FA56B61C0493CCF3592B44D40CE6E133F5D6C61C0DFB2CE3522B54D407C256994F46C61C0E0FD79E0C4B44D40CB27BEE98C6D61C049D2258B17B44D40E1D5133F316E61C028D5CE352EB44D40EA63BEE9D16E61C0DF93D035CAB44D40D6FCBDE93D7061C08871D035FEB64D4038AD6894CA7061C0A85ECF355EB84D401E036994187161C02804258BCFB84D40321FBEE9197361C08471D0357EBA4D40C2E068946C7B61C017B979E0ECC54D4058A2133FBF7A61C0DF93D0358AC74D40E3D5133F817861C0B17A248B1FC64D40264ABEE9787761C060BF248BB7C64D40C4E068948C7761C06CBF248B37C74D4066BE6894B07761C000CC7AE08CC84D409C16BEE9067761C0314FD03572C84D40F1F16894827661C06F557BE0FCC84D409C16BEE9167661C048877AE034CA4D402B91133FB97561C0A85ECF351ECC4D409D5D133F677561C0F7CB7AE0CCCA4D40AE7DBEE90A7561C00781CF35AAC94D40F838BEE9A27461C01704258B4FC94D40C4E068942C7461C0F8CB7AE04CCA4D402B91133F697461C018B979E02CCB4D4058A2133FEF7361C055877AE034CC4D40CA27BEE96C7261C00481CF35AACE4D40C5E06894EC7261C00417268BAFCF4D40264ABEE9887261C0A85ECF35DED14D404E146994DE7061C0D893D035CAD64D40C4E068945C6F61C00381CF352ADA4D408E41BEE9256F61C07B0AD035DADB4D409D16BEE9367161C0D32CD035E6E04D40E2D5133F717161C0C5107BE0E4E14D40C4E06894FC7161C094427AE0DCE24D40D6FCBDE94D7261C0B8107BE024E54D40826CBEE9A47261C0FC80CF35EAE94D403AAD68947A7361C0E093D0358AEE4D406130BEE9DF7361C040877AE0F4F14D4069BE6894A07361C0E719CF3586F34D408E41BEE9457361C0533CCF3512F44D40F638BEE9A27261C088F7CE357AF64D406D05BEE9507261C0F419CF3506F74D40040EBEE9E37161C0BCC5CF3542F74D409D16BEE9767161C0B8107BE0E4F74D40F738BEE9B27061C098F7CE35BAF94D40F2F16894C26F61C0EC19CF3506FE4D407C256994246F61C027D5CE352EFF4D40CC6E133F5D6E61C0697479E094FD4D40F1F16894C26D61C0E019CF3586FB4D4058A2133FDF6B61C0F419CF3506F74D40050EBEE9C36961C037D5CE35AEEE4D40C827BEE9AC6961C0617479E094EC4D40CB27BEE9AC6A61C0975ECF351EE84D403AAD6894FA6A61C017B979E0ACE44D40254ABEE9F86A61C09BF7CE35FAE24D40CD6E133FBD6A61C094F7CE357ADE4D406B05BEE9F06A61C0F319CF3506DD4D40EA63BEE9F16A61C060A3CF3536DC4D407C256994746A61C087427AE09CDB4D40EB63BEE9316A61C0D7FD79E004DB4D409B16BEE9F66961C0DF93D0354ADA4D40D6FCBDE9DD6961C0E4B2CE35A2D94D40FB7F133FB36961C0D8B2CE3522D74D40F3F16894E26861C050A3CF35B6D24D40D5FCBDE98D6861C0D793D0358ACF4D40BC52BEE92B6961C038D5CE356ECF4D40F838BEE9F26961C0DDB2CE35E2CE4D40F1F16894A26A61C0E819CF3506CE4D403AAD6894FA6A61C00D81CF35EACC4D409D16BEE9466961C0988D258BBFC94D40321FBEE9A96861C054D2258B57C94D405E30BEE94F6861C0A85ECF351ECA4D404E1469943E6761C0D793D0358ACF4D40040EBEE9836761C0503CCF3512D14D4058A2133F5F6861C0A87A248B5FD44D40D5FCBDE98D6861C0B9C5CF3542D54D40B2C4133F8B6861C06F0AD0355AD94D4038AD68949A6861C0F835248B87DB4D408E41BEE9C56861C0750AD0359ADD4D40FC7F133FF36861C08C71D0353EDE4D40B17DBEE92A6961C067557BE07CDE4D40331FBEE9596961C003CC7AE00CDF4D40D5FCBDE96D6961C00781CF35AAE04D40F1F16894526961C00CE8CF354EE14D40F838BEE9D26861C0F9CB7AE04CE34D40321FBEE9A96861C068BF248BB7E34D40CE6E133F6D6861C0687479E094E44D40F2F16894F26861C027B979E0ECE84D40244ABEE9F86861C050A3CF35B6EA4D401975BEE9776861C097F7CE35BAEB4D40555BBEE98E6561C0E448258BE7EC4D40301FBEE9296161C0C82CD03566EC4D40321FBEE9596061C03CB6D035D6EB4D409B16BEE9065F61C0D893D0358AE84D406030BEE93F5E61C02004258B4FE74D40E0D5133F715D61C0E893D0350AE74D40A05D133FB75C61C037B6D03516E84D40FA38BEE9225D61C0E819CF3506E84D408E41BEE9855D61C034D5CE352EE84D40545BBEE93E5E61C058A3CF35F6E84D406C05BEE9706061C0E819CF35C6ED4D401875BEE9E76061C0E719CF3546EE4D406230BEE9FF6661C08071D0357EEF4D408C41BEE9A56761C020B979E06CF04D409F5D133F476A61C0D348258B27F84D404D1469945E6B61C0EF19CF3586F94D402A91133FC96B61C007E8CF354EFB4D4086B3133F256C61C03FB6D03556FD4D40CA27BEE97C6C61C0B0107BE0E4FE4D40F4F16894326D61C08471D0353E004E402A91133FC96E61C0B8C5CF3582014E40A05D133F776F61C0A85ECF35DE024E40B3C4133F3B7061C050877AE0F4054E40B4C4133FAB7061C044D2258B97064E4086B3133F557161C060A3CF35F6054E406030BEE95F7161C0EB19CF35C6044E40545BBEE98E7261C00D17268BEF004E40CA27BEE9DC7261C03F877AE074FE4D40FC7F133FB37261C0ED93D0358AFB4D409B16BEE9B67261C0988D258B3FFA4D40B3C4133FFB7261C098F7CE35BAF94D402C91133F097461C00036248B87F94D40E2D5133F117561C0EB19CF35C6F84D409F5D133F977661C06C557BE0FCF54D409C16BEE9867761C0670AD0351AF34D40BC52BEE96B7961C037B6D03556ED4D40B2C4133F2B7B61C0D8B2CE35E2E84D40311FBEE9A97E61C065A3CF35B6E54D40D4FCBDE95D8161C0DF19CF3586E24D40F838BEE9628461C050A3CF35B6DE4D40F3F16894228861C0C02CD035E6DA4D40010EBEE9538A61C0BFC5CF35C2D94D40301FBEE9099061C0E0FD79E044DA4D404D146994BE9361C0F716268BAFDA4D40F738BEE9129661C058A3CF35F6DB4D401975BEE9679861C09BF7CE353ADD4D40525BBEE99E9B61C027D5CE356EDF4D4066BE689450A061C018B979E02CE54D405D30BEE9AFA361C087427AE09CE74D408D41BEE9C5A861C02B4FD035B2EC4D408E41BEE945AB61C07D0AD0359AEE4D4095CF6894B6AD61C0D7B2CE35A2EF4D40A05D133F87AE61C0DF48258BE7F04D40B1C4133FFBAE61C049D2258B97F34D40826CBEE9A4AE61C040D2258B57F54D40B17DBEE9EAAD61C0FD80CF356AF64D40F2F1689432AD61C0F419CF3506F74D401675BEE9E7AD61C071BF248BB7F54D404F1469943EAE61C0F135248BC7F44D40A05D133F87AE61C0E719CF3586F34D40826CBEE904AE61C063A3CF35B6F24D40254ABEE938AD61C0304FD03532F34D40CB6E133F4DAB61C0EF35248BC7F54D40274ABEE918AB61C0D7B2CE3562F64D409C16BEE9D6AA61C03CB6D035D6F64D40525BBEE90EAA61C09CF7CE353AF74D409D5D133F17A961C0E793D0354AF84D40535BBEE9CEA861C0EB19CF35C6F84D40D4FCBDE98DA861C01B04258B4FFA4D40FD7F133F63A861C0FB80CF35AAFC4D40F838BEE952A861C0BFC5CF3542FF4D40525BBEE95EA861C0B8C5CF3582014E40F4F1689492A861C05FBF248BB7034E408D41BEE9E5A861C0B0107BE0A4054E40321FBEE959A961C08771D0353E074E40BB52BEE9EBA961C0B0C5CF3582084E40FE7F133FB3A961C02FD5CE356E084E409C16BEE906A961C0B0C5CF3582084E40F838BEE9C2A961C008CC7AE00C0B4E408B41BEE915AB61C0C4107BE0A40C4E4085B3133F25AC61C0717479E0940E4E408E41BEE915AC61C02C4FD03532124E40E1D5133F31AE61C09B5ECF355E114E406C05BEE930AF61C0C1107BE024104E402003699448AF61C070BF248B370E4E405F30BEE98FAE61C0E993D0350A0A4E4058A2133F4FAE61C050A3CF3576094E4069BE6894D0AD61C07871D0353E094E404E1469946EAD61C0CB2CD035A6084E401775BEE9C7AC61C0B8C5CF35C2064E402A91133F59AC61C054877AE074044E40F638BEE992AC61C04B3CCF35D2024E40E4D5133F41AD61C02FB6D035D6014E40555BBEE91EAF61C0E348258B27014E40826CBEE9A4B361C0EC93D0350AFC4D40CF6E133F8DB561C0E019CF3506FB4D40E963BEE971B761C0F835248B47FB4D40B4C4133F9BBC61C06CBF248BF7004E40F838BEE902BF61C0700AD0359A034E4085B3133F55C361C0E1FD79E084044E40040EBEE953C661C0B8C5CF35C2064E4069BE689440CB61C00881CF35AA084E40254ABEE998CF61C067BF248BB7094E401775BEE977D461C089427AE01C0D4E40CE6E133F8DD961C0D7B2CE35620E4E40555BBEE96EDF61C03FB6D035D60B4E40020EBEE943E661C00881CF35AA084E4020036994D8EE61C0B8C5CF35C2064E40EA63BEE981F361C0737479E054064E4085B3133FF5F761C0B0C5CF3542034E4058A2133F9FFB61C008CC7AE00C004E4085B3133F65FD61C0985ECF359EFF4D40B4C4133F5B0162C06F7479E094034E40EA63BEE9610362C014E8CF350E044E40C727BEE9FC0762C0D1B2CE3522044E40FC7F133F430462C03FB6D03516054E406C05BEE9000162C097427AE05C044E40806CBEE9140062C03FB6D03516054E407C256994A40062C093427AE0DC074E406030BEE99F0162C0344FD035320A4E40FB7F133F930662C05F7479E094124E40FC7F133F030762C0EF19CF3506134E4097CF6894A60762C0C02CD03526134E40816CBEE9140862C0D993D035CA134E4086B3133FB50762C00817268B2F154E407C256994940662C03CD5CE356E174E40EC63BEE9510662C0483CCF3592174E40244ABEE9180662C0D1B2CE35E2174E406ABE6894000662C0E193D035CA184E4087B3133F150662C01F04258BCF194E402891133F490662C0403CCF35521A4E40B4C4133F8B0662C0F035248B471A4E40244ABEE9C80662C00381CF35AA194E40040EBEE9E30762C028D5CE352E184E4057A2133F1F0B62C08471D035BE194E406ABE6894600C62C0F916268B2F194E4068BE6894F00B62C0DCFD79E084174E403CAD68945A0E62C0483CCF3592164E40806CBEE9D40E62C040877AE0F4164E40F4F16894520F62C0BF2CD035E6174E40BC52BEE98B0F62C0737479E014194E40A05D133F370F62C0C4107BE0241A4E40040EBEE9B30F62C030D5CE35AE1B4E40D6FCBDE98D1062C0D8B2CE35E21A4E406C05BEE9801162C0EF19CF3546194E4096CF6894461262C0C02CD03566184E4059A2133F3F1362C0C4107BE024194E4058A2133F0F1562C0503CCF35921B4E40A05D133F071662C0BCC5CF35C21C4E40FB7F133F931562C0888D258BFF1C4E40D5FCBDE92D1562C030D5CE35AE1C4E4096CF6894E61462C03F877AE0341C4E40B07DBEE97A1462C01CE8CF35CE1B4E40C6E068948C1462C088F7CE357A1C4E40F638BEE9221562C0DFB2CE35621F4E4039AD68943A1662C0D0B2CE35E2224E406230BEE98F1762C0CF48258B67244E40F738BEE9E21762C02804258B0F254E4068BE6894301862C00881CF35EA254E40F538BEE9A21862C08171D035BE264E409B16BEE9161962C0FF80CF352A274E403CAD68946A1962C02004258BCF264E40F4F16894E21962C0F816268BAF254E403CAD68943A1A62C0FCCB7AE00C264E4087B3133F851A62C000CC7AE0CC264E4098CF6894D61A62C02004258BCF264E403AAD68942A1B62C08871D0357E264E40545BBEE9AE1B62C057A3CF35F6264E40D4FCBDE9ED1B62C02004258BCF264E40BA52BEE97B1C62C0998D258B7F254E401675BEE9F71C62C0F935248B87254E407E256994541D62C090F7CE35BA254E40D6FCBDE9AD1D62C08371D0353E264E40EB63BEE9211E62C0908D258B3F274E409E5D133FE71D62C0878D258B7F284E40F538BEE9521D62C09C8D258BBF294E401775BEE9771C62C0737479E0D42C4E40F1F16894621C62C0304FD035722D4E403AAD68947A1C62C08F8D258B7F2E4E4058A2133FAF1C62C0503CCF35D22E4E408C41BEE9E51C62C0B37A248BDF2E4E4083B3133F051D62C0A75ECF351E2F4E40040EBEE9431D62C0E493D035CA304E40F638BEE9321D62C0E893D0358A314E40F2F16894D21C62C0F816268BAF324E404E1469945E1C62C0CB2CD03566334E40CA27BEE9DC1B62C093427AE09C334E406D05BEE9D01A62C088F7CE357A334E406D05BEE9D01A62C00717268B6F344E40AD7DBEE98A1B62C0503CCF3592354E40EA63BEE9F11A62C0687479E0D4374E40501469944E1962C0AFC5CF35823B4E403CAD68946A1962C02BB979E0EC3C4E402891133F691962C0AC5ECF35DE3E4E40C4E068948C1962C0CC2CD035E63F4E406C05BEE9A01A62C0473CCF35123D4E40CD6E133F4D1B62C0B7107BE0243C4E4068BE6894F01B62C02404258B4F3C4E40F1F16894621C62C0E4B2CE35223E4E40E2D5133F211C62C08CF7CE357A3F4E401F036994D81B62C070557BE03C404E40C927BEE98C1B62C01CE8CF35CE404E40040EBEE9131B62C0D02CD03526424E406C05BEE9C01A62C0A75ECF35DE424E40D4FCBDE99D1A62C007CC7AE04C434E40826CBEE9941A62C073BF248BF7434E405F30BEE99F1A62C0975ECF35DE444E40F3F16894A21A62C0D048258BA7454E40E863BEE9811A62C08071D035FE454E402891133F291A62C0D8B2CE35A2464E4096CF6894161A62C06C7479E014484E40FA7F133F331A62C0E0FD79E0C44A4E40CD6E133F1D1A62C00381CF352A4C4E4084B3133FE51962C09DF7CE353A4D4E40501469944E1962C07C557BE0BC4E4E40A05D133F971862C0DFFD79E004504E40264ABEE9681862C00C81CF35AA504E40E863BEE9311862C01704258B4F524E40331FBEE9391862C0DF19CF3586534E40C827BEE95C1862C00117268BEF544E409C16BEE9561862C08B427AE01C564E40F738BEE9E21762C0670AD0359A564E40D6FCBDE9ED1662C09C8D258BFF554E4020036994081662C0204FD035F2544E4022036994281562C07F71D0357E544E40F838BEE9421462C094F7CE35BA554E408C41BEE9C51362C038B6D03516574E40FC7F133FA31362C098F7CE35FA574E40AD7DBEE99A1362C01BE8CF354E594E4095CF6894B61362C0D8B2CE35625B4E40D6FCBDE9ED1362C0FB35248BC75B4E4020036994481462C0B77A248B5F5B4E40F2F16894921662C043B6D035165A4E408E41BEE9751762C077557BE0FC584E40E863BEE9311862C017E8CF358E574E40F3F16894B21862C0B87A248B9F554E409C16BEE9261962C0D993D0354A534E407D256994B41962C0533CCF3552514E40FA7F133F631B62C0B07A248B9F4F4E4087B3133FD51B62C00436248B874D4E40EA63BEE9211C62C02B4FD035F24A4E4086B3133F951C62C0A95ECF359E484E405E30BEE92F1D62C054D2258B57474E40CC6E133F2D1F62C078557BE0BC444E40CD6E133FFD1F62C0988D258B3F444E406030BEE99F2062C0E3B2CE3562434E40B2C4133F4B2162C0780AD0355A414E40D4FCBDE94D2262C028D5CE352E3D4E403AAD68941A2362C0975ECF35DE384E408F41BEE9A52362C073BF248BF7364E40B3C4133F3B2562C0B8107BE064354E40C6E068948C2762C0A75ECF351E2F4E405E30BEE99F2862C048877AE0B42D4E407C256994C42962C0EB93D0358A2D4E40020EBEE9732C62C0E148258B672E4E40F4F16894E22C62C0D4B2CE35E22E4E402891133F492D62C0780AD0359A2F4E403CAD6894FA2D62C05BA3CF3576314E40D5FCBDE9FD2E62C0C4107BE024324E40535BBEE96E2F62C0F816268BAF324E40244ABEE9A82F62C0A45ECF359E334E409A16BEE9F62F62C050A3CF3536364E406C05BEE9203062C0AF107BE024374E40AE7DBEE98A3062C02804258BCF374E40331FBEE9993162C08471D0357E384E40F3F16894523262C08771D035BE394E409E9D2CE5873562C06F30E7FBA43A4E40A4898D65693762C0409E70328E3B4E4048AD8A7FBE3962C0502FBC622B3A4E401B0C2BCBB63B62C0D0A89B004D394E400F6313450A3E62C0D3AD2960603A4E40E2D5133F213E62C013E8CF354E3C4E4096CF6894863D62C00017268B6F3D4E402891133F293C62C027B979E06C3E4E406D05BEE9A03B62C0BF2CD035663F4E402891133F193B62C028B979E0EC404E40F3F16894B23862C033D5CE356E454E40CB6E133FCD3562C030B6D035D64D4E409A16BEE9963562C0D0B2CE35224F4E40F638BEE9523562C0533CCF3552514E40AF7DBEE9BA3462C02FB6D03596524E40EB63BEE9213462C00BCC7AE08C534E40A05D133FD73362C06F0AD035DA544E406B05BEE9203462C03CD5CE35EE564E40D6FCBDE9DD3462C00C81CF356A564E40F838BEE9223662C01BE8CF350E544E409A16BEE9063B62C07771D0357E4F4E403AAD68942A3C62C094F7CE357A504E406C05BEE9D03A62C0D52CD035E6514E40AE7DBEE92A3A62C0CB2CD03526534E40F838BEE9C23962C06F0AD035DA544E405F30BEE95F3A62C0780AD0351A554E4068BE6894903B62C0F135248B07544E403AAD68942A3C62C06F0AD035DA544E406ABE6894603B62C0670AD0359A564E40C3E068940C3B62C0938D258BBF574E403AAD6894DA3A62C01BE8CF354E594E40D3FCBDE96D3B62C068BF248BF7584E40B5C4133F3B3C62C033B6D035D6574E40F638BEE9F23C62C074BF248B37564E405F30BEE99F3D62C02FB6D03596524E40321FBEE9793E62C038D5CE35AE514E40D3FCBDE91D4062C088427AE05C514E405E30BEE9CF3F62C03FD2258B17534E40F638BEE9723F62C0B87A248B1F544E40E4D5133F913E62C094F7CE35BA554E4068BE6894303E62C03F3CCF35D2564E409C16BEE9963D62C0304FD03532594E40EB63BEE9413D62C0730AD0351A5A4E403AAD68940A3E62C0CF2CD035A65A4E4084B3133FE53E62C04B3CCF3552594E40DFD5133FC13F62C0D8FD79E084574E40D6FCBDE98D4062C0670AD0359A564E40AE7DBEE96A4162C0D748258B27564E40050EBEE9534662C090F7CE357A514E40050EBEE9A34762C08871D0353E514E4022036994384862C057A3CF35B6524E40EA63BEE9414862C00CCC7AE00C534E409916BEE9564862C0D993D0354A534E40BC52BEE96B4862C028B979E0AC534E4085B3133F754862C040877AE074544E40C5E068945C4862C02304258BCF544E4056A2133FDF4762C060BF248BF7544E40C827BEE9AC4762C0E493D0354A554E40EA63BEE9614762C0F880CF352A564E406C05BEE9C04362C03CB6D035565C4E40321FBEE9994262C093F7CE35FA5C4E406130BEE93F4262C0EF19CF35865D4E40CA27BEE9FC4162C06FBF248B775E4E40F2F16894E24162C04F3CCF35D25F4E40F838BEE9B24162C044B6D03556604E408C41BEE9D54062C044B6D035565F4E40F638BEE9924062C0F8CB7AE04C604E409A16BEE9A64062C0D0FD79E004614E4087B3133F354162C0E093D035CA634E401675BEE9074162C00781CF35EA644E40535BBEE9FE4062C08FF7CE35BA654E4087B3133F354162C00981CF356A664E40050EBEE9634162C00436248B87664E40CA27BEE99C4162C0C4C5CF3582664E40D8FCBDE9CD4162C02C04258B4F664E40F2F16894E24162C038D5CE35EE654E401675BEE9374262C0E4B2CE35A2634E40D4FCBDE9FD4262C0C72CD035A6614E40EA63BEE9814462C044B6D035565F4E401575BEE9574562C01804258BCF5E4E407E256994D44562C078557BE03C5F4E40EA63BEE9D14562C0D12CD03566604E402891133F294562C0A85ECF351E624E40C6E06894AC4662C0AF7A248B5F614E404F1469941E4762C067557BE0BC604E40545BBEE96E4762C028B979E0AC5F4E4068BE6894B04762C0975ECF355E5E4E404E146994FE4762C0D8FD79E0445D4E40F738BEE9724862C007CC7AE0CC5C4E4086B3133F754962C074BF248BF75C4E40E2D5133FD14962C04C877AE0B45D4E40C827BEE9FC4962C044B6D035565F4E40B2C4133FEB4962C01BE8CF350E614E40CA27BEE9AC4962C050A3CF35F6614E40C827BEE95C4962C017B979E0AC624E4021036994184962C0E093D035CA634E40826CBEE9044A62C0EF19CF35C6624E401875BEE9474B62C00581CF35EA5D4E40040EBEE9734C62C0F780CF356A5C4E40331FBEE9594D62C068BF248B775A4E4057A2133F9F4D62C051877AE0B4594E409E5D133F074E62C043B6D03516594E40525BBEE96E4F62C037D5CE35EE574E40C6E06894CC4F62C04C877AE0F4574E405F30BEE98F5062C0780AD0355A594E40264ABEE9985162C0F035248BC7594E40CD6E133F9D5462C01BE8CF354E594E40D6FCBDE9DD5462C0740AD0359A594E403CAD6894EA5462C02FB6D035565A4E4085B3133FE55462C0204FD035325B4E40030EBEE9F35462C017B979E0EC5B4E4096CF6894365562C007CC7AE0CC5C4E40FB7F133F435662C044B6D035565F4E409A16BEE9B65562C0740AD0355A604E40F838BEE9225562C08F8D258BFF5F4E40FB7F133F935462C0A97A248BDF5E4E40040EBEE9135462C03FB6D035965D4E40D6FCBDE9DD5362C01804258B4F604E407C256994B45362C02FD5CE356E614E40C6E068946C5362C0A85ECF351E624E403AAD6894EA5262C0204FD035F2614E406C05BEE9005262C0B87A248B1F604E40AF7DBEE91A5162C028D5CE352E614E409C16BEE9365062C0F735248B475F4E40C6E06894CC4F62C04F3CCF35D25F4E403CAD6894BA4F62C0C0107BE064614E40321FBEE9295062C0D0B2CE3562624E408E41BEE9C55062C0A05ECF35DE624E401875BEE9375162C00D81CF35EA624E406ABE6894805062C07C0AD035DA634E40B4C4133FBB4F62C0948D258BBF634E40F2F16894424E62C00D81CF35EA624E409A16BEE9A64D62C0F816268B2F634E40AE7DBEE95A4C62C0B0107BE064644E40C6E06894FC4A62C08BF7CE35FA644E402891133F694862C0E793D035CA674E40E0D5133F414662C00036248B07694E40E0D5133F414662C0E448258BE7694E40AE7DBEE94A4762C050877AE0746A4E40321FBEE9994762C0CD2CD035A66B4E40C4E068943C4762C0730AD035DA6C4E40E0D5133F414662C0CF2CD035666D4E403BAD6894FA4262C0CD2CD035A66B4E4096CF6894264762C0AFC5CF3542724E40525BBEE91E4862C0BC7A248B5F714E406C05BEE9004962C08B71D035FE6D4E409A16BEE9264A62C07B0AD0351A6B4E409E5D133F774B62C0BCC5CF3542694E402891133FD94C62C00036248B07694E402891133FD94C62C0E448258BE7694E40CA27BEE9AC4C62C0D42CD035666A4E407E256994944C62C0F716268BEF6A4E407C256994644C62C0F035248B876C4E40D7FCBDE95D5062C0FB35248BC7684E406030BEE9DF5162C0E448258BE7694E4056A2133FBF5162C067BF248B376C4E40FC7F133F235262C0E3FD79E0446D4E406B05BEE9C05262C02CD5CE352E6D4E40D6FCBDE94D5362C02FB6D035166C4E406030BEE9CF5362C0A87A248B5F6A4E40AF7DBEE91A5462C0C4107BE0E4694E406C05BEE9305462C0680AD035DA6A4E40040EBEE9135462C0CF2CD035666D4E40826CBEE9845362C0A75ECF359E6E4E40C6E068946C5362C0C92CD035266F4E4068BE6894905362C0F019CF3546704E40D6FCBDE9DD5362C0A77A248B1F714E40244ABEE9385462C00581CF35AA714E40050EBEE9835462C07B0AD035DA714E401675BEE9F75462C02C4FD03572714E40040EBEE9635562C0C0C5CF35C2704E4058A2133FDF5562C0985ECF359E704E4067BE6894805662C07B0AD035DA714E40C6E068948C5662C060A3CF3536724E4068BE6894F05662C094F7CE357A744E40311FBEE9295762C0BCC5CF3542754E405E30BEE95F5762C02CB979E0AC754E4021036994885762C0B8C5CF3542764E401775BEE9975762C0F335248B87774E40AE7DBEE91A5862C07771D0353E7A4E40321FBEE9195862C03CD5CE356E7B4E40AF7DBEE95A5762C050A3CF35767B4E40535BBEE9DE5662C0700AD035DA7A4E40545BBEE91E5662C08B8D258B3F794E40BC52BEE95B5362C04F877AE0F4774E4058A2133FBF5262C01FB979E0EC784E40CC6E133FCD5362C07771D0353E7A4E406ABE6894505562C04F3CCF35527B4E40806CBEE9645662C0E893D0350A7D4E409E5D133F275662C02B04258B4F804E40D6FCBDE9ED5562C07871D0357E814E40A05D133F875562C00B17268B2F844E406E05BEE9305562C0DD48258B27854E401775BEE9975462C0DFB2CE3562854E40264ABEE9E85262C05CA3CF3536844E407E256994545262C0E348258B67834E40E1D5133F415262C033D5CE35EE834E4067BE6894205262C0503CCF3552854E401675BEE9175262C043877AE0F4854E4056A2133F8F5362C051D2258BD7864E406D05BEE9405462C0B87A248B9F874E40BA52BEE9BB5462C02D4FD03572894E40EB63BEE9D15162C0978D258BFF8A4E407E256994144962C028B979E06C8A4E406B05BEE9904762C0503CCF35128C4E4084B3133FE54862C05BA3CF35B68F4E403CAD68949A4962C060A3CF35F6904E40C827BEE96C4A62C070BF248B77914E40826CBEE9344C62C087F7CE353A914E40F3F16894D24D62C0730AD035DA914E40CE6E133FCD4F62C028B979E02C914E4058A2133FBF5262C070BF248B77914E406ABE6894805362C078557BE0BC904E4096CF6894365462C08771D0353E8F4E40BC52BEE99B5562C0DF19CF35468B4E40545BBEE90E5762C014E8CF354E884E40244ABEE9185A62C0413CCF3512844E40020EBEE9535B62C050A3CF35B6804E40E863BEE9E15B62C0670AD0351A7E4E40F3F16894825C62C02BB979E06C7C4E40321FBEE9295D62C0C72CD035267B4E40BE52BEE95B5E62C01CE8CF358E794E40E0D5133F415F62C02C04258B0F794E401675BEE9276062C044B6D03556794E40F2F16894026162C03BB6D035967A4E404E146994CE5F62C0BC7A248BDF7D4E40F2F16894525F62C031B6D035D67F4E40B07DBEE97A5F62C050A3CF35B6804E409E5D133F276062C0780AD035DA804E403BAD68945A6062C050A3CF35B6804E406ABE6894806062C0F035248B47804E402991133F896062C0B0C5CF35C27F4E403CAD68948A6062C0DF19CF35467F4E409F5D133F976062C058A3CF35F67E4E401775BEE9176162C0D32CD035A67D4E40B07DBEE96A6162C023B979E02C7D4E40E963BEE9E16162C060A3CF35367D4E40D6FCBDE98D6162C0978D258BFF7E4E40CA27BEE95C6162C0B87A248B5F804E40F838BEE9826162C0BCC5CF3542814E40F738BEE9E26262C0DFFD79E004824E4020036994386362C055877AE0F4814E40F4F16894D26362C0A75ECF355E804E404E146994BE6462C058A3CF35F67E4E40E2D5133FD16462C098F7CE35FA7C4E409C16BEE9A66462C014E8CF354E7B4E40B07DBEE9AA6462C0C82CD035267A4E40321FBEE9496562C058A3CF35B6794E40D6FCBDE9ED6562C04C3CCF35127A4E4057A2133F5F6662C0E3B2CE35227B4E406ABE6894A06662C027B979E0EC7C4E4088B3133FB56662C00817268B6F7F4E40E963BEE9A16662C090427AE01C814E4068BE6894906662C09C5ECF35DE814E40C6E06894BC6662C05FBF248BB7814E40030EBEE9236862C09BF7CE353A7F4E40826CBEE9746862C058A3CF35F67E4E40264ABEE9E86862C02304258B8F804E4098CF6894366962C0C82CD035E6804E40341FBEE9596962C00817268B6F7F4E40FA7F133F336962C0533CCF35127E4E40CC6E133F7D6862C0B0107BE0E47B4E40F4F16894426862C03BB6D035967A4E40BD52BEE93B6862C000CC7AE00C784E40AE7DBEE99A6862C0403CCF3512774E40EA63BEE9016A62C043D2258B17774E402A91133FC96962C0B0107BE024764E403AAD6894FA6A62C0E0B2CE3522734E40AF7DBEE9AA6B62C0747479E014724E40244ABEE9F86B62C06F7479E014734E40E3D5133F416C62C068557BE0FC744E40CD6E133FED6C62C03BB6D035D6744E403AAD6894BA6D62C0F880CF35EA734E4084B3133F656E62C0F419CF3586734E40FB7F133F036E62C0AF107BE0A4764E406D05BEE9306C62C00481CF352A7E4E40525BBEE9CE6C62C03FD2258BD77E4E4097CF6894566D62C097F7CE357A7D4E401675BEE9D76D62C02804258B8F7B4E40F838BEE9626E62C03BB6D035967A4E4021036994B86E62C09B5ECF359E7B4E407E256994746E62C00881CF35EA7D4E406030BEE9EF6D62C01CE8CF354E804E408D41BEE9856D62C0717479E094814E407E256994746E62C0C72CD03566814E406C05BEE9006F62C01804258B0F804E406C05BEE9D06F62C0C02CD035E67B4E405F30BEE94F7062C08471D0357E764E40321FBEE9B97062C00081CF352A744E4022036994587162C0D748258BE7744E407E256994747162C00481CF352A7E4E40BD52BEE93B7162C0E593D0358A804E40FB7F133FF37062C0D0B2CE3522824E406C05BEE9D07062C00381CF35EA834E40301FBEE9097162C0DF48258BE7864E40EA63BEE9B17062C0C82CD035A6874E4084B3133FB56F62C0D0B2CE35E2884E40C827BEE97C6F62C02D4FD03572894E40C6E068948C6F62C070BF248BB78A4E40D5FCBDE9CD6F62C0DF19CF35468B4E404E1469941E7062C04F3CCF35928B4E40CA27BEE95C7062C0503CCF35128C4E40545BBEE9AE7062C0C82CD035E68D4E4056A2133FDF7062C06FBF248BF78F4E40545BBEE9CE7062C054D2258BD7914E40CA27BEE95C7062C0B8107BE024934E40BC52BEE9CB7062C0DFFD79E0C4934E40F4F16894627162C0770AD0351A944E40816CBEE9F47162C040877AE0F4934E402891133F597262C0B8107BE024934E408D41BEE9857262C0304FD03572914E401875BEE9577262C0737479E054904E4056A2133F0F7262C0E348258B678F4E402891133FE97162C0E793D0354A8E4E40D4FCBDE91D7262C00081CF352A8B4E40501469949E7262C0697479E094874E40E963BEE9417362C0DDB2CE35A2844E404E146994DE7362C0E348258B67834E40AD7DBEE97A7462C0AB5ECF351E834E40FA7F133F137562C08571D0357E824E40321FBEE9497562C09C5ECF35DE814E4068BE6894C07462C0717479E094814E40CE6E133FDD7362C0E893D035CA814E40254ABEE9A87362C0717479E094814E406030BEE96F7362C027D5CE356E804E4096CF6894867362C0780AD035DA7F4E40AE7DBEE9BA7362C06C557BE07C7F4E40BA52BEE9DB7362C058A3CF35F67E4E406C05BEE9F07362C0EF35248B477E4E40B6C4133F3B7462C034D5CE352E7D4E40B4C4133F4B7462C0F019CF35C67C4E40C827BEE92C7462C068557BE0BC7B4E40806CBEE9E47362C060BF248B777B4E40F3F16894927362C03CD5CE356E7B4E40F4F16894527362C0FC35248B077B4E40040EBEE9337362C06C7479E094794E40E2D5133F617362C098F7CE353A764E40244ABEE9387362C094F7CE357A744E40244ABEE9187362C0AC5ECF355E714E40B5C4133F2B7362C07771D0353E6F4E403CAD68948A7362C0FF35248B476E4E40806CBEE9447562C08F427AE0DC6D4E40F4F16894D27562C027D5CE35AE6E4E4069BE6894507562C0AFC5CF3542734E40BD52BEE9EB7562C0E4FD79E004734E40311FBEE9C97662C0533CCF3512724E406130BEE95F7762C07B0AD035DA714E40F638BEE9727762C054A3CF3536734E4084B3133F457762C0EF19CF3586754E40CB6E133FED7662C0D7FD79E0C4774E405E30BEE97F7662C01FB979E0EC784E405E30BEE97F7662C058A3CF35B6794E40244ABEE9487762C0D793D0354A794E4057A2133F9F7862C033D5CE35EE764E407E256994247962C043D2258B17774E40C3E068943C7962C0AC5ECF359E764E402A91133F497962C08871D0353E764E40BC52BEE95B7962C06C0AD0355A754E40806CBEE9A47862C00C81CF35AA744E40FB7F133FE37862C009E8CF350E734E40050EBEE9037A62C0680AD0351A704E40D6FCBDE9DD7862C098F7CE35FA6E4E4056A2133FAF7862C064A3CF35B66E4E40321FBEE9897862C0503CCF35526E4E405F30BEE93F7862C0E3FD79E0446D4E40B3C4133F0B7862C00881CF352A6C4E408F41BEE9257862C0CD2CD035A66B4E40E2D5133F717862C0E0B2CE35626B4E406C05BEE9107962C038D5CE352E6A4E4088B3133F757962C0E448258BE7694E4020036994D87B62C08CF7CE353A6B4E40B07DBEE95A7C62C00717268B2F6C4E40F638BEE9C27C62C02B04258B8F6D4E40F838BEE9127D62C0C92CD035266F4E401775BEE9577D62C00417268BAF714E40F638BEE9827D62C0CF2CD035A6724E402891133FC97D62C06F557BE0BC734E40806CBEE9047E62C0483CCF3552744E40F2F16894A28062C0F035248B87784E40545BBEE93E8162C01FB979E0EC784E40C827BEE99C8162C0A75ECF359E794E40264ABEE9188162C029D5CE352E7B4E40535BBEE9EE7F62C0F716268BAF7D4E40BB52BEE9FB7F62C00781CF356A7E4E40E41C6994118062C06F557BE0BC7E4E408BFA6894158062C044B6D035167F4E40535BBEE9EE7F62C0FC80CF35EA7F4E407E256994A47F62C0B07A248B9F804E40C927BEE9EC7E62C0DFFD79E004814E4057A2133F9F7E62C0717479E094814E40AE7DBEE93A7E62C0E348258B67834E40AE7DBEE9BA7D62C0D0B2CE35E2864E40B07DBEE94A7D62C0C82CD035A6884E40E1D5133FC17D62C02004258B4F894E40F638BEE9F27D62C02D4FD03572894E406C05BEE9607D62C0503CCF35128C4E402A91133F497C62C0F735248B478F4E40EA63BEE9117B62C07F71D035FE914E406130BEE91F7A62C0B8107BE024934E406ABE6894C07962C0A05ECF35DE934E40B4C4133FBB7862C0FFCB7AE04C974E4058A2133F3F7862C058A3CF3576984E40B07DBEE9EA7662C03CB6D035D6994E401875BEE9777662C0E793D0354A9B4E40CA27BEE9BC7662C047877AE0B49D4E4086B3133F957762C04FD2258B979B4E401F036994087862C050A3CF35369B4E40C4E068947C7862C060A3CF35F69B4E407C256994247762C0C0C5CF35C2A04E40040EBEE9D37662C04B877AE0F4A24E406130BEE95F7762C0413CCF35D2A34E405E30BEE9EF7762C030B6D03556A34E40040EBEE9637862C00C81CF35EAA14E407E256994247962C030B6D035969E4E40BC52BEE9AB7A62C0EC93D0354A994E405F30BEE9FF7A62C058A3CF3576984E40EA63BEE9F17B62C0F035248B47974E40040EBEE9137D62C09C8D258B7F944E40A05D133FD77E62C0FF16268BAF8E4E40030EBEE9F37F62C0EC19CF3506884E40BC52BEE9AB8062C0D893D035CA844E40826CBEE9948162C0E348258B67834E40D6FCBDE94D8262C0BC7A248B1F834E404E1469948E8262C0E348258B67834E40F1F16894C28262C0D3FD79E004844E406ABE6894008362C0DC48258BA7854E4069BE6894A08362C00B81CF35EA874E4098CF6894E68362C090F7CE35BA894E4021036994388462C01CE8CF354E8B4E40F4F16894C28462C0503CCF35128C4E403CAD68947A8462C0344FD035728E4E40B70B6994AB8462C050D2258B178F4E406030BEE91F8562C03DD5CE35AE8E4E4096CF6894468662C0700AD0351A8D4E4096CF6894468862C0503CCF35128C4E4021036994E88862C0D7B2CE35628B4E40040EBEE9C38962C0AB5ECF35DE894E405AE968947F8C62C087427AE09C884E403AAD68941A8D62C0334FD035B2874E408BFA6894B58C62C03CB6D03516874E40C5E06894EC8B62C00717268BAF864E40D6FCBDE98D8B62C043877AE0F4854E40E61C6994E18B62C0274FD03532854E4096CF6894868C62C03FB6D03516834E40040EBEE9C38C62C014E8CF350E824E40D3B568940D8D62C0C72CD03566814E40806CBEE9648E62C0FC80CF35EA7F4E40806CBEE9648E62C058A3CF35F67E4E40E61C6994218D62C0AFC5CF35427E4E40826CBEE9048C62C0CC2CD035E67F4E40B07DBEE90A8A62C0DD48258B27854E40E51C6994F18862C0E893D0350A874E40244ABEE9488762C037B6D03516894E405F30BEE9AF8562C010E8CF35CE894E40F4F16894C28462C0334FD035B2874E40D7FCBDE93D8562C0B8107BE024874E40A4A46894578562C0244FD035F2854E4098CF6894568562C034D5CE356E844E40020EBEE9838562C090F7CE35FA824E406D05BEE9A08662C0F716268BAF7D4E40CA27BEE9FC8662C097F7CE357A7C4E406230BEE90F8862C048877AE0347A4E402BD86894798862C058A3CF35B6794E40020EBEE9038962C04C3CCF35127A4E40244ABEE9088A62C0E3B2CE35227C4E40244ABEE9A88A62C03FB6D035567C4E40D2B568946D8A62C0EB19CF35067B4E405E30BEE93F8962C0F335248B87774E405BE96894FF8862C038B6D035D6754E409A16BEE9268962C0F880CF35EA744E404E1469947E8962C040B6D03516744E4050146994CE8962C0CF2CD035A6724E40C6E06894DC8962C00481CF35AA704E40244ABEE9C88962C027D5CE35AE6E4E407C256994D48962C0CC2CD035266D4E406C05BEE9408A62C0F035248B876C4E409A16BEE9D68A62C008E8CF35CE6C4E406E05BEE9008C62C09C8D258BFF6D4E403CAD6894AA8C62C0FF35248B476E4E407C256994248B62C08871D035BE6A4E409C16BEE9A68A62C0E4B2CE35E2684E408D41BEE9558B62C06F7479E014684E407E256994448C62C0707479E094684E40826CBEE9B48D62C00381CF35EA6A4E40EB63BEE9A18E62C0CD2CD035A66B4E406030BEE9BF9062C03F3CCF35926B4E4001C76894C39262C008CC7AE04C6A4E407D256994849662C057A3CF3576654E40E41C6994719562C0DB93D0358A644E40F2F16894529462C0737479E094654E40FFC66894339362C050A3CF3536674E406ABE6894209262C06F7479E014684E40AE7DBEE9EA9162C0473CCF35D2674E408AFA6894A59162C0FF80CF35AA664E40B80B69947B9162C00981CF356A664E409A16BEE9369162C0E3FD79E084664E40D6FCBDE93D8F62C098F7CE353A684E402CD86894B98E62C068557BE0FC674E40806CBEE9648E62C00981CF356A664E40D6FCBDE99D8F62C00417268B2F654E40EA63BEE9819262C02704258B0F644E40535BBEE98E9362C0C72CD035A6614E407E256994F49362C007E8CF354E604E40040EBEE9D39462C0E0B2CE35625E4E40806CBEE9349562C007CC7AE0CC5C4E406030BEE9AF9562C0C0107BE0A4594E40311FBEE9099662C08471D0353E584E407D256994849662C017E8CF358E574E407D256994849662C0670AD0359A564E40BC52BEE95B9562C041B6D03556564E40C827BEE9FC9462C0670AD0359A564E40244ABEE9989462C000CC7AE04C574E40E963BEE9E19362C088F7CE35FA584E40806CBEE9249362C0F9CB7AE08C594E40D6FCBDE9DD9262C043877AE0345A4E402DD86894A99262C030D5CE352E5B4E408F41BEE9959262C08B427AE05C5C4E4096CF6894869262C038D5CE352E5E4E40B07DBEE95A9262C05DA3CF35B65E4E4000C76894139262C0543CCF35D25E4E406D05BEE9B09162C044B6D035565F4E40EA63BEE9F19062C0D02CD035E6604E40FFC66894539062C094F7CE35BA614E40D4FCBDE9AD8F62C02804258B0F624E40331FBEE9D98E62C0A85ECF351E624E405CE968947F8E62C0D0B2CE3562624E407E256994148E62C0F735248B87634E40B80B6994DB8D62C0E093D035CA634E40D1B56894FD8B62C0E093D035CA634E40D1B56894FD8B62C00D81CF35EA624E40D0B568946D8C62C00D81CF35EA624E40D0B568946D8C62C0A85ECF351E624E405BE968941F8C62C04F3CCF35D2614E40535BBEE9DE8B62C0878D258B3F614E40D1B56894AD8B62C00181CF356A604E40D6FCBDE98D8B62C044B6D035565F4E408F41BEE9558C62C037D5CE35AE5E4E407E256994A48C62C0E093D0350A5E4E40C927BEE9DC8C62C007CC7AE0CC5C4E408E41BEE9D58C62C0B07A248B9F5B4E407E256994A48C62C0B4C5CF3542584E40040EBEE9C38C62C017E8CF358E574E407B256994A48D62C097F7CE35FA564E40A3A46894E78D62C03BD5CE356E554E40E863BEE9C18D62C094F7CE357A504E40E61C6994718D62C0E819CF3546514E403CAD6894AA8C62C01BE8CF350E544E40525BBEE93E8C62C0274FD035B2544E403AAD6894DA8B62C060BF248BF7544E40B07DBEE97A8B62C03BD5CE356E554E40D3FCBDE91D8B62C0670AD0359A564E408E41BEE9F58A62C0F519CF35065A4E404E146994DE8962C0F019CF35065E4E401875BEE9778862C0D0B2CE3562614E40E963BEE9618762C00D81CF35EA624E40E963BEE9618762C0A85ECF351E624E40EA63BEE9F18762C02B04258B8F604E40F638BEE9328862C061A3CF35765E4E4022036994288862C095F7CE35FA5B4E409916BEE9D68762C01BE8CF354E594E4096CF6894968762C0DFB2CE3522584E40E863BEE9018762C028D5CE352E564E40321FBEE9B98662C06F0AD035DA544E40AD7DBEE99A8662C0CC2CD035A6534E409A16BEE9968662C0AC5ECF359E524E4020036994888662C07C0AD0359A514E403CAD68944A8662C094F7CE357A504E40321FBEE9998662C028D5CE356E4F4E4000C76894038762C06F0AD0359A4E4E403AAD68947A8762C008E8CF350E4E4E4069BE6894F08762C098427AE0DC4D4E4096CF6894168A62C095427AE05C464E4020036994C88A62C02B4FD03532454E40D6FCBDE98D8B62C08071D035FE454E40D6FCBDE98D8B62C0D893D035CA464E40EB63BEE9A18B62C09CF7CE35FA474E40FEC66894538D62C06B7479E094474E40E863BEE9C18D62C018E8CF350E494E40EA63BEE9118E62C0C4107BE0244B4E40C6E06894CC8E62C038D5CE356E4B4E40E51C6994A18F62C0E819CF35864A4E4020036994C89062C02CD5CE35AE474E40545BBEE92E9362C008CC7AE0CC434E40C827BEE9FC9462C001CC7AE0CC3F4E40BD52BEE96B9562C08871D0357E3E4E402DD86894E99562C03BD5CE356E3C4E4000C76894139662C0E019CF35863A4E408D41BEE9859562C038D5CE35AE394E40244ABEE9D89462C0D0FD79E0843A4E406ABE6894B09362C024B979E02C3E4E403CAD6894DA9162C007E8CF358E404E40020EBEE9739062C0B0107BE0A4434E40BD52BEE90B8F62C00481CF35EA454E40E863BEE9C18D62C0E093D0350A454E403BAD6894AA8D62C01F4FD035B2434E409A16BEE9168D62C0B3107BE024434E402ED86894598C62C0E4B2CE35E2424E408AFA6894C58B62C018B979E06C424E408CFA6894358C62C0908D258BBF404E409B16BEE9268B62C053A3CF3536414E40D6FCBDE9ED8A62C0770AD035DA404E40C4E068943C8B62C0BF2CD035663F4E40B80B69947B8B62C02CB979E0EC3D4E408F41BEE9258B62C0EC19CF35863D4E404F1469948E8A62C06F0AD035DA3D4E408D41BEE9058A62C0533CCF35923E4E40331FBEE9D98862C07B0AD0355A3F4E40A4A46894978862C0FC35248B873C4E406D05BEE9708862C078557BE0BC394E40311FBEE9998762C01CE8CF358E3A4E406E05BEE9308762C009CC7AE00C3C4E401875BEE9278762C093F7CE353A3D4E403BAD68944A8762C0B8C5CF35823E4E40E963BEE9618762C0E019CF3546404E40FEC66894738762C07F71D035BE404E40F2F16894928762C0D0FD79E044414E4068BE6894A08762C0284FD035F2414E40D5FCBDE97D8762C098427AE0DC424E405AE968944F8762C0FC35248B47434E40F738BEE9D28662C0C02CD03526444E40321FBEE9B98662C0BF2CD035A6444E409A16BEE9968662C034D5CE35EE454E40826CBEE9448662C09CF7CE35FA464E401A75BEE9E78562C0D02CD03566474E40F2F16894A28562C0D893D035CA464E404E1469948E8562C0AD5ECF351E454E40AE7DBEE9AA8562C08B71D0353E434E40535BBEE9DE8562C0D4B2CE35A2414E40F4F16894128662C0908D258BBF404E40F538BEE9528562C04F877AE034404E40F2F16894F28462C05FBF248B37434E40545BBEE9BE8462C0C0107BE064474E408BFA6894858462C0E093D0354A4A4E405F30BEE92F8462C00381CF352A4B4E406ABE6894008362C0B0C5CF35424D4E40C927BEE9AC8262C028B979E06C4D4E4098CF6894368262C0988D258BFF4A4E40B60B6994EB8162C07C557BE0FC494E409A16BEE9768162C08C71D0357E494E40FFC66894238262C0E093D0350A454E40040EBEE9C38162C0F935248B47454E40E61C6994118162C02FB6D03596464E40535BBEE9CE8062C0D893D035CA464E4069BE6894608062C0AB5ECF351E464E401775BEE9378062C04C877AE034454E40F538BEE9228062C02B4FD03532444E40535BBEE9EE7F62C007CC7AE04C434E40826CBEE9847F62C0BCC5CF35C2424E4069BE6894107F62C018B979E06C424E409C16BEE9B67E62C0D4B2CE35A2414E4057A2133F9F7E62C001CC7AE0CC3F4E40AE7DBEE9CA7E62C05DA3CF35F63E4E4022036994287F62C0985ECF351E3E4E4084B3133F957F62C04FA3CF35763D4E40535BBEE9EE7F62C028D5CE352E3D4E40F638BEE9827F62C0FB80CF352A3B4E409C16BEE9D67E62C00081CF356A3B4E4021036994387E62C0DCFD79E0043C4E40F638BEE9F27D62C0F035248B073B4E40040EBEE9237E62C05CA3CF35B6384E406030BEE99F7E62C0473CCF35D2374E40535BBEE9EE7F62C034D5CE35EE374E40321FBEE9D97F62C054877AE0F4354E4089FA6894658062C0503CCF3592344E40D6FCBDE92D8162C0908D258BBF334E40CA27BEE9CC8162C088F7CE357A334E40C827BEE9BC8262C0C0107BE0A4354E40AF7DBEE91A8362C031D5CE35AE354E40B90B6994CB8262C0F816268BAF324E40C4E068948C8362C0DFB2CE3522334E40E71C6994018562C094427AE01C354E4088FA6894D58562C02C04258B4F354E40A4A46894778562C038D5CE356E344E40F2F16894528462C018E8CF358E304E40AE7DBEE91A8462C0A75ECF351E2F4E40525BBEE98E8462C06FBF248B772D4E40525BBEE96E8562C00781CF352A2D4E403AAD68945A8662C0A85ECF359E2D4E40EB63BEE9F18662C07C71D0353E2E4E40B07DBEE9EA8662C06C0AD0359A304E40264ABEE9788762C0948D258B3F314E408AFA6894258862C0BBC5CF3582304E402BD86894798862C02CD5CE35AE2E4E406130BEE94F8862C09B427AE09C2C4E40321FBEE9E98762C028B979E0AC2C4E40331FBEE9698762C0284FD035322D4E40EB63BEE9F18662C08471D0357E2C4E40F2F16894E28662C03F877AE034294E408AFA6894B58762C0680AD0351A264E409C16BEE9D68862C0E493D035CA234E4050146994EE8962C098427AE09C224E40D5FCBDE93D8A62C0E048258B67214E405AE968948F8A62C0D7B2CE3522214E409A16BEE9D68A62C040D2258B97214E4069BE6894508B62C03FB6D035D6234E40D6FCBDE98D8B62C0E3B2CE35A2244E4096CF6894268C62C0E193D035CA244E40EA63BEE9818C62C0BBC5CF3582234E40030EBEE9938C62C0FF80CF35EA214E40E41C6994518C62C0D7B2CE3522214E40F638BEE9C28B62C08F8D258B7F204E402ED86894A98B62C0BFC5CF35021F4E40D2B56894DD8B62C08D71D0353E1D4E408CFA6894358C62C01CE8CF35CE1B4E40D2B56894BD8C62C0E019CF35C61A4E4030D86894498D62C00481CF352A1A4E40331FBEE9C98D62C0FFCB7AE04C194E40CA27BEE92C8E62C0DCFD79E084174E40030EBEE9138D62C0443CCF35D2174E40EA63BEE9018C62C024B979E0AC184E40C827BEE9FC8A62C0E719CF35061A4E40B07DBEE90A8A62C01CE8CF35CE1B4E40F3F16894428862C08BF7CE353A204E40321FBEE9398762C0707479E054214E40F4F16894128662C037D5CE352E204E40F4F16894128662C0DFB2CE35621F4E407E256994548762C0BFC5CF35021F4E402BD86894798862C05FBF248BB71D4E40244ABEE9E88762C094F7CE35FA1C4E401875BEE9878662C02FD5CE352E1C4E40F4F16894128662C0E3FD79E0041B4E4068BE6894F08562C0E348258B27194E405AE968941F8662C097F7CE357A174E40321FBEE9B98662C02F4FD035F2134E406E05BEE9008662C00817268B2F154E406030BEE91F8562C0E019CF35461B4E408BFA6894858462C05FBF248BB71D4E40525BBEE93E8462C094F7CE35FA1D4E40D3B56894CD8362C0E0FD79E0041E4E40050EBEE9638362C003CC7AE08C1D4E408F41BEE9358362C0F035248B471C4E401875BEE9478362C0D0FD79E0C41A4E40A2A46894778362C08471D035BE194E409A16BEE9468562C0607479E014134E40AE7DBEE90A8662C09B8D258B3F114E405CE96894EF8662C0EF19CF3586104E4039AD6894EA8862C0E793D0354A104E40D4FCBDE98D8962C073BF248B77114E4096CF6894268962C0503CCF35D2144E40F3F16894B28962C07F71D035FE144E408D41BEE9558A62C04BD2258B17164E40244ABEE9A88A62C0F319CF35C6154E408AFA6894C58B62C0DFB2CE35220F4E406030BEE9EF8B62C06C0AD0351A0B4E40311FBEE9698C62C06F557BE07C074E40BC52BEE92B8D62C0F816268BEF044E40CA27BEE92C8E62C0D1B2CE3522044E40CA27BEE92C8E62C0B0C5CF3542034E40301FBEE9098D62C02B04258B4F024E40C927BEE9DC8C62C078557BE0FC014E40C4E06894EC8C62C0D048258BE7004E4089FA6894058D62C00781CF356A004E40B07DBEE90A8D62C02C4FD035F2FF4D40C927BEE9DC8C62C0B0107BE0E4FE4D404E146994EE8D62C0D893D035CAFA4D40E61C6994718E62C08771D0353EFA4D40E963BEE9118F62C0F419CF3546FC4D401775BEE9F78F62C0304FD035B2014E40020EBEE9939062C0D02CD035A6034E40244ABEE9789162C0D1B2CE3522044E40311FBEE9199162C030D5CE35AE014E40F838BEE9229162C0985ECF359EFF4D406C05BEE9809162C02704258B0FFE4D406ABE6894209262C0B8107BE024FD4D401775BEE9879162C098427AE01CFC4D40341FBEE9F99162C0B3C5CF3582FA4D4022036994A89462C00181CF352AF64D40C827BEE9FC9462C0CF2CD03526F64D40D5FCBDE94D9562C00017268B2FF74D40020EBEE9439562C0E793D0354AF84D40321FBEE9099562C05CA3CF3536F94D40311FBEE9C99462C098F7CE35BAF94D402ED86894499562C048D2258B57FA4D40826CBEE9C49562C04C877AE034FA4D405CE968943F9662C0533CCF35D2F94D40C4E06894BC9662C098F7CE35BAF94D40F838BEE9229762C043D2258B17FA4D401875BEE9D79762C0DB48258B27FB4D40264ABEE9489862C0CF2CD03566FB4D408F41BEE9359962C02B4FD035B2FA4D40FFC66894039B62C063A3CF35F6F74D405D30BEE9FF9B62C093F7CE35FAF74D40D7FCBDE98D9C62C03FB6D03516F94D40E863BEE9A19D62C0740AD0355AFC4D40BD52BEE96B9E62C0B8107BE024FD4D406ABE689410A062C01704258BCFFB4D40D4FCBDE9BDA062C093427AE0DCFB4D40B80B69949BA062C0DBFD79E004FE4D407E25699464A262C040D2258B17FC4D40B80B69946BA362C0EF35248B07FC4D40F4F16894E2A362C0B0107BE0E4FE4D406C05BEE980A362C07C0AD0355A004E40D2B56894BDA162C0677479E0D4044E40D7FCBDE93DA162C0B8C5CF35C2064E404E1469943EA262C0F8CB7AE0CC074E40C4E068944CA362C00417268B6F074E406130BEE94FA462C0607479E014064E40B07DBEE92AA662C01BE8CF35CE014E401775BEE967A662C0543CCF3512014E406E05BEE990A662C0F019CF35C6FF4D40AE7DBEE99AA662C00C81CF356AFE4D40535BBEE9AEA662C027D5CE352EFD4D4095CF6894F6A662C0F419CF3546FC4D40545BBEE9FEA662C0F835248B47FA4D40C4E068947CA762C017E8CF354EF84D40F838BEE9D2A762C0D893D0358AF64D4096CF689466A762C02F4FD03532F54D40816CBEE9B4A762C007CC7AE08CF34D406ABE689440A862C0334FD035B2F14D40545BBEE9CEA862C0D893D0354AF04D408D41BEE925A962C043877AE0F4EF4D406D05BEE960A962C0A85ECF359EF14D40C4E068944CA962C0CB2CD03566F64D409A16BEE996A962C078557BE03CF94D40C927BEE99CA962C00481CF356AFA4D408AFA689495A962C047877AE0B4FC4D40E51C6994C1A962C0F780CF352AFD4D40D0B568941DAA62C09F5ECF355EFD4D40525BBEE96EAA62C08C71D035FEFD4D403CAD68947AAA62C033D5CE35AEFF4D40244ABEE948AA62C0E0B2CE3522004E40BC52BEE98BA962C031B6D035D6004E40F838BEE962A962C0B8C5CF3582014E40AD7DBEE99AA962C059A3CF35F6024E408D41BEE915AA62C040877AE034034E403AAD6894EAAA62C0A85ECF35DE024E40806CBEE954AB62C0B8107BE0A40B4E40C6E068949CAB62C08071D0353E0E4E409C16BEE946AC62C00081CF35AA0F4E40060EBEE913AD62C03CB6D035D60F4E40E71C6994C1AD62C0304FD035B20E4E4089FA6894F5AD62C05FA3CF35360D4E40826CBEE924AE62C018B979E0AC0A4E402003699438AE62C00BCC7AE00C084E403CAD68941AAE62C087427AE05C064E402ED8689489AD62C0A85ECF35DE024E407B25699464AD62C02B04258B4F024E40EB63BEE971AC62C033D5CE35AEFF4D40F4F1689462AD62C0D0B2CE35E2FE4D409C16BEE9D6AD62C094F7CE353AFE4D4098CF689436AE62C0B8107BE024FD4D40C4E068945CAE62C00081CF35EAFB4D40BC52BEE97BAE62C074BF248BF7F84D4096CF6894A6AE62C093F7CE35FAF74D40BA52BEE91BAF62C08C71D0353EF74D40D2B568947DAF62C0F780CF356AF74D40F838BEE9E2AF62C0A85ECF35DEF74D408F41BEE965B062C093F7CE35FAF74D40C827BEE9DCB062C02804258B4FF74D405AE96894BFB162C027B979E0ECF44D402DD8689409B262C0D048258B67F44D408AFA689475B262C0B0107BE0E4F24D408BFA689465B362C098F7CE353AEC4D4068BE689400B462C050A3CF35B6EA4D40A4A4689417B462C0F319CF3506EA4D402F1FBEE9D9B362C0E719CF3586E84D402103699478B362C0E819CF3506E74D4000C7689423B362C050D2258B57E64D40E963BEE9C1B262C0E893D0350AE54D40806CBEE994B262C017B979E0ACE44D40A4A4689447B262C08C71D0357EE44D408AFA689445B162C017B979E0ACE44D40C827BEE97CB162C00881CF352AE34D4068BE689490B162C01F04258B0FE24D40BD52BEE98BB162C0BF2CD03526E14D40D2B568947DB162C098F7CE353AE04D4098CF6894F6B062C0888D258B7FDE4D402CD86894B9B062C030D5CE352EDD4D40B07DBEE9DAB062C07B0AD035DADB4D4000C7689433B162C05FA3CF35B6DB4D40E61C6994A1B162C0513CCF3592DC4D401775BEE957B262C094F7CE357ADE4D40E61C6994D1B262C0C0C5CF3502DF4D4030D8689459B462C06C0AD0355ADF4D40A5A4689437B362C02FB6D03516E24D40331FBEE909B362C054D2258BD7E24D40F4F1689442B362C00817268B2FE44D40264ABEE9C8B362C020B979E06CE44D406ABE689460B462C03FB6D03556E44D402ED86894C9B462C017B979E0ACE44D40FEC66894A3B462C0D52CD035A6E64D406D05BEE980B562C045B6D03596E84D408BFA689455B562C02B04258B4FEA4D40525BBEE91EB562C04F3CCF3592EB4D407E256994A4B462C095427AE0DCEF4D40C4E068948CB462C050D2258B57F14D40D0B56894CDB462C0CFFD79E0C4F44D40F638BEE972B562C008CC7AE04CF84D40D2B568944DB662C0690AD035DAFA4D406D05BEE930B762C0CF2CD03566FB4D40806CBEE9B4B762C0E348258B67F94D40F2F16894A2B762C0FC35248B07F24D409C16BEE9F6B762C037D5CE35AEEE4D40F2F1689482B862C094F7CE357AEB4D40CA27BEE9DCB862C018B979E0ECEA4D401975BEE997B962C00C81CF35AAEB4D40525BBEE98EBA62C0CF48258BA7ED4D403BAD68941ABB62C0985ECF35DEED4D40A4A46894C7BB62C0E093D0358AEC4D40CA27BEE95CBB62C018B979E0ECEB4D403AAD6894EABA62C0D748258BE7EA4D40C5E068945CB962C09F5ECF355EE64D40C5E068949CB862C017B979E0ACE44D40F638BEE902B862C0304FD03532DA4D408BFA689415B862C0E048258B67D74D405F30BEE9DFB762C0D42CD03566D54D408BFA689435B862C08871D035BED44D40A4A46894C7B862C07B0AD0351AD54D4098CF689446B962C028B979E02CD64D405BE96894DFB962C08B71D035FED74D40B952BEE90BBA62C054877AE0B4D84D40C6E06894CCB962C0B0107BE0E4DA4D40826CBEE9D4B962C07B0AD035DADB4D402ED8689449BA62C097427AE0DCDC4D40C827BEE96CBB62C0C82CD035E6DD4D408C41BEE9E5BB62C0F880CF35EADE4D40B60B69942BBD62C04B3CCF3512E34D406030BEE96FBD62C068BF248BB7E34D406C05BEE9D0BE62C0E3FD79E044E44D40244ABEE998C062C064A3CF3536E64D40FEC6689403C162C00FE8CF354EE64D40BC52BEE93BC162C0204FD03572E54D40C927BEE94CC162C00436248B47E34D40B70B69944BBF62C098F7CE353AE04D4069BE689420BF62C0E393D0358ADF4D405EE96894BFBE62C0A45ECF351EDD4D4097CF689476BE62C008E8CF358EDC4D40CA27BEE9ACBD62C01CE8CF354EDC4D40030EBEE953BD62C07B0AD035DADB4D4001C76894A3BE62C077557BE0BCD54D408E41BEE915C062C03BD5CE352ED24D401775BEE967C062C00981CF356AD04D405BE96894FFC062C004CC7AE08CD14D40AF7DBEE95AC162C0D0B2CE3522D34D405CE96894EFC162C098427AE09CD64D40FFC6689463C262C0898D258BBFD74D4068BE689420C362C0FC35248B07D94D406D05BEE9D0C362C0B7107BE0A4D94D40525BBEE91EC462C0BFC5CF35C2D84D40C4E06894DCC362C0FC80CF352AD74D402DD8689459C362C0EF35248B07D64D40AE7DBEE9FAC262C08871D035BED44D408F41BEE925C362C0CFB2CE35A2D24D40BA52BEE96BC362C0A45ECF359ED04D40D2B568946DC362C05FA3CF35B6CE4D40826CBEE934C362C0C92CD03526CD4D405BE96894CFC262C0A85ECF351ECC4D40A2A4689487C362C07C71D0353ECA4D40C927BEE9ECC362C0770AD0359AC94D409C16BEE956C462C054D2258B57C94D404F146994CEC462C0E4FD79E0C4C94D40BA52BEE95BC562C0344FD035B2CB4D40B80B6994ABC562C0A85ECF351ECC4D40254ABEE958C662C0D8B2CE3522CB4D40E863BEE961C662C01804258BCFC84D405AE968940FC662C0D448258B27C64D40B80B6994ABC562C0730AD0351AC44D407C25699494C762C06B7479E054C44D40A2A4689437C862C040D2258B57C34D40AF7DBEE9DAC762C094F7CE35BABF4D40FEC66894F3C862C0E793D0358ABF4D40EA63BEE951C962C03BB6D03516BF4D4068BE689470CA62C020B979E0ECBC4D40F2F1689422CB62C0CF48258B27BC4D408E41BEE9D5CB62C03FD2258B17BC4D4096CF689476CC62C097427AE01CBD4D40B90B69943BCC62C054D2258B57BD4D408E41BEE9D5CB62C00417268BEFBD4D40E71C699491CB62C01BE8CF350EBE4D409C16BEE906CC62C0D0B2CE3562BF4D40FFC6689443CC62C094F7CE35BABF4D408AFA6894D5CB62C0C0C5CF3542C04D40E963BEE961CB62C0473CCF3592C04D40C6E06894FCCA62C0E3B2CE3522C14D409C16BEE9B6CA62C07C0AD0355AC24D40F3F1689432CB62C0BF2CD03566C24D4068BE689470CB62C0EB93D0354AC34D40BA52BEE97BCB62C053D2258B97C44D40525BBEE95ECB62C017B979E0ECC54D402103699408CB62C090427AE01CC74D409C16BEE916CA62C038D5CE352EC84D408D41BEE9B5C962C0304FD035F2C84D40D6FCBDE96DC962C0EC93D0358ACA4D40D6FCBDE96DC962C0E393D035CACB4D40A4A4689477C962C0FF16268BEFCC4D40B70B69944BC962C090F7CE353ACE4D407C256994A4C862C08171D0353ED04D408C41BEE985C862C0C72CD03566D14D405CE96894BFC862C0A05ECF351ED34D408E41BEE905C862C070BF248B77D54D407C25699454C762C0EB19CF3506D94D40D5FCBDE92DC762C0543CCF3592DB4D40F4F1689412C862C0C02CD035E6DA4D40BC52BEE9EBC862C03BB6D03596D84D409A16BEE956CB62C047D2258B17CD4D4088FA689425CC62C048877AE034CB4D40826CBEE994CC62C04F3CCF35D2C94D4000C7689493CD62C0730AD0351AC44D40F838BEE9E2CE62C0E493D0354ABF4D407C25699404CF62C047877AE034BD4D401A75BEE957CF62C0543CCF35D2BB4D407C256994C4CF62C0AC5ECF359EBB4D40F1F1689432D062C097427AE01CBD4D40CA27BEE90CD062C0DFFD79E044BF4D40A2A4689457D162C04C877AE0F4C14D40806CBEE9B4D162C0503CCF3592C44D40E71C699471D162C053877AE074C64D406130BEE92FD062C09CF7CE357ACA4D40F4F16894C2CF62C00D81CF35EACC4D4097CF6894F6D062C0E893D0350ACD4D40BC52BEE9BBD362C08871D0353EC84D408D41BEE905D562C060BF248BB7C64D408D41BEE905D562C017B979E0ECC54D408E41BEE965D462C0EB19CF3546C54D4022036994A8D362C02FD5CE35AEC34D4050146994FED262C00481CF35AAC14D402DD8689499D262C094F7CE35BABF4D4002C7689493D262C00817268BAFBD4D4050146994FED262C00817268BAFBC4D40D6FCBDE95DD462C0F935248B47BB4D40D6FCBDE95DD462C08471D0357EBA4D40264ABEE9A8D362C0D348258BA7B94D40301FBEE959D362C064A3CF35F6B84D405CE968947FD362C0D02CD03526B84D4096CF689426D462C08871D035FEB64D408D41BEE9E5D462C0B0C5CF3542B64D406C05BEE950D762C0D893D0350AB64D40C6E068947CD762C047D2258B17B54D4001C76894C3D762C0DCFD79E004B34D408D41BEE925D862C0304FD035F2B04D4000C76894A3D862C08071D035FEAF4D402DD8689439D962C000CC7AE08CAF4D40B80B69942BDB62C07871D035FEAB4D4098CF689466DB62C01BB979E06CAB4D40806CBEE9A4DB62C0284FD035F2AA4D40D2B568945DDD62C001CC7AE0CCA94D403BAD68945ADD62C037B6D03596A84D407C25699414DD62C067557BE0BCA64D40C727BEE95CDC62C04C877AE034A34D40AE7DBEE98ADC62C064A3CF35F6A04D40B80B6994CBDD62C0EC19CF35C69F4D4020036994E8DE62C0C4C5CF35029E4D40C827BEE9ACDE62C0473CCF35129A4D40030EBEE9E3DF62C0988D258BFF9C4D404F1469945EE062C02CD5CE35EE9E4D40D5FCBDE94DE062C00C81CF35AAA04D40F3F16894E2DF62C0553CCF3552A24D406030BEE9EFDF62C0D42CD035E6A24D40F638BEE942E062C0BB7A248B1FA34D407E256994A4E062C038D5CE35AEA34D404D1469941EE162C0FF16268B6FA54D40C6E068945CE162C0E793D0350AA64D40BD52BEE9BBE162C013E8CF354EA64D40C5E068941CE262C0B07A248BDFA54D40E763BEE981E262C0E019CF3506A54D4088FA6894F5E262C08171D0357EA44D40826CBEE9E4E362C0B77A248B9FA54D409A16BEE9A6E562C0FC35248B87A64D40E81C699451E762C08871D0357EA84D403CAD6894CAE762C0BFC5CF35C2A84D40E963BEE941E862C00481CF35AAA84D40535BBEE9BEE862C018E8CF350EA84D404D1469943EE862C0334FD03532A64D40C3E068948CE762C03F877AE0F4A54D40E863BEE9D1E662C0BCC5CF3502A64D402CD8689439E662C0ED93D0350AA54D403AAD6894CAE562C0B7C5CF35C2A34D402103699428E462C02404258B0FA14D404F1469947EE362C028D5CE356EA04D40D6FCBDE92DE362C0A75ECF35DE9F4D40B60B69940BE362C0D7B2CE35E29E4D40C4E068941CE362C0DF19CF35C69D4D402ED8689449E362C0B4C5CF35C29C4D401675BEE987E362C0E719CF35069C4D4050146994AEE462C0443CCF35D29A4D40BB52BEE92BE562C03CB6D035969A4D401875BEE9D7E562C0607479E0D49B4D40A4A46894C7E662C0747479E0949C4D40B70B69941BE762C0314FD035B29C4D402ED86894C9E862C0AB5ECF355E9C4D40BD52BEE96BE962C0314FD035B29C4D40C4E068942CEB62C067557BE0FC9E4D40515BBEE9EEEB62C014E8CF358E9F4D4000C7689473EC62C03BD5CE35AEA04D40F838BEE9B2EC62C02404258B0FA14D40B70B69941BED62C0E893D0354AA14D40525BBEE95EED62C00C81CF352AA14D403AAD68940AF062C0D893D0350A9E4D40E963BEE9A1F062C0314FD035B29C4D40EA63BEE941F062C02104258B4F9C4D40AE7DBEE98AEF62C0680AD0351A9C4D405CE968941FEF62C074557BE0BC9B4D4096CF6894A6EF62C018E8CF358E994D40244ABEE988F062C00917268B2F994D40264ABEE968F262C0473CCF35129A4D40D2B568943DF362C0513CCF35D2994D408AFA6894A5F362C00336248B47994D408F41BEE9B5F362C07C71D0353E984D40F4F1689452F362C0F7CB7AE04C974D406D05BEE970F262C041D2258B17984D40D5FCBDE92DF262C0948D258B7F964D402CD86894D9F562C0975ECF35DE944D4039AD6894BAF762C0C4107BE064954D402ED8689489F862C067BF248BB7984D40826CBEE954F862C050D2258BD79A4D4097CF689446F862C0A87A248B1F9C4D40D2B568946DF862C0314FD035B29C4D4000C76894E3FA62C0403CCF35529B4D408E41BEE9C5FB62C0700AD0355A9B4D407C25699494FC62C08371D0353E9C4D40826CBEE924FD62C0284FD035729E4D40F2F16894A2FC62C088F7CE357A9E4D405BE968945FFC62C01CB979E0EC9E4D40FEC6689463FC62C0E793D035CA9F4D40806CBEE9B4FC62C02404258B0FA14D40EA63BEE901FD62C074BF248B77A14D40C827BEE93CFE62C034D5CE35EEA14D409B16BEE9C6FE62C0B0107BE0A4A24D40826CBEE944FF62C0B7C5CF35C2A34D40F838BEE992FF62C09BF7CE357AA54D40BD52BEE98BFF62C018E8CF350EA84D40535BBEE93EFF62C0E548258BA7A94D40050EBEE9B3FE62C030D5CE352EAB4D40311FBEE999FD62C007CC7AE04CAD4D406C05BEE9B0FC62C0EF19CF3506AE4D408F41BEE915FA62C007CC7AE04CAD4D40B90B6994BBFA62C0FFCB7AE00CAF4D4000C7689433FC62C0503CCF3552B14D4050146994CEFC62C018E8CF350EB34D40BC52BEE99BFC62C050D2258BD7B44D40A3A46894A7FB62C0C0107BE0A4B64D40244ABEE9D8F962C02804258BCFB84D40EA63BEE9F1F762C0E393D0350AB94D40BA52BEE9FBF662C04FA3CF35B6B94D40E863BEE991F662C0B7C5CF35C2BB4D40C927BEE90CF662C09BF7CE357ABD4D40BD52BEE9DBF462C0284FD03532BE4D40B80B6994FBEE62C0284FD03532BD4D406D05BEE920EE62C0B7C5CF35C2BB4D403CAD68948AED62C0700AD0351ABA4D40E963BEE9D1EC62C094F7CE35FAB84D40B07DBEE93AEC62C027D5CE35EEB84D40AE7DBEE90AEC62C08471D0357EBA4D40B07DBEE97AEC62C0BC107BE0A4BC4D401675BEE917EE62C00717268B2FBF4D40F2F1689472EE62C0E893D0350AC14D4069BE689420EE62C0B47A248B1FC44D40BB52BEE95BED62C017B979E0ECC54D40B80B69949BEB62C028B979E0ACC74D40B80B6994EBEA62C0737479E0D4C74D4089FA689455E962C03BD5CE352EC74D40535BBEE9BEE862C028B979E0ACC74D408BFA689485E862C09C427AE01CC94D40C4E068947CE862C043B6D035D6CA4D401F03699448E862C014E8CF354ECC4D40D7FCBDE98DE762C00D81CF35EACC4D40B80B69943BE662C08C71D0357ECC4D40F1F1689492E562C02404258BCFCC4D40E61C699491E562C090F7CE353ACE4D402203699468E662C0A75ECF35DED04D40E41C699471E662C0503CCF3512D24D401775BEE9E7E562C0E448258BE7D34D402103699478E562C05DA3CF35B6D44D402CD8689489E462C008E8CF35CED54D402103699428E462C098427AE09CD64D403AAD6894DAE362C040877AE0F4D74D406030BEE96FE362C06CBF248BF7DA4D403AAD68942AE362C08F8D258B3FDC4D40A3A4689467E262C018B979E06CDE4D40806CBEE9C4DF62C068BF248BB7E34D406ABE6894C0E062C0647479E0D4E54D40545BBEE91EE262C07B557BE0FCE54D40D6FCBDE97DE362C017B979E0ACE44D40E61C6994F1E462C0E919CF3546E14D40C927BEE9CCE662C06C0AD0355ADF4D40040EBEE933EC62C0C0107BE064D64D4039AD68945AED62C077557BE0BCD54D403CAD6894CAED62C0E819CF3546D54D40F4F1689462EE62C0BF2CD03526D44D40A3A46894E7EE62C097F7CE35BAD24D405CE968941FEF62C0A85ECF355ED14D4050146994DEEE62C0A35ECF351ED04D401F03699448EE62C0A77A248B1FCF4D4089FA6894C5ED62C0BF2CD03566CE4D405EE968949FED62C0F019CF3546CE4D40F638BEE922ED62C0E093D035CACD4D401875BEE9C7ED62C01F04258B4FCE4D409C16BEE9E6F762C0E048258B67D74D40C4E06894FCF862C0770AD0359AD84D403AAD68949AFA62C024B979E0ACDB4D408AFA6894E5FB62C028D5CE35EEDF4D4069BE689440FC62C017B979E0ACE44D406D05BEE910FC62C07B557BE0FCE54D402003699428FB62C058A3CF35F6E84D406ABE6894F0FA62C0D848258B67EA4D40AD7DBEE99AFA62C0948D258B7FED4D409B16BEE9A6F762C08B71D0357EFE4D409A16BEE976F762C0543CCF3512014E40F738BEE932F762C00017268B2F034E401775BEE997F662C038B6D03556054E40806CBEE9E4EE62C0EC19CF3506184E405DE96894BFED62C0244FD035B21B4E40A5A46894E7EC62C01804258B4F204E406030BEE97FEC62C0BB7A248B5F264E40806CBEE994EC62C033B6D035162C4E40C827BEE97CEC62C0AFC5CF35022E4E402203699408EC62C04CD2258B972F4E408AFA689495EB62C0700AD0355A304E409C16BEE926EB62C0C0C5CF35C2304E40C827BEE92CEA62C0204FD035F2304E4039AD6894CAE962C0F935248B87314E40264ABEE9A8E962C02D4FD035F2324E40535BBEE99EE962C0FF16268B2F364E40D6FCBDE90DE962C02C4FD035723E4E40BC52BEE9FBE862C0D02CD03526414E40C5E068940CE962C08771D035BE444E40FFC6689443E962C08F8D258B7F464E40BC52BEE94BEA62C08C71D0357E494E40535BBEE9AEEA62C0FFCB7AE0CC4B4E40BC52BEE95BEB62C0A87A248BDF514E409C16BEE916EC62C0C3C5CF3542544E40AD7DBEE9AAEC62C0D048258BE7564E40C827BEE92CED62C0A75ECF35DE594E4039AD68945AED62C017B979E0EC5B4E4000C76894B3EC62C06FBF248B775E4E40C6E068945CEA62C07C0AD0359A5E4E408AFA689485E962C04F3CCF35D25F4E408AFA6894D5E862C063A3CF3536624E402203699418E862C08471D0353E634E402ED8689449E262C0E719CF3586644E408D41BEE965E162C038D5CE35EE654E408BFA6894D5E062C00017268BAF674E40C4E068946CD862C0AC5ECF359E764E40D6FCBDE94DD362C0938D258B3F7D4E40AE7DBEE97ACE62C0E0B2CE3562844E40F4F1689462CC62C00BCC7AE00C864E409C16BEE9B6CA62C04C877AE034844E405CE968944FCA62C09C5ECF35DE814E40B60B6994EBC962C0CF2CD035A67E4E40A2A4689467C962C02404258BCF7B4E4089FA689445C862C00817268B2F7A4E40E41C699491C762C0B57A248B5F784E4088FA689435C762C071BF248BF7774E4096CF689466C162C06C0AD0355A754E403CAD68944ABF62C00881CF352A784E40264ABEE9C8BD62C01FB979E0EC784E407C25699434BB62C0E348258BA77C4E40501469945EBA62C060A3CF35367D4E401875BEE917B862C0D52CD035A67C4E40EA63BEE9F1B662C04FD2258BD77B4E40BE52BEE9DBB562C03BB6D035967A4E406030BEE96FB462C0E719CF3546784E40806CBEE9E4B362C071BF248BF7774E408D41BEE9D5B062C071BF248BF7774E40311FBEE939B062C010E8CF358E774E40040EBEE9F3AE62C09C8D258BBF754E40244ABEE908A462C0690AD0351A714E4069BE689450A362C0B1107BE064704E409C16BEE9E6A262C0A87A248B9F6F4E405E30BEE97FA262C02804258B8F6E4E40FEC66894E3A162C098427AE09C6D4E407C25699444A162C097427AE01C6D4E4001C76894D3A062C0CF2CD035666D4E40F4F16894F2A162C0780AD035DA724E40F2F1689492A362C087427AE0DC764E40AE7DBEE96AA562C059A3CF3536794E4001C7689433A762C058A3CF35B6794E4069BE6894B0AA62C0607479E014774E40040EBEE973AB62C0F335248B87774E40264ABEE918AC62C059A3CF3536794E4039AD68947AAF62C0948D258BBF7D4E408F41BEE985B062C0D893D0358A7E4E4096CF6894C6B362C02D04258B4F7F4E405BE968940FB962C008E8CF35CE854E402203699488BA62C0C02CD03566894E409A16BEE916BD62C0503CCF35128C4E40A4A4689427C262C00017268BEF934E408F41BEE9D5C162C017E8CF350E964E40234ABEE938C162C054A3CF35B6984E405F30BEE97FC062C0F880CF356A9A4E402DD86894D9BF62C0204FD035B2994E40AE7DBEE93ABF62C0D848258B67994E40BB52BEE93BBE62C040B6D035969A4E4068BE689440BD62C0737479E0549C4E40BA52BEE9ABBC62C047877AE0B49D4E403AAD68947ABC62C0F319CF35C69E4E407D25699404BC62C04B877AE0F4A24E40D7FCBDE9CDBB62C0FF80CF352AA44E406E05BEE9F0B962C0FF80CF356AAA4E40545BBEE97EB962C0BF107BE064AB4E4000C7689403B962C097427AE09CAB4E401875BEE987B862C00CCC7AE08CAB4E408BFA689415B862C00717268BAFAB4E406C05BEE960B762C0E793D0350AAD4E40234ABEE988B662C02FD5CE352EB14E404D146994DEB562C09F5ECF351EB34E40B70B6994FBB462C0680AD0355AB44E40D0B568943DAA62C06C7479E054BD4E40EB63BEE9F1A862C0D02CD035A6BD4E403BAD68945AA862C0EB93D0354ABE4E40B80B6994DBA762C0A75ECF35DEBF4E40301FBEE9E9A862C037B6D035D6C04E409A16BEE956AD62C0A75ECF35DEBF4E409C16BEE9E6AC62C08C71D035BEC04E4000C76894B3AD62C00C17268BAFC14E40EA63BEE9C1B462C068557BE07CBE4E40C6E068943CB862C0FB35248B07BA4E408AFA689475B962C038B6D03556B64E40E51C699411BA62C0E0FD79E004B54E407C25699494BB62C030D5CE35AEB24E4098CF689426BC62C027B979E06CB14E40A5A46894B7BC62C0E819CF3586AF4E409A16BEE926BD62C0B7107BE024AD4E404E1469946EBD62C098F7CE35BAA74E406C05BEE9B0BD62C00436248B07A54E40B90B69940BBE62C071BF248BB7A24E40B80B69946BBE62C054877AE034A14E40AD7DBEE97ABF62C0F135248B879F4E40321FBEE9F9C862C0EF19CF3546A14E40A2A4689467C962C0978D258BFFA14E401775BEE9C7C962C08FF7CE353AA34E402ED86894E9C962C0E719CF3506A44E405DE968940FCA62C0F8CB7AE00CA44E40535BBEE97ECA62C04B877AE0F4A24E40020EBEE963CA62C034B6D035D6A24E40A4A4689457CA62C0687479E014A24E40535BBEE95ECA62C08C427AE01CA14E40535BBEE97ECA62C0707479E054A04E40806CBEE9B4CA62C0A75ECF351EA04E40AF7DBEE96ACE62C0707479E054A04E40C827BEE9FCCF62C08B71D0357EA14E408F41BEE955D162C030D5CE35AEA44E406C05BEE9F0D162C033D5CE356EA94E40311FBEE949D162C0DFFD79E044AF4E40806CBEE904D262C0F019CF35C6AE4E402ED86894C9D262C017E8CF350EAD4E40A4A4689437D362C00CCC7AE08CAA4E401975BEE9B7D262C050A3CF35B6A54E408D41BEE955D362C0ED93D0354AA54E4096CF689446D462C09CF7CE353AA64E408D41BEE905D562C02C4FD03532A84E40545BBEE91ED662C0E819CF3586A34E4001C7689463D762C0BBC5CF3582A04E40A2A4689487DC62C028D5CE356E9B4E40030EBEE953DE62C0C0C5CF35029B4E407B256994A4DE62C08F427AE09C9A4E408AFA689435DF62C098427AE0DC984E4096CF6894A6DF62C058A3CF3576984E40C6E068940CE062C04C3CCF3552984E40301FBEE9E9E062C0AC5ECF355E974E409C16BEE946E162C060A3CF35B6964E40F638BEE9F2E162C0C12CD035E6944E40321FBEE919E462C007E8CF350E8C4E40D6FCBDE97DE462C0B8C5CF35028A4E40020EBEE9F3E462C0888D258B3F884E40AF7DBEE9AAE562C0DF48258BE7864E40BC52BEE9CBE762C0E019CF3506854E40F4F16894F2E962C04C877AE034844E40AF7DBEE95AEA62C0FBCB7AE0CC834E405BE968942FEB62C07771D035FE814E402103699498EB62C0717479E094814E40F2F1689402EE62C0DF93D0358A824E40C4E068943CEF62C03CD5CE352E824E401775BEE9B7F062C0700AD0351A814E40F838BEE922F262C00BCC7AE04C7F4E40BB52BEE99BF362C017E8CF358E7B4E40D6FCBDE9ADF462C088F7CE35BA794E40C6E06894CCF562C0985ECF35DE764E40FFC6689433F762C0687479E054764E409C16BEE9E6F762C06C0AD0355A754E40E61C699411F862C058A3CF35F6724E40F838BEE972F962C094F7CE353A6F4E40244ABEE9D8F962C0F035248B876C4E40C827BEE9CCF962C02C4FD035326B4E40EA63BEE9A1F962C0F019CF35066A4E401775BEE9F7F662C09C427AE01C5F4E4001C76894C3F662C0B7107BE0E45C4E40E51C6994E1F762C017B979E0EC5B4E4000C76894F3F862C03CD5CE35AE5C4E409C16BEE9E6FA62C0BB107BE024604E4089FA6894D5FB62C0F880CF352A614E407C256994C4FB62C040D2258B97604E40264ABEE9A8FB62C0BB107BE0245F4E402103699498FB62C000CC7AE08C5E4E405AE968941FFD62C0607479E0945D4E40535BBEE9CEFD62C038B6D035D65C4E40B80B6994DBFE62C0D893D0350A5A4E40B07DBEE96A0063C0E3B2CE3522574E405CE96894FF0063C0670AD0359A564E40CA27BEE96C0163C08C71D0357E564E40806CBEE9A40163C0F880CF352A564E4020036994F80163C06F0AD035DA544E40EB63BEE9010263C0EC93D0358A544E40D6FCBDE93D0363C0503CCF35924E4E406230BEE97F0363C098427AE0DC4D4E40525BBEE9DE0363C0B0C5CF35424D4E407D256994940463C078557BE07C4C4E40AF7DBEE97A0563C0700AD0355A4A4E40020EBEE9730763C0FC80CF35AA474E4022036994180A63C0908D258BBF404E40BC52BEE98B0A63C0DB93D0350A3F4E40E863BEE9E10A63C0204FD035F23C4E40C827BEE9FC0A63C00BCC7AE08C3A4E406030BEE9BF0A63C034D5CE35EE374E402CD86894290A63C0687479E0D4354E40C4E068946C0963C030B6D035D6344E404F146994DE0763C088F7CE357A334E404F146994DE0763C0F816268BAF324E40A2A46894C70B63C007E8CF35CE2D4E40A3A46894B70C63C08C71D035BE2A4E406030BEE9CF0C63C0687479E0D4294E40C827BEE9EC0C63C0DF48258BA7274E40B70B69940B0D63C02004258BCF264E405CE968944F0D63C087427AE01C264E401875BEE9F70E63C0E4B2CE3522244E40A4A46894671063C0C82CD03526234E40AD7DBEE91A1163C0AFC5CF3502224E40806CBEE9141363C08D71D0353E1D4E40A6A46894B71363C040877AE0B41C4E402ED86894491463C017B979E06C1D4E40BC52BEE9DB1463C040B6D035961E4E40535BBEE97E1563C0DFB2CE35621F4E409C16BEE9C61963C050D2258B171E4E40EA63BEE9311B63C0DFB2CE35621F4E4022036994E81A63C0E919CF35C6204E408F41BEE9651A63C054D2258BD7204E40B07DBEE9CA1963C0DFB2CE3562204E408F41BEE9351963C037D5CE352E204E408F41BEE9351963C0D7B2CE3522214E40D0B56894DD1A63C0730AD0355A224E40F2F16894A21B63C0DF19CF3506224E40E61C6994811C63C037D5CE352E204E406D05BEE9C01C63C0898D258B3F234E40AE7DBEE9BA1C63C0FF35248BC7254E4039AD6894FA1C63C08871D0357E274E40264ABEE9081E63C0B37A248B1F284E40040EBEE9632063C0B37A248B1F284E40CA27BEE98C2163C0E0B2CE35A2274E40826CBEE9A42263C0BB7A248B5F264E406030BEE95F2363C018E8CF358E244E406E05BEE9502363C05FBF248B77234E4020036994C82263C09C8D258B7F234E4098CF6894162263C02804258B0F254E409C16BEE9362163C0403CCF3552264E4098CF6894E61F63C0B8C5CF3582264E40C4E068949C1E63C0985ECF359E254E40E61C6994D11D63C018B979E0AC234E4067BE6894C01D63C04CD2258B97224E40535BBEE9DE1D63C0D32CD03566204E40E61C6994D11D63C0DFB2CE35621F4E409C16BEE9861D63C087427AE05C1E4E40A2A46894B71C63C06F0AD0351A1D4E40B07DBEE99A1B63C043B6D035961A4E40D4FCBDE98D1863C0C02CD03566184E408BFA6894C51763C08F427AE05C164E406D05BEE9701763C0F319CF35C6154E40D2B568942D1763C01BB979E0AC154E40BA52BEE99B1663C00181CF35EA154E402ED86894591663C0F319CF35C6154E40B70B6994DB1563C054D2258BD7144E409A16BEE9A61563C068BF248B37144E406030BEE9CF1563C02F4FD035F2134E408F41BEE9F51563C0E448258B67134E409916BEE9E61563C078557BE03C124E4068BE6894B01563C04F3CCF3512114E405F30BEE95F1563C0EF19CF3586104E40D2B568940D1563C020B979E02C104E4001C76894E31263C010E8CF35CE0B4E40FEC66894831263C0BF107BE0640A4E40020EBEE9831263C09BF7CE35FA084E40F2F16894221363C065A3CF3576054E40C827BEE98C1363C0DCFD79E044044E40331FBEE9291463C0D1B2CE3522044E40331FBEE9291463C0B0C5CF3542034E40B07DBEE90A1463C053D2258B17034E405CE96894BF1363C068BF248B77024E408E41BEE9451563C03F3CCF3552FF4D40E41C6994B11563C0DBFD79E004FE4D408BFA6894151663C0F319CF35C6FB4D40BC52BEE98B1663C0AF7A248B1FF74D406C05BEE9001763C02F4FD03532F54D40C827BEE99C1763C0E419CF3546F44D40D2B56894DD1963C093F7CE35BAF24D40254ABEE9981A63C03BB6D03596F14D40244ABEE9F81A63C029D5CE352EF14D40311FBEE9691B63C0DF48258BE7F04D402ED86894F91C63C00017268B6FF14D40F838BEE9421D63C050D2258B57F14D40321FBEE9E91D63C04CD2258B97F04D40D2B56894AD2063C00036248BC7F14D40244ABEE9782163C08D71D0357EF14D406C05BEE9F02263C07771D0353EF04D40311FBEE9592763C00881CF352AEF4D402ED86894C92763C0C4107BE064EE4D40F2F16894622863C0700AD0359AEC4D40545BBEE9EE2863C0E593D0358AEA4D401775BEE9372963C058A3CF35F6E84D4088FA6894352863C0A45ECF351EE94D40545BBEE93E2763C0503CCF3512EA4D40244ABEE9482663C040B6D03596EA4D4000C76894D32463C00881CF35EAE84D401675BEE9672463C0D02CD03526E94D40E863BEE9012463C0DFB2CE35A2E94D408AFA6894E52163C03F877AE0B4EA4D40E51C6994712063C0E593D0358AEA4D404F1469942E2063C097427AE0DCE94D4069BE6894002063C037B6D03516E84D4069BE6894002063C02C4FD03572E64D40B07DBEE92A2063C060BF248B77E54D40C927BEE95C2063C0770AD0359AE44D40D1B568949D2063C0AF107BE0A4E14D40BA52BEE96B2163C057A3CF3576DC4D40826CBEE9C42163C0C02CD035E6DA4D402CD86894892263C0EF19CF35C6D94D4098CF6894762463C01FB979E0ECD74D4030D86894D92463C028B979E02CD64D40E863BEE9512563C08471D035FED44D40806CBEE9642663C077557BE0BCD34D40F2F16894922763C028D5CE35EED24D4020036994582863C0A05ECF351ED34D406B05BEE9902863C010E8CF350ED44D401975BEE9E72863C0BC107BE0A4D64D401775BEE9372963C0E048258B67D74D4096CF6894D62963C0F419CF3546D74D40C4E068941C2A63C0E019CF3506D64D40F538BEE9122A63C044D2258B97D44D4000C76894C32963C0E448258BE7D34D40E863BEE9A12963C0BFC5CF3582D34D404F146994CE2963C0CFB2CE35A2D24D4097CF6894262A63C0DCFD79E0C4D14D40A3A46894872A63C0A85ECF355ED14D40F4F16894122B63C0F419CF3586D14D40040EBEE9832C63C0A05ECF351ED34D4088FA6894C52C63C0BCC5CF3542D34D40B70B69949B2D63C0A05ECF351ED34D40B70B69949B2D63C0E448258BE7D34D40A5A46894172D63C0F716268BEFD44D40806CBEE9C42C63C0EF35248B07D64D40C4E068947C2B63C0AFC5CF3542DC4D40D2B568940D2B63C0A85ECF35DEDC4D405AE968944F2A63C07B0AD035DADB4D40FFC66894C32A63C0C4C5CF3582DD4D407F6CBEE9342C63C0C82CD035E6DE4D40B80B69947B2E63C050A3CF3576E54D40F838BEE9722E63C0C4C5CF3542E34D40AE7DBEE98A2E63C08FF7CE357AE14D4096CF6894862E63C0700AD0359ADF4D40321FBEE9292E63C0A45ECF351EDD4D406E05BEE9402E63C0908D258BBFDB4D40826CBEE9E42E63C0740AD0355AD64D40F638BEE9222F63C0F835248BC7D44D40030EBEE9B32F63C04FA3CF3536D34D40BB52BEE96B3063C0D02CD03526D24D406130BEE92F3163C014E8CF358ED14D4002C76894E33163C0A85ECF355ED14D401675BEE9573263C01F4FD03532D24D401875BEE9273363C097427AE01CD64D40BB52BEE98B3363C0E048258B67D74D40826CBEE9543363C07C557BE0FCD74D40C927BEE93C3363C0F880CF352AD84D409A16BEE9163363C0FF35248B47D84D409A16BEE9163363C068557BE03CD94D40CA27BEE9EC3363C07D557BE0FCD84D401775BEE9073463C0C72CD035A6D74D40F838BEE9E23363C0E819CF35C6D54D409C16BEE9F63363C0E448258BE7D34D40F838BEE9923463C068557BE0FCD24D40F4F16894423663C0E0FD79E084D24D40AE7DBEE99A3663C0BD107BE0E4D04D403BAD6894DA3363C00981CF356AD04D409A16BEE9963363C06FBF248B37D04D406ABE6894403263C06CBF248BF7CD4D40CA27BEE91C3263C077557BE0FCCD4D40A2A46894373263C0A85ECF351ECC4D40040EBEE9C33263C0DCB2CE35A2C84D409B16BEE9E63363C0403CCF3512C74D4096CF6894563963C07771D0357EC54D40AE7DBEE9FA3963C00C17268B2FC74D40C927BEE9AC3A63C0DCB2CE35A2C74D40F2F16894623B63C0A05ECF351EC74D40E71C6994113C63C017B979E0ECC54D406ABE6894E03A63C03CD5CE35AEC54D401975BEE9F73963C0C82CD035E6C44D404F1469942E3963C0F419CF3586C34D409C16BEE9B63763C064A3CF35B6BF4D402CD86894393763C087F7CE35BABD4D406D05BEE9303763C0D048258BA7BB4D403AAD6894EA3763C090427AE09CB94D40BD52BEE90B3863C0780AD0355AB84D40A2A46894F73863C0F8CB7AE08CB74D404F146994FE3A63C08871D035FEB64D406D05BEE9B03C63C04B3CCF3552B74D40F638BEE9323D63C08871D035FEB64D40C827BEE97C3D63C010E8CF354EB64D40E51C6994F13D63C0F019CF3546B44D408AFA6894453E63C08C71D0357EB34D40826CBEE9E44063C07771D035BEB14D405AE968941F4163C045B6D035D6B14D408AFA6894854163C0DBFD79E084B24D402DD86894C94163C0A95ECF359EB24D40EC63BEE9F14163C040B6D03556B24D40301FBEE9494263C0BD107BE024B14D40E71C6994714263C0D893D035CAB04D401875BEE9074363C08171D0357EB04D408E41BEE9A54463C0D893D035CAB04D40F2F16894924363C040B6D03516AE4D404E1469941E4263C041B6D03596AC4D402CD86894B94063C067557BE0FCAC4D40F2F16894D23F63C08071D035FEAF4D40040EBEE9833F63C033D5CE356EAF4D4068BE6894303F63C0AD5ECF351EAF4D403AAD6894DA3E63C0C0C5CF3502AF4D40F1F16894823E63C0BB7A248B1FAF4D40F1F16894823E63C0988D258B3FAE4D40545BBEE9DE4063C06F557BE0BCAB4D40816CBEE9944363C0EC19CF3506A74D4098CF6894164463C0D748258BA7A54D40C4E068947C4463C01CE8CF350EA44D408E41BEE9A54463C0747479E054A24D40BC52BEE9CB4463C0B37A248B1F9E4D404E1469949E4463C034D5CE35AE9C4D40030EBEE9F34363C0314FD035B29C4D405F30BEE92F4463C0B8107BE0A49A4D4050146994AE4463C02BB979E0EC994D4089FA6894F54563C0473CCF35129A4D40D5FCBDE9BD4563C08071D0357E974D40E963BEE9514663C00781CF352A964D4087FA6894354763C038D5CE35AE954D40C727BEE9EC4763C0AB5ECF359E954D405CE968944F4763C0493CCF35D2944D40CA27BEE90C4763C00B81CF35AA944D401875BEE9574763C027D5CE35EE934D40321FBEE9A94763C0D948258B67934D406E05BEE9004863C06F0AD0351A934D40C6E068945C4863C0888D258BFF924D40A2A46894174863C050877AE0B4904D408AFA6894854763C05F7479E054904D40D2B568942D4663C0908D258B3F914D40C3E06894AC4563C088427AE09C904D4069BE6894804563C034D5CE352E8F4D40341FBEE9A94563C063A3CF35B68D4D4020036994284663C04FA3CF35F68C4D403AAD6894DA4563C088F7CE353A8C4D4022036994B84563C0AFC5CF35028C4D4022036994B84563C0D7B2CE35228B4D40254ABEE9584663C0670AD035DA894D40806CBEE9644663C0D02CD03526874D404E146994FE4563C088F7CE357A844D4020036994484563C0EF19CF3546834D40D6FCBDE97D4463C078557BE0FC834D406030BEE9DF4363C030D5CE35AE854D40D2B568944D4363C04FA3CF35B6874D407C256994A44263C0DFB2CE3562894D40030EBEE9B34063C08771D035BE8A4D40E963BEE9A13C63C0C82CD03566884D40E61C6994C13A63C0DFFD79E084884D40B80B69941B3A63C0E719CF3546894D40BC52BEE9DB3963C0304FD03572894D40806CBEE9C43663C00FE8CF350E894D403CAD68940A3663C0C02CD03526884D408D41BEE9653563C08C71D035BE864D40B80B6994DB3463C00817268BEF844D4067BE6894403463C073BF248B37824D409C16BEE9F63363C0204FD03572814D4020036994A83263C04C3CCF3512804D40FFC66894533263C043B6D035567F4D40F838BEE9F23163C01804258BCF7E4D407C256994543163C0BB107BE0A47E4D409A16BEE9B63063C01804258BCF7E4D409A16BEE9563063C043B6D035567F4D40B07DBEE9EA2F63C0204FD03572804D409A16BEE9962F63C04F3CCF3552804D4068BE6894F02E63C0D12CD035E67E4D40BA52BEE9AB2D63C03FD2258B977D4D401875BEE9472D63C027B979E0AC7C4D40501469942E2C63C0DC48258B67784D409B16BEE9D62B63C0607479E0D4774D40B70B6994DB2A63C0607479E0D4774D40C3E068949C2A63C0E819CF3586774D40EB63BEE9A12A63C01F04258BCF764D40D3B56894BD2A63C02C4FD035F2754D405CE96894BF2A63C064A3CF3536754D40F638BEE9522A63C08071D0357E724D40F838BEE9022A63C0F8CB7AE0CC714D406030BEE96F2963C058A3CF35B6714D406030BEE96F2963C037B6D035D6704D40040EBEE9E32963C007CC7AE04C704D40525BBEE99E2B63C0E3B2CE35E26F4D40F838BEE9322B63C0BF2CD035266F4D40F2F16894B22A63C08B427AE0DC6E4D403CAD6894AA2863C0E093D0358A6F4D40D0B568944D2863C060BF248B376F4D40040EBEE9732863C08B71D035BE6D4D4069BE6894402963C0F8CB7AE00C6C4D40040EBEE9D32A63C0284FD035726D4D40525BBEE99E2B63C068BF248B776C4D40806CBEE9142C63C0975ECF351E6A4D4087FA6894A52C63C0AC5ECF351E644D405F30BEE90F2D63C019B979E06C614D409A16BEE9962D63C0F035248B475F4D40AE7DBEE90A2E63C0BF2CD035E65D4D40F3F16894E23063C00881CF352A594D40D0B56894ED3163C030D5CE35EE584D405CE968946F3263C034D5CE356E584D409C16BEE9A63263C0F816268BEF564D4000C76894E33263C00CCC7AE04C544D40AE7DBEE97A3363C077557BE07C524D40F3F16894423463C0EF19CF3546514D40321FBEE9193663C02804258B8F4F4D40826CBEE9743963C04CD2258B974E4D40050EBEE9A33B63C03FB6D035564F4D401875BEE9C73C63C0FF16268BEF4E4D40F638BEE9323D63C054D2258BD74C4D4068BE6894203D63C0985ECF35DE4B4D404F146994FE3C63C0F735248B474B4D40AF7DBEE9CA3C63C0E093D0350A4B4D405E30BEE9EF3C63C098F7CE353A4A4D40826CBEE9343D63C0DCFD79E0C4484D40A2A46894673D63C030D5CE352E474D405CE96894BF3D63C090F7CE353A454D4050146994BE3D63C07B0AD035DA444D402ED86894C93D63C02804258B8F444D40D5FCBDE90D3E63C0680AD0351A444D401A75BEE9473E63C033D5CE352E444D40301FBEE9893E63C048D2258B97444D4000C76894D33E63C0F019CF35C6444D4089FA6894253F63C0680AD0351A444D40F2F16894C23E63C0C82CD035A6434D408C41BEE9D53D63C0483CCF3512434D40D7FCBDE99D3D63C090427AE05C424D40FFC66894C33D63C09CF7CE357A414D401575BEE9273E63C0B47A248B5F404D40CA27BEE99C3E63C0C3107BE0643F4D40F3F16894F23E63C087427AE0DC3E4D40AF7DBEE90A4063C087427AE0DC3E4D40B07DBEE95A4163C0908D258B7F3F4D40C927BEE99C4263C0E0B2CE35623F4D40264ABEE9884363C0A05ECF351E3D4D408E41BEE9154363C0A85ECF35DE3B4D405F30BEE98F4263C0C02CD035E6374D407C256994344263C0E893D0350A364D4089FA6894254263C02FD5CE356E354D40806CBEE9344263C0A35ECF35DE344D409A16BEE9364263C054A3CF3576344D40525BBEE9FE4163C0F8CB7AE04C344D40FDC66894034163C0F8CB7AE04C344D40311FBEE9A94063C0988D258BBF334D40E863BEE9414063C00FE8CF358E324D40E863BEE9014063C0670AD0355A314D4000C76894234063C017E8CF35CE304D40C827BEE97C4063C0647479E094304D40AE7DBEE9FA4163C0FF80CF35AA2E4D408AFA6894D54263C01FB979E02C2E4D40826CBEE9144663C01FB979E02C2E4D40C6E068944C4663C00717268B6F2D4D40C927BEE91C4663C0533CCF35122D4D40BC52BEE93B4663C09B427AE05C2C4D40C727BEE99C4663C098F7CE357A2B4D4098CF6894F64663C038B6D035162B4D40311FBEE9C94763C0607479E0D42A4D403CAD68949A4963C0BBC5CF3502294D40F638BEE9324A63C0F419CF35C6274D40040EBEE9534A63C078557BE03C264D40244ABEE9A84B63C08471D0357E244D40F2F16894624B63C0DCFD79E0C4234D404E1469943E4B63C07C557BE0BC224D405F30BEE94F4B63C044877AE0B4214D40244ABEE9A84B63C08871D035FE204D40C4E068944C4B63C02F4FD035B2204D406ABE6894004B63C060A3CF3536214D4000C76894B34A63C0F8CB7AE00C224D40040EBEE9534A63C07C557BE0BC224D40D7FCBDE9DD4963C0878D258BFF224D406C05BEE9004963C050D2258B17234D407B256994944863C09F5ECF359E234D40030EBEE9B34863C048D2258BD7254D40C927BEE91C4863C0E0B2CE3562264D40C727BEE99C4663C078557BE03C264D40545BBEE97E4663C00781CF35AA264D406030BEE95F4663C061A3CF3576274D408AFA6894354663C0F8CB7AE04C284D4089FA6894F54563C06F0AD035DA284D40BA52BEE97B4563C00717268B2F294D40B07DBEE94A4563C06F0AD035DA284D401775BEE9274563C06C7479E014284D40EB63BEE9E14363C017E8CF35CE234D40AF7DBEE9DA4463C00017268BAF224D401975BEE9974663C08F8D258B3F224D40C727BEE9EC4763C08871D035FE204D406C05BEE9004663C038B6D03516204D40B07DBEE94A4563C0C3107BE0A41E4D40D3B568944D4563C0888D258BBF1B4D407C256994044663C0985ECF355E194D40040EBEE9134763C0948D258B7F184D40D4FCBDE92D4863C0737479E0D4184D407C256994044963C0908D258BFF194D40E41C6994414963C07C0AD0359A194D40C6E06894AC4963C0BB7A248B1F194D40FEC66894334963C08B71D0353E174D40B80B69948B4763C0DCB2CE35E2134D40826CBEE9444763C018E8CF350E124D4089FA6894E54763C028D5CE352E104D4022036994F84863C0FB35248B07114D40254ABEE9C84A63C0908D258BBF144D40BC52BEE92B4B63C0533CCF3592124D40D4FCBDE90D4B63C0473CCF3512114D404E146994BE4A63C0B8107BE0A40F4D40BD52BEE98B4A63C038D5CE35AE0D4D406ABE6894C04A63C027D5CE35EE0A4D40311FBEE9494B63C0F019CF35860A4D40A2A46894D74B63C06F0AD0359A0B4D40D5FCBDE95D4C63C01DE8CF350E0F4D40D8FCBDE9FD4C63C0D0B2CE3562104D4067BE6894B04D63C04FA3CF3576114D40501469942E4E63C08871D0357E124D401875BEE9574E63C0DBB2CE3562134D406C05BEE9704E63C0978D258B7F144D40CA27BEE97C4E63C04FA3CF35B6154D406230BEE97F4E63C0C82CD035E6164D40B07DBEE9AA4E63C00036248B07184D404F1469940E4F63C087427AE0DC184D405AE96894CF4F63C0908D258BFF194D40A2A46894F74E63C03F3CCF35D2124D40B60B6994BB4E63C087F7CE35BA0E4D40244ABEE9084F63C0948D258B7F0B4D40254ABEE9F84F63C07C557BE03C0B4D409A16BEE9765263C04CD2258B17104D40B60B69948B5363C030D5CE356E0F4D40FFC66894635363C02C04258B8F0E4D408AFA6894B55163C0D0B2CE35A20A4D40F3F16894B25163C0FF16268B2F0A4D408F41BEE9755163C0730AD0351A094D402BD86894A95163C0314FD035B2064D40525BBEE91E5263C0E393D0354A044D40244ABEE9A85263C0284FD03532034D40F838BEE9325463C08C71D035FE034D40EA63BEE9A15463C0E893D0358A044D40515BBEE9BE5463C03F3CCF35D2054D405EE96894BF5463C000CC7AE04C074D40AE7DBEE9DA5463C0284FD03572084D405F30BEE96F5563C0B0C5CF3542094D40AF7DBEE92A5663C04C3CCF35D2084D409A16BEE9E65663C0D993D0358A074D40515BBEE97E5763C03F3CCF35D2054D40CA27BEE99C5763C009CC7AE00C054D402ED86894B95763C058A3CF3536034D40301FBEE9E95763C07C71D0353E024D40D3B568942D5863C097427AE09C014D403BAD68948A5863C010E8CF350E014D40C6E06894EC5863C0BF2CD035A6004D40501469943E5963C0948D258B7F004D40515BBEE9EE5963C0E093D0350A014D4098CF6894665B63C0204FD03572034D40E61C6994315C63C08C71D035FE034D40331FBEE9295F63C08C71D035FE034D40D2B56894BD6063C0F319CF3546034D40244ABEE9486163C047877AE034024D402CD86894E96063C0948D258B7F004D4068BE6894706163C087F7CE35FAFC4C401875BEE9076263C00417268B2FFB4C408D41BEE9D56263C0F8CB7AE08CFA4C40F2F16894026463C05BA3CF3576FA4C407E256994746263C0E4FD79E044F54C40F2F16894326263C088427AE0DCF24C40D6FCBDE91D6363C030D5CE35AEF04C40301FBEE9696463C0AFC5CF35C2EF4C402FD86894296863C030D5CE35AEF04C40501469942E6763C040D2258BD7ED4C40C3E068940C6763C03FB6D035D6EC4C408AFA6894456763C0E493D035CAEB4C40301FBEE9C96763C0A75ECF351EEB4C404E146994CE6863C0C82CD035A6EA4C40C827BEE9DC6963C0A05ECF355EEB4C403CAD68946A6A63C050A3CF3576EB4C4020036994C86A63C0C82CD035A6EA4C408AFA6894B56A63C0D793D035CAE94C40264ABEE9E86963C02C4FD03532E64C405CE968940F6B63C0607479E014E74C408AFA6894756B63C03F3CCF3512E74C408AFA6894756B63C02C4FD03532E64C40EA63BEE9C16A63C050A3CF3536E54C40C4E06894FC6963C09CF7CE353AE34C40F4F16894926963C0BC7A248BDFE04C40D5FCBDE9ED6963C0F019CF35C6DE4C401975BEE9476A63C0FF35248B47DE4C40C827BEE93C6B63C0B0C5CF3582DD4C4000C76894036C63C087F7CE353ADD4C40816CBEE9546C63C0244FD035F2DC4C40545BBEE99E6C63C0C0107BE0E4DC4C40C827BEE9FC6C63C0D5B2CE3562DD4C404D146994DE6D63C050A3CF3576DF4C40525BBEE9AE6F63C0D32CD035A6E14C401675BEE9277063C0607479E0D4E14C4068BE6894F07063C098427AE0DCE24C40F4F16894A27163C0A85ECF35DEE44C407C256994647263C0988D258B3FE64C40C827BEE95C7363C0D848258B67E54C40EA63BEE9C17363C018B979E0ECE34C40321FBEE9197463C0D32CD035A6E14C401775BEE9577463C0C72CD03526DF4C405CE968946F7463C070557BE0FCDC4C401775BEE9177463C0B0107BE0A4DA4C408D41BEE9D57263C0EC19CF3546D84C401675BEE9E77263C068BF248B77D64C40030EBEE9937363C08FF7CE353AD54C406ABE6894807663C098F7CE35FAD24C406C05BEE9607863C098F7CE35FAD24C405AE96894AF7863C0EB19CF3586D24C40F1F16894527863C017E8CF358ED14C404E1469947E7763C0F419CF3546D04C40E61C6994717763C04C3CCF3592CF4C406D05BEE9807763C047D2258BD7CE4C404E1469949E7763C05CA3CF3536CE4C40B90B6994BB7763C077557BE0BCCD4C402CD86894897763C0A15ECF351ECC4C406D05BEE9A07763C070BF248B37C94C404E1469947E7763C0F835248B87C74C40B90B6994BB7763C0F880CF35AAC64C40EA63BEE9617963C054877AE0B4C54C4021036994C87963C0E3B2CE3522C64C40C4E06894EC7963C0E3B2CE3522C74C403AAD6894FA7963C02004258B4FC84C40D6FCBDE91D7A63C0F035248B47C94C40D3B568946D7A63C0C0107BE024CA4C40BA52BEE99B7A63C00317268B2FCA4C406C05BEE9207B63C0B8C5CF3502C84C40050EBEE9937B63C0E893D0358AC74C40D4FCBDE9ED7C63C074557BE03CC74C409B16BEE9367D63C027D5CE352EC64C40F738BEE9927D63C0D0FD79E004C44C409C16BEE9667E63C0CF2CD03566C44C40E61C6994517F63C0E3B2CE3522C64C40A4A46894A78063C06C7479E0D4C94C409A16BEE9168163C0C0107BE024C94C4096CF6894168163C0975ECF351EC74C40D6FCBDE97D8063C00081CF35EAC44C40D6FCBDE97D8063C0EC93D0350AC44C406A05BEE9A08263C0C3C5CF35C2C44C40321FBEE9598363C0EC93D0350AC44C40B90B6994EB8263C06F557BE07CC24C40F838BEE9A28163C0D793D0354AC24C40D4FCBDE95D8163C0F816268BEFC04C405CE968945F8163C030D5CE35AEBE4C40020EBEE9538163C0F035248BC7BC4C40F838BEE9228163C033B6D03556BB4C408E41BEE9B58063C02BB979E06CBA4C406E05BEE9F08163C04B3CCF3512B74C40B60B69949B8363C069557BE03CB94C40C827BEE95C8563C0B37A248B9FBC4C40D6FCBDE9DD8663C058A3CF35F6BC4C402ED86894198763C02C4FD035F2BB4C40BA52BEE93B8763C097F7CE357ABA4C40D7FCBDE94D8763C0770AD0359AB84C40040EBEE9A38763C030D5CE35EEB74C4089FA6894958863C08071D035FEB64C40E963BEE9E18963C0E0B2CE3562B64C401675BEE9D78A63C027B979E02CB54C40A4A46894178F63C08071D0357EAB4C40C4E06894CC8F63C007E8CF354EAB4C40301FBEE9A99063C0D7B2CE35A2AA4C40D2B568946D9163C007E8CF354EA94C40816CBEE9D49163C0A05ECF351EA74C405CE96894BF9163C007E8CF350EA44C40AF7DBEE92A9163C08FF7CE35BAA34C40AD7DBEE98A8C63C008CC7AE04CA84C40AD7DBEE95A8B63C0680AD035DAA74C40806CBEE9048B63C00381CF35EAA74C408AFA6894258B63C064A3CF3576A64C406C05BEE9E08A63C0E4FD79E084A44C40806CBEE9048B63C024B979E0ACA24C40C6E068942C8B63C088427AE09CA24C408AFA6894358B63C030B6D035D6A24C4001C76894338B63C02F4FD03532A34C40C827BEE93C8B63C0D793D0358AA34C405AE968946F8B63C0F019CF3546A04C40321FBEE9498C63C0D893D035CA9E4C406E05BEE9508E63C02FD5CE356E9D4C406E05BEE9508E63C010E8CF358E9C4C40321FBEE9C98D63C0B3C5CF35829C4C4000C76894238D63C074557BE0FC9B4C408BFA6894958C63C064A3CF35F69A4C402ED86894598C63C054877AE074994C406B05BEE9308C63C0EC93D035CA984C4089FA6894758B63C0D7B2CE3562984C40C827BEE93C8B63C0730AD0351A984C40F2F16894128B63C0AFC5CF35C2964C40B70B69942B8B63C0F816268B2F964C40AD7DBEE95A8B63C010E8CF35CE954C40816CBEE9748B63C038B6D03516954C40A2A46894078C63C044B6D03556924C40D3B56894BD8E63C05F7479E014904C406ABE6894A08F63C0403CCF35928E4C40515BBEE90E8F63C07871D035FE8C4C40040EBEE9838E63C0503CCF35128B4C406D05BEE9108F63C0DFB2CE35228A4C40AE7DBEE96A8F63C0C4C5CF35028B4C408E41BEE9A58F63C04BD2258B578C4C4020036994D88F63C08B71D035BE8C4C406C05BEE9109063C067BF248B778B4C40AD7DBEE91A9063C048D2258B17884C4020036994489063C0B77A248B9F864C40C927BEE9BC9063C0A45ECF35DE854C40501469945E9163C01704258BCF854C406C05BEE9009263C0F880CF352A864C40A3A46894779263C0B77A248B9F864C406D05BEE9E09263C014E8CF354E874C40040EBEE9039463C0985ECF351E8A4C409A16BEE9369463C03F3CCF3552894C40040EBEE9039463C09C8D258B7F874C409B16BEE9A69463C09C8D258B7F874C40A4A46894179263C0707479E094804C401975BEE9979163C00FE8CF35CE7D4C405F30BEE95F9263C07B0AD035DA7D4C4096CF6894069563C070557BE0BC7F4C40F2F16894629563C02C04258BCF7F4C40806CBEE9B49563C0F419CF3506804C40B70B6994FB9563C0C0C5CF3582804C40D5FCBDE91D9663C02CB979E02C814C40301FBEE9899663C08F8D258BFF834C40D7FCBDE9AD9663C0E819CF3546844C408C41BEE9E59663C0B47A248BDF844C404F1469942E9763C09CF7CE357A854C401875BEE9D79863C0B77A248B9F864C40C927BEE91C9963C0E393D0354A864C40040EBEE9539963C054A3CF3576854C406030BEE96F9963C00417268B6F844C406E05BEE9609963C0E419CF3586834C40AE7DBEE92A9963C02F4FD035F2824C403BAD6894DA9863C0E793D0354A824C405CE968948F9863C0BFC5CF3582814C401675BEE9679863C0C0C5CF3582804C40D6FCBDE96D9863C087F7CE35FA7E4C40C827BEE99C9863C04C3CCF35527E4C40B07DBEE9DA9863C0DCB2CE35E27D4C405F30BEE90F9963C0B7C5CF35027D4C4021036994289963C0B07A248BDF7B4C409B16BEE9369963C068557BE0BC794C40A4A46894479963C02C04258B8F784C4088FA6894859963C018E8CF354E764C409C16BEE9E69963C014E8CF350E744C40E863BEE9619A63C0780AD035DA724C40D2B56894ED9A63C050A3CF35B6734C408BFA6894759C63C0A05ECF35DE794C40EB63BEE9F19C63C08C427AE01C7B4C40D2B56894AD9D63C090F7CE353A7C4C4068BE6894609E63C04C877AE0F47C4C40F638BEE9C29E63C0B7C5CF35027D4C40F638BEE9729E63C064A3CF35B67B4C40B60B69944B9E63C00817268B2F7A4C40EA63BEE9519E63C07C71D035BE784C40AE7DBEE98A9E63C00717268BAF774C4096CF6894669E63C000CC7AE00C774C40B07DBEE93A9E63C0B8C5CF35C2754C40B80B69941B9E63C02404258B0F754C40E71C6994819E63C0A05ECF359E744C406230BEE9DF9F63C00017268B2F744C402DD86894F9A063C038D5CE35EE714C40244ABEE948A163C0533CCF3592714C40C4E068949CA163C0D048258B67704C40F2F1689482A263C0CC2CD035266B4C40545BBEE9EEA263C04C877AE0B4694C40B90B69949BA363C00BE8CF354E6A4C40525BBEE96EA563C0C0107BE0646D4C40C6E068941CA663C0C4C5CF35C26C4C405E30BEE9DFA563C00436248BC76B4C40F838BEE932A563C0E448258B676A4C40AF7DBEE9BAA463C03CB6D03556684C404F1469941EA563C0B0C5CF3542654C405BE968940FA663C09C427AE05C634C40F838BEE9E2A663C0DCB2CE35E2634C401775BEE9A7A763C02B04258B4F654C40D4FCBDE92DA963C0A45ECF359E664C40341FBEE9C9A963C0E3B2CE35E2674C40E51C6994B1AB63C070557BE0FC6C4C40B07DBEE98AAC63C08C71D0357E6E4C40D6FCBDE96DAD63C0EC19CF35066F4C407D25699434AE63C0D7B2CE35A26D4C4087FA6894B5AE63C054D2258B576C4C4021036994E8AE63C0DF19CF35866B4C40D2B56894FDAE63C07B0AD0351A6A4C40A4A46894D7AE63C018B979E06C684C40C3E068947CAE63C008CC7AE0CC674C40D6FCBDE90DAE63C0503CCF3592674C40D2B56894ADAD63C03FB6D03516674C40C4E068945CAD63C06B557BE0FC654C40826CBEE914AD63C0D893D0358A644C405BE96894EFAC63C0E793D0350A634C4068BE689400AD63C0BFC5CF35C2614C406E05BEE930AD63C02CB979E06C624C40C6E068946CAD63C05CA3CF35F6624C40AF7DBEE9AAAD63C073557BE03C634C40F838BEE9E2AD63C088427AE01C634C409A16BEE906AE63C0D748258BA7624C40A4A4689437AE63C0AF7A248BDF614C402CD8689459AE63C0B8107BE024614C4069BE689450AE63C0D0B2CE35E2604C40C5E06894CCAE63C04FD2258BD7604C403BAD68944AB063C0BFC5CF35C2614C408BFA689405B163C0D893D0354A604C40BD52BEE9ABB163C08471D0357E5D4C402ED8689459B263C098F7CE35BA5B4C40244ABEE928B363C0C3107BE0645D4C406C05BEE960B363C0F816268B6F5C4C40B80B69940BB363C06B0AD035DA5B4C40816CBEE9C4B263C03CD5CE352E5B4C407C25699494B263C0EC93D0354A5A4C406E05BEE980B263C0E4FD79E004594C40050EBEE943B263C0CB2CD035E6594C40331FBEE9D9B163C0948D258BBF574C40EB63BEE921B163C090F7CE35BA564C40B80B69948BAF63C0C02CD03566564C406D05BEE960AF63C050D2258BD7554C40E963BEE9D1AE63C0DFB2CE3562534C409916BEE9A6AE63C0503CCF35D2524C406C05BEE990AE63C0747479E054524C40D1B56894CDAE63C06CBF248B37514C402DD8689429AF63C010E8CF350E504C40EC63BEE971AF63C0D848258B674F4C408C41BEE965B063C0AC7A248B5F4F4C4050146994AEB263C018E8CF35CE504C403AAD68947AB363C017E8CF35CE4F4C401775BEE947B463C09CF7CE353A4E4C40826CBEE944B563C0BBC5CF35424E4C4096CF689436B663C0C82CD035664F4C40806CBEE9E4B663C0C02CD03526514C4096CF689406B863C010E8CF354E564C40B60B6994BBB863C0680AD0359A574C40BC52BEE9BBB963C000CC7AE0CC564C404E146994CEBA63C067557BE03C554C40826CBEE924BB63C028D5CE352E544C40E763BEE991BB63C07F71D0357E534C40B90B6994BBBC63C0503CCF35D2534C40AE7DBEE93ABD63C0284FD035B2534C4020036994D8BD63C0F835248B47524C408AFA6894E5BE63C0D7B2CE35624E4C405CE968946FBF63C0707479E0944D4C4069BE689410C163C0E0B2CE35A24C4C40D7FCBDE93DC163C00881CF356A4C4C40C5E068946CC163C0CC2CD035E64B4C4068BE689490C163C070BF248B374B4C404F1469949EC163C0E819CF35864A4C4002C76894C3C163C018E8CF350E4A4C40BA0B6994BBC263C038B6D035164A4C40D4FCBDE95DC363C07871D0353E494C40CA27BEE9CCC363C008CC7AE00C484C4089FA689415C463C044B6D03556464C40F738BEE942C463C0E4B2CE35E2434C4098CF689466C263C0E348258BE7444C408F41BEE9D5BE63C03F877AE0F4484C40264ABEE938BC63C0E893D0350A494C4050146994CEBB63C040B6D035D6484C40B60B69947BBB63C040B6D03556484C40F4F1689432BB63C098427AE01C474C40FEC6689423BB63C00417268BEF454C40C827BEE91CBB63C0B8C5CF35C2444C40CA27BEE9ECBA63C08471D0357E434C401775BEE9C7BA63C090427AE01C424C4030D86894F9BA63C00717268BEF404C40321FBEE999BB63C00481CF352A3F4C40E71C699411BC63C064A3CF35363D4C40B07DBEE94ABC63C0204FD035F23C4C40B07DBEE9CABC63C0B0107BE0E43C4C40BB52BEE99BBE63C0F019CF35C63D4C40C827BEE92CC263C0F419CF3586414C40AE7DBEE90AC463C0D0B2CE3522424C407E256994E4C463C01F4FD035B2414C401975BEE947C563C0284FD035F2404C405EE968945FC563C0740AD0359A3F4C40040EBEE913C563C0985ECF359E3E4C402003699438C463C0B8C5CF35823F4C40AE7DBEE90AC463C0DF93D0354A3E4C40C927BEE96CC463C03CB6D035963B4C40F3F1689452C563C07771D035BE3A4C40301FBEE919C763C0C82CD035263B4C40A4A46894F7C763C02B04258B8F3A4C40525BBEE95EC863C0B87A248B9F3A4C40F2F16894C2C863C0B77A248B9F3B4C4098CF689406C963C0D848258B273C4C40D6FCBDE92DCA63C0B0107BE0E43C4C4098CF6894D6CA63C06F0AD035DA3C4C40C6E068945CCB63C014E8CF354E3C4C40D2B568944DCD63C0CC2CD03526394C40AE7DBEE9CACD63C0403CCF3512384C40C927BEE92CCE63C0E893D035CA364C40E863BEE991CE63C00436248B07354C408E41BEE915CF63C070557BE03C334C408BFA689445D063C03CD5CE356E304C406C05BEE9C0D063C040B6D035D62E4C4088FA689495D063C01BB979E02C2E4C40E61C699451D063C05CA3CF35362C4C4068BE689450D163C038B6D035D62B4C40826CBEE974D263C0EC19CF35462A4C40FFC6689483D363C030D5CE352E284C405F30BEE93FD463C024B979E02C264C405CE96894AFD463C0B8107BE0A4224C401875BEE9D7D363C0D893D035CA204C406C05BEE930D163C090F7CE35FA1F4C40BC52BEE96BD163C08C8D258B3F214C4097CF6894B6D163C058A3CF3536224C408E41BEE9F5D163C0BFC5CF3542234C406C05BEE910D263C0FF35248BC7244C405CE96894EFD163C02004258B4F264C406ABE6894A0D163C0274FD03572274C40F2F1689422CF63C0A87A248BDF2B4C40A3A4689457CE63C033B6D035962B4C40EA63BEE921CE63C01CB979E0EC274C4020036994D8CD63C0C0107BE0A4284C40525BBEE98ECD63C0E493D0350A294C40A2A4689447CD63C050D2258B17294C408BFA689405CD63C008CC7AE0CC284C4068BE689420CD63C01804258B0F284C40F3F1689442CD63C024B979E02C264C40D3B56894EDCB63C008CC7AE0CC284C40D5FCBDE90DCB63C02CB979E0AC294C405F30BEE9BFCA63C0C72CD03566294C405DE968944FCA63C040877AE034284C40F2F1689412CA63C01CB979E0EC274C40A4A4689447C863C0F8CB7AE00C274C408E41BEE945C763C038D5CE35EE254C40321FBEE9A9C663C050D2258B57244C403CAD68943AC763C0E048258B67224C40D1B56894EDC763C088F7CE35BA204C4096CF6894B6C863C010E8CF358E1F4C40321FBEE9E9C963C0747479E0D41E4C40B07DBEE9BACA63C0CFB2CE35A21D4C40311FBEE929CB63C06B0AD0355A1D4C4097CF689496CB63C0F019CF35861D4C40525BBEE95ECC63C04C877AE0341E4C40F2F16894D2CC63C097F7CE353A1E4C40E863BEE9A1CC63C03F877AE0341D4C40545BBEE9BECC63C0BCC5CF35421C4C40E41C699401CD63C054A3CF35361B4C40F3F1689442CD63C09B427AE0DC194C40BA52BEE9CBCC63C06C7479E0541A4C40C827BEE94CCC63C0E019CF35461B4C4068BE6894D0CB63C03CB6D035D61B4C40EA63BEE971CA63C0D42CD035A6194C409C16BEE956CA63C0F019CF35C6184C40D5FCBDE90DCB63C068557BE03C174C405CE968942FCA63C090427AE05C164C402203699438C963C094F7CE35BA174C40050EBEE943C863C05FA3CF35B6194C401875BEE997C663C0B77A248BDF1B4C402CD86894A9C563C02004258B0F1E4C409B16BEE9B6C463C060A3CF35761F4C40F638BEE9D2C363C097F7CE353A1E4C40E863BEE9D1C463C0E4B2CE35621D4C40826CBEE924C563C0F880CF35EA1C4C40525BBEE95EC563C00081CF352A1C4C40E71C699491C563C0C0107BE0241B4C40C3E06894CCC563C08071D0353E1A4C402203699458C663C0988D258B7F194C40BC52BEE9DBC663C010E8CF35CE174C40301FBEE919C763C068557BE03C174C405BE968947FC763C08C427AE01C174C40BC52BEE9DBC763C0700AD0355A174C40AF7DBEE93AC863C0637479E054174C4098CF6894A6C863C090427AE05C164C402CD8689469C863C08071D0357E154C40806CBEE944C963C00717268BAF144C40501469945ECA63C0A45ECF355E144C40050EBEE943CB63C0D893D0354A134C40F638BEE982CB63C08C71D0353E104C40C5E068943CCC63C0C82CD03566114C402003699468CC63C0B0C5CF3582134C4098CF689466CC63C07871D035BE154C408AFA689495CC63C068557BE03C174C40BC52BEE91BCD63C0B8107BE024174C409B16BEE976CD63C00436248B47154C40B60B69948BCD63C048D2258BD7124C40F3F1689442CD63C0E493D0350A114C40535BBEE9DECD63C0F816268BEF104C40EA63BEE921CE63C0E493D0350A114C4000C76894B3CD63C0C4C5CF35820E4C40E61C699431CD63C0C4107BE0240C4C40AE7DBEE90ACD63C0E893D0350A0A4C40E963BEE9B1CD63C0F7CB7AE04C084C408AFA689425CE63C0D0B2CE35E20A4C4002C7689443CE63C0E448258B270C4C40EA63BEE921CE63C0B47A248B9F0D4C402DD8689489CE63C0988D258BFF0D4C40D0B56894FDCF63C0B47A248B9F0D4C403CAD68941AD063C0B8C5CF35020D4C4097CF6894C6CF63C088427AE09C0B4C409C16BEE906CF63C018B979E02C094C408AFA689495CF63C0D8B2CE35A2074C40E863BEE981CF63C08371D0357E054C407D25699404CF63C0700AD0351A044C402103699488CE63C04C877AE034054C40525BBEE99ECE63C0403CCF3592054C40D4FCBDE9ADCE63C0948D258BFF054C40301FBEE9C9CE63C010E8CF358E064C40020EBEE9E3CD63C08371D0357E054C40A2A4689487CD63C0503CCF3512034C404E146994AECD63C030B6D035D6004C40806CBEE954CE63C07C0AD0355A004C40311FBEE9B9CE63C0F035248B47014C40321FBEE979CF63C0B4107BE024044C40E41C6994E1CF63C017E8CF35CE044C403CAD68945AD063C0687479E054044C40F738BEE962D063C00817268BEF024C403AAD68942AD063C030D5CE352E014C40E41C6994E1CF63C02804258B8FFF4B409A16BEE966D063C078557BE07CFF4B4000C7689413D163C0543CCF3592004C4069BE6894C0D163C0B0C5CF3542024C40244ABEE948D263C028D5CE35EE034C40E61C699451D063C010E8CF358E064C40E61C699451D063C02FD5CE356E074C402003699428D263C00036248B07064C40D1B56894BDD263C04C877AE034054C40AE7DBEE93AD363C02BB979E02C054C402DD8689459D363C02C4FD035B2064C40C4E068941CD363C053A3CF3576084C408C41BEE985D263C018B979E02C094C408C41BEE985D263C008CC7AE00C0A4C40F838BEE942D363C0670AD0351A0B4C406030BEE93FD363C0BB7A248BDF0C4C40C5E06894BCD263C0F8CB7AE08C0E4C40806CBEE9F4D163C0EC93D0354A0F4C403CAD6894EAD163C0D8B2CE35E20F4C40040EBEE993D163C05CA3CF35B6124C40254ABEE968D163C00881CF35AA134C4096CF689446D163C0F7CB7AE0CC134C408E41BEE9E5D063C02004258B8F134C40C827BEE99CD063C0B8C5CF35C2134C40244ABEE978D063C0AB5ECF359E134C40C4E068945CD063C09C427AE09C134C40E61C699451D063C0BC107BE024144C4001C7689453D063C00436248B47154C40E61C699451D063C08071D0357E154C408C41BEE9A5CF63C0A75ECF359E164C40F638BEE952CF63C0FC35248B87174C408E41BEE955CF63C0B8C5CF3582184C40F638BEE9B2CF63C0543CCF3512194C40BA52BEE91BD263C05BA3CF35F6184C401875BEE977D463C09B427AE0DC194C408C41BEE915D463C0E093D035CA174C40F638BEE972D363C02404258BCF164C406C05BEE910D263C08071D0357E154C40AF7DBEE9EAD263C00FE8CF358E134C407C25699494D363C008CC7AE04C114C404E1469944ED463C0A85ECF355E0F4C40C927BEE95CD563C00881CF356A0E4C403CAD68942AD563C0FB35248BC7104C40EA63BEE961D563C038D5CE35AE124C40D5FCBDE9DDD563C00FE8CF358E134C402DD8689479D663C0985ECF35DE124C40040EBEE923D663C074BF248B77114C40AF7DBEE90AD663C0707479E014104C40321FBEE929D663C0E019CF35C60E4C402DD8689479D663C0B47A248B9F0D4C40E71C699471D563C0C4107BE0A40C4C40040EBEE923D563C0403CCF35D20B4C40C927BEE95CD563C008CC7AE00C0A4C40F2F1689452D563C0D02CD035E6074C404E1469946ED763C02704258BCF054C407C256994E4D663C028D5CE35EE034C40321FBEE949D663C02CB979E0AC034C40E963BEE9A1D563C0C82CD035E6034C40545BBEE90ED563C040877AE0B4034C40806CBEE9B4D463C030D5CE352E024C40806CBEE9B4D463C08871D035FEFF4B403BAD68940AD563C03F3CCF35D2FE4B407C25699404D663C068557BE0BCFD4B407C25699404D663C0204FD035F2FC4B40A5A46894D7D563C0F319CF35C6FC4B4030D8689489D563C0E4FD79E044FC4B40C927BEE95CD563C04C3CCF3512FC4B403AAD6894DAD563C028B979E0ACFA4B40264ABEE9C8D663C0AC5ECF351EFA4B408E41BEE9C5D763C0D893D0354AFA4B406C05BEE970D863C0A85ECF351EFB4B407C25699434D863C044B6D035D6FB4B40545BBEE9EED763C0D4B2CE3562FC4B4002C76894A3D763C0C3C5CF35C2FC4B40040EBEE953D763C0204FD035F2FC4B40040EBEE953D763C068557BE0BCFD4B409A16BEE9A6D763C007CC7AE00CFF4B40B70B6994DBD763C0F816268B2F004C408AFA689435D863C0B8C5CF3502014C40321FBEE9F9D863C01BE8CF354E014C405CE968941FD963C0DC48258BE7004C408F41BEE965D963C048D2258B17FF4B40EC63BEE9A1D963C0F716268BAFFE4B40A4A4689417DA63C00C81CF35EAFE4B409C16BEE956DA63C0E893D0358AFF4B40525BBEE9BEDA63C08071D035BE014C4069BE689480DB63C0E048258BA7014C40C6E068946CDC63C03BD5CE35EEFD4B407C256994B4DD63C0A85ECF35DEF54B40A5A46894E7DD63C0A85ECF35DEF54B40A4A4689427DE63C09C8D258B3FF74B40D6FCBDE99DDE63C03CB6D035D6F74B40331FBEE929DF63C0AC7A248BDFF74B4000C7689433E063C0DCFD79E044F74B40FFC6689473E063C028D5CE35EEF64B40321FBEE9A9E063C0770AD0355AF64B40F2F16894C2E063C0A85ECF355EF54B40826CBEE9A4E063C008E8CF358EF44B40806CBEE974E063C0543CCF3512F44B4000C7689453E063C0985ECF351EF44B402CD8689459E063C00881CF356AF34B40040EBEE953E063C04FD2258BD7F24B40E963BEE971E063C02C4FD03572F24B40EA63BEE9E1E063C0E093D0354AF24B40F1F1689422E163C06BBF248B77F24B40AE7DBEE94AE163C0D048258BE7F24B40545BBEE96EE163C0978D258B7FF34B402FD8689449E263C030B6D035D6F54B404D146994AEE263C00336248B87F64B40D2B568942DE363C0483CCF35D2F64B40F638BEE9A2E363C003CC7AE08CF64B40050EBEE9A3E463C0780AD0355AF54B407C25699424E563C0503CCF3512F54B407C25699484E563C0C0107BE0A4F44B40BC52BEE9FBE563C090F7CE35BAF24B40040EBEE973E663C0E093D0354AF24B40244ABEE988E863C0443CCF35D2F14B4039AD68946AE963C017E8CF358EF04B40F4F1689432EA63C0B0C5CF3502EE4B4096CF6894A6EA63C013E8CF354EF04B4000C7689463EB63C0473CCF3592F04B405E30BEE92FEC63C0EC93D0358AEF4B40EA63BEE9D1EC63C0B0C5CF3502EE4B40A5A4689427ED63C048D2258BD7EB4B40F3F1689452ED63C024B979E0ACE64B404E1469947EED63C028D5CE352EE54B40C827BEE90CEE63C0DCFD79E004E54B40020EBEE993EE63C0533CCF3592E64B405CE96894FFEE63C0908D258BBFE84B40254ABEE938EF63C027D5CE356EEA4B40F2F1689452EF63C0E793D0354AEC4B40F2F1689452EF63C0EC93D0358AEE4B40254ABEE938EF63C00017268BEFF04B4097CF689406EF63C08471D0353EF34B402ED86894A9EF63C06FBF248B37F34B40806CBEE994F063C0948D258BBFF24B4068BE689470F163C0B07A248BDFF14B40F4F16894E2F163C0B77A248B9FF04B40806CBEE9C4F163C008E8CF35CEEE4B40545BBEE9CEF063C0707479E014EB4B40F838BEE992F063C0244FD03532E94B402ED8689489F063C030B6D035D6E74B405F30BEE95FF063C02804258B8FE54B408C41BEE955F063C094F7CE353AE44B40C5E068944CF063C0A85ECF359EE34B4096CF689426F063C058A3CF35B6E24B40D7FCBDE91DF063C00881CF352AE24B406030BEE92FF063C0C4107BE064E14B402003699458F063C0E419CF3506E14B406D05BEE980F063C0E819CF35C6E04B40F838BEE992F063C0DFB2CE3562E04B4096CF6894F6F063C0204FD035B2DE4B40535BBEE9AEF163C030B6D03556DC4B405F30BEE90FF263C0D42CD03526DA4B40D3B568946DF163C0204FD035F2D84B40806CBEE984F163C0FC35248B87D74B40244ABEE988F163C0C4C5CF3542D64B40826CBEE994F163C0AC5ECF351ED54B40030EBEE9C3F163C07B0AD0351AD44B406030BEE9DFF163C00C17268BAFD34B40C927BEE9FCF163C040B6D03516D34B408AFA689415F263C0BCC5CF35C2D24B4096CF689436F263C0F019CF3586D24B406E05BEE990F263C0204FD03532D24B40C827BEE9BCF263C0E3B2CE35E2D14B40826CBEE944F363C030B6D03556D04B408F41BEE9D5F363C08FF7CE353ACE4B40501469942EF463C098F7CE35FACB4B40C4E068940CF463C0D0FD79E004CA4B40F838BEE912F763C030B6D03596C84B401F036994C8F763C068BF248B37C94B40D6FCBDE95DF763C068557BE03CCA4B405F30BEE9AFF663C0BBC5CF3582CC4B406C05BEE940F663C0B8C5CF3582CD4B407E25699444F763C01F04258B4FCD4B402203699438F863C0E4B2CE35A2CC4B40BA52BEE9BBF763C0988D258B7FCE4B40F638BEE9C2F663C0E019CF3546CF4B406C05BEE9C0F563C00817268BEFCE4B402ED8689429F563C0B8C5CF3582CD4B40E61C699481F463C05BA3CF3576CE4B40D3B568948DF463C0CB2CD03566CF4B408E41BEE975F463C054A3CF3536D04B406E05BEE940F463C0EC93D035CAD04B40F738BEE9F2F363C0C4C5CF3502D14B404E146994BEF363C018E8CF354ED14B40D6FCBDE9FDF363C053877AE0F4D14B403BAD68940AF563C08471D0357ED34B405DE968942FF663C0E419CF3586D44B408C41BEE9B5F663C050877AE074D54B40535BBEE91EF663C00081CF35EAD64B407D25699444F463C08471D035BED94B40D3B56894CDF463C0E719CF3506DB4B404F1469940EF563C0274FD035F2DB4B40040EBEE943F563C040B6D03516DE4B40C827BEE97CF563C08C71D0353EDE4B409A16BEE9B6F563C0EC19CF3546DE4B406E05BEE9D0F563C0443CCF3512DF4B40EA63BEE9B1F563C0B8C5CF3542E04B40F638BEE9D2F463C064A3CF35B6E44B40311FBEE909F463C098F7CE35FAE64B40EA63BEE901F463C0E819CF3506E84B40E61C699481F463C0D4B2CE35A2E94B4097CF689406F563C0E493D0358AEA4B4088FA689475F663C0BFC5CF3502EC4B40F3F1689492FA63C0BF2CD03526ED4B4069BE689410FB63C050877AE0F4EC4B402ED8689459FB63C098F7CE35BAEB4B402FD8689489FB63C0B0C5CF35C2E84B40535BBEE94EFB63C0C02CD035E6E64B404E1469943EFB63C094F7CE35BAE54B40B07DBEE96AFB63C028D5CE352EE54B40F4F16894F2FC63C094F7CE353AE44B40311FBEE989FD63C017E8CF350EE54B40E61C699491FE63C0DB48258B67E84B4068BE689440FF63C0B0C5CF35C2E84B4068BE689440FF63C00FE8CF35CEE74B40E41C699401FF63C0D4FD79E044E74B40F1F16894F2FE63C0985ECF359EE64B4000C7689403FF63C064A3CF35B6E44B40040EBEE923FF63C0D0FD79E084E34B4069BE689470FF63C09CF7CE357AE34B40501469944E0064C04CD2258B97E44B40E41C6994910064C06F0AD0355AE54B40AD7DBEE9DA0064C0B7C5CF3502E64B401675BEE9370164C02704258B0FE64B4088FA6894650164C098F7CE357AE54B40B07DBEE9AA0164C094427AE05CE34B405CE96894DF0164C02C04258B8FE24B40CA27BEE9FC0064C0D02CD03526DE4B40F738BEE9120164C048877AE0F4DC4B40A4A46894170264C0F419CF3586DC4B406D05BEE9D00264C070557BE03CDD4B401875BEE9170364C00017268B2FDD4B407C256994340364C0F8CB7AE00CDC4B405CE968940F0364C00881CF356ADB4B40A4A46894170264C08471D035BED94B40331FBEE9190364C02F4FD035B2D94B40B80B69948B0364C038B6D03516DA4B4089FA6894F50364C0E0B2CE3522DB4B40C827BEE92C0464C060A3CF3536DC4B40030EBEE9530464C00017268B2FDD4B40C4E068948C0464C018B979E0ECDD4B40254ABEE9F80464C0EC19CF3546DE4B40BC52BEE9CB0464C0EC93D0354ADC4B407E256994940464C0F880CF352AD84B409C16BEE9460464C0707479E054D64B406030BEE93F0564C09C427AE01CD44B4000C76894A30764C030B6D03516D54B40AE7DBEE93A0864C05CA3CF35B6D34B40AE7DBEE93A0864C0BCC5CF35C2D24B40F638BEE9320B64C0BCC5CF35C2D24B40D4FCBDE9AD0C64C040B6D03596D34B40BC52BEE96B0D64C02C4FD035B2D34B408C41BEE9250E64C0BCC5CF35C2D24B40D2B568949D0D64C08C71D0353ED14B402CD86894B90B64C05BA3CF3576CE4B402CD86894B90B64C0B8C5CF3582CD4B40EA63BEE9810C64C094F7CE35BACC4B40C827BEE9EC0D64C044B6D035D6C94B40AE7DBEE99A0E64C0D0FD79E004CA4B40F638BEE9920E64C07B0AD0351AC84B408AFA6894850E64C048D2258B57C74B40D4FCBDE95D0E64C0F816268B6FC64B40040EBEE9A30E64C0888D258B7FC54B40B07DBEE9DA0E64C0908D258BBFC34B4050146994FE0E64C037D5CE35EEC14B403AAD68940A0F64C000CC7AE0CCC04B401575BEE9470F64C02404258B4FBF4B4020036994D80F64C088F7CE353ABE4B40E963BEE9011164C0E048258BE7BC4B40D2B568948D1164C0780AD0359ABE4B401675BEE9A71264C050A3CF3536C54B40C6E06894FC1264C04C877AE034C84B40D0B568940D1364C0E048258B67CB4B403CAD68942A1364C0747479E094CD4B40E61C6994A11364C0B8C5CF3582CD4B401675BEE9171464C0B87A248B9FCB4B40F4F16894821464C08071D035FEC84B402ED86894091564C0CF48258BA7C64B4020036994D81564C0C42CD035A6C54B40C4E06894BC1764C098F7CE353AC64B407C256994941864C02804258BCFC54B40816CBEE9741864C0CB2CD035E6C34B408D41BEE9B51764C00417268B2FC34B40C6E068949C1664C070BF248B37C34B40C827BEE99C1564C01CE8CF35CEC24B40D6FCBDE92D1564C000CC7AE0CCC04B40C827BEE95C1564C00881CF352ABD4B404E146994DE1564C090F7CE357ABB4B40AE7DBEE90A1964C098F7CE353AB94B40E41C6994911964C0687479E054B94B4098CF6894E61964C038B6D035D6B94B406030BEE99F1A64C0403CCF3592BB4B403CAD6894FA1A64C050877AE0F4BB4B40A2A46894271B64C00BCC7AE08CBC4B40EA63BEE9111B64C0D4B2CE35E2BD4B408CFA6894C51A64C02CB979E0ECBF4B40D5FCBDE99D1A64C077557BE07CC14B408BFA6894E51A64C0BB7A248B5FC24B406C05BEE9C01B64C0F419CF3506C34B408E41BEE9951D64C0284FD03572C24B4000C76894B31E64C0B87A248B1FBF4B403AAD68949A1F64C00881CF35AABA4B40C4E06894CC2064C05FA3CF35B6B64B404E1469944E2264C0E0FD79E044B44B40545BBEE9EE2864C018B979E06CAD4B40BC52BEE9FB2964C0BCC5CF3542AD4B4002C76894732A64C0985ECF355EAE4B40C727BEE9DC2A64C01CE8CF350EB14B40C5E06894CC2B64C044B6D03556B14B40806CBEE9542F64C05BA3CF3536AE4B4096CF6894363064C0403CCF3592AE4B409A16BEE9963064C04C3CCF3512B14B405CE968947F3064C0E493D035CAB14B40D2B568949D2F64C0B0C5CF35C2B64B40311FBEE9892F64C0A05ECF351EB84B40BC52BEE96B2F64C070557BE07CBD4B408F41BEE9552F64C04C3CCF3512BE4B40321FBEE9892E64C0B0107BE0E4C14B40CA27BEE92C2E64C0EF35248B47C34B40A4A46894672D64C0F880CF35EAC44B4068BE6894702C64C078557BE03CC94B40F638BEE9C22B64C0D0FD79E004CA4B40BA52BEE92B2B64C0EC93D0350AC94B40E963BEE9212A64C0FF35248B87C54B402ED86894592964C0EC19CF35C6C44B401875BEE9D72564C0F419CF3506C34B40BC52BEE9DB2464C0EF35248B47C34B40F838BEE9A22464C088F7CE357AC44B4020036994182564C02804258BCFC54B40D6FCBDE9ED2764C0C3107BE064C74B40BC52BEE95B2864C0D42CD035E6C74B405CE96894AF2864C0A85ECF351EC94B40BB52BEE9FB2864C04B3CCF3592CA4B409B16BEE9562964C0E0FD79E0C4CB4B40D5FCBDE91D2A64C0700AD035DACC4B40D1B56894AD2B64C0737479E014CE4B405F30BEE90F2D64C0C82CD03566D14B403AAD68940A2E64C0BCC5CF35C2D14B40D0B56894DD3364C05BA3CF3576CE4B4068BE6894A03364C0EF19CF35C6CC4B4068BE6894C03364C09C8D258BFFCB4B403AAD68940A3464C02804258B8FCB4B40D2B568944D3464C0BF107BE0E4CA4B404F146994DE3464C0747479E0D4C74B40AF7DBEE9AA3664C068BF248B77C34B40CA27BEE9EC3664C024B979E0ACC14B40FEC66894D33664C0BFC5CF3542C04B40B90B69949B3664C0C82CD035A6BF4B4000C76894633664C0C32CD03566BF4B40301FBEE9493664C008CC7AE00CBF4B405CE968944F3664C0F319CF35C6BD4B40FEC66894B33664C0730AD0359AB74B40311FBEE9B93664C02C04258B4FB64B40FEC66894B33664C088427AE01CB44B4068BE6894C03664C02CB979E06CB34B40CA27BEE9EC3664C040B6D03556B24B408BFA6894253A64C00BE8CF358EA84B40264ABEE9A83A64C03CB6D03596A54B406D05BEE9F03A64C04C3CCF3512A54B406130BEE99F3C64C00436248B079F4B40AE7DBEE9BA3C64C0D8B2CE35E29D4B4087FA6894C53C64C08071D035BE9C4B4068BE6894E03C64C0DCB2CE35E29B4B404E1469942E3D64C0E893D0358A9B4B40321FBEE9E93D64C0AC5ECF355E9B4B40BC52BEE93B3E64C048D2258B979B4B40C4E068949C3E64C0D048258B679C4B4020036994583E64C00FE8CF354E9C4B40806CBEE9843D64C0D048258B679C4B40806CBEE9843D64C098427AE05C9D4B406030BEE96F3E64C097427AE05C9E4B40F2F16894823F64C0DF19CF35C69E4B4001C76894934064C0204FD035B29E4B40244ABEE9784164C0DF48258B279E4B40244ABEE9784164C098427AE05C9D4B401875BEE9A74064C0344FD035B2994B4067BE6894804064C0A75ECF359E974B40264ABEE9084164C0D893D0354A964B40E61C6994813F64C090427AE01C944B40244ABEE9683F64C0A85ECF35DE924B40D0B568942D3F64C0234FD035B2914B40EA63BEE9E13E64C06FBF248BB7904B40C4E068949C3E64C048D2258B17904B406E05BEE9203F64C0888D258BBF8D4B403BAD68940A4064C030D5CE35EE8B4B40D6FCBDE90D4164C00781CF35AA8A4B4002C76894E34164C01F04258B0F8A4B4096CF6894964264C0543CCF35528A4B40F4F16894624364C0244FD035728B4B4020036994184464C028D5CE352E8D4B401675BEE9874464C0FFCB7AE04C8F4B4022036994E84364C0988D258BFF8F4B401875BEE9A74364C048D2258B17904B40806CBEE9E44364C0F8CB7AE00C914B40BC52BEE99B4364C0740AD0351A924B40A4A46894674364C040B6D03516934B40A4A46894474364C02CB979E02C944B40D1B568943D4364C08471D0357E954B40B07DBEE92A4664C0908D258B3F924B40030EBEE9634764C03CD5CE356E8E4B40D4FCBDE9BD4664C00CCC7AE08C8B4B40A5A46894574664C000CC7AE00C884B40A5A46894774664C0740AD0351A854B40030EBEE9634764C0AC5ECF35DE834B405F30BEE9DF4764C05BA3CF3576834B4097CF6894564864C0F019CF35C6824B40B07DBEE9CA4864C0B8C5CF3582824B40E963BEE9414964C038D5CE356E834B40321FBEE9894964C054D2258B97844B408F41BEE9054A64C0344FD03572874B40B07DBEE93A4A64C07B0AD0351A894B402ED86894894A64C050877AE074884B40C5E06894CC4A64C0E4B2CE3562874B40BB52BEE93B4B64C0E0B2CE3522854B40321FBEE9994B64C030D5CE35AE844B409A16BEE9864D64C0E048258BA7844B406E05BEE9604E64C0E048258B27854B40C6E068941C4F64C0DCFD79E044864B4000C76894C34F64C0F780CF35EA874B404F1469945E5064C01F04258B0F8A4B40234ABEE9D85064C03CB6D035168D4B404E1469948E5064C034D5CE35AE8E4B40B80B6994CB4F64C0E893D0350A8F4B40B952BEE9DB4E64C03CD5CE356E8E4B40050EBEE9534D64C0FC35248B878C4B406030BEE97F4C64C090427AE05C8C4B40AE7DBEE98A4B64C098F7CE357A8D4B40AF7DBEE95A4D64C0D8FD79E084904B409C16BEE9F64D64C02CD5CE35EE914B40BE52BEE95B4F64C070BF248B77964B4096CF6894B64F64C0A75ECF351E984B40D3B56894FD5064C04BD2258BD79F4B408F41BEE9D55164C037D5CE352EA24B403BAD68943A5364C09C427AE09CA24B40B07DBEE94A5264C0304FD035F2A34B401F036994285264C0E048258B67A54B403BAD6894AA5264C0E893D0358AA64B4039AD6894AA5364C0C02CD035E6A64B4096CF6894A65464C0D448258B67A64B40F2F16894625564C004CC7AE04CA54B40525BBEE9FE5564C04C3CCF3592A34B40D0B568949D5664C06CBF248B37A14B406030BEE9FF5664C0740AD0359A9E4B40C4E06894FC5664C0B0107BE0E49B4B40EA63BEE9915664C0F019CF35C6994B407C256994145564C094427AE05C984B406ABE6894405464C0908D258BFF964B409A16BEE9A65364C0E893D0354A954B4039AD6894AA5364C02CB979E0AC934B40D6FCBDE94D5364C0B87A248B5F924B40F638BEE9325364C0F8CB7AE08C914B4000C76894535364C0D8B2CE35E2904B4039AD6894AA5364C048D2258B17904B40C6E06894AC5364C0F835248B87904B407D256994D45364C020B979E02C914B40C6E068940C5464C0A45ECF359E914B40B07DBEE93A5464C07C71D0357E914B407C256994545464C0E019CF35C6904B4088FA6894555464C0D8FD79E004904B406030BEE94F5464C074557BE03C8F4B40A4A46894575464C03CD5CE356E8E4B40264ABEE9885464C0BB107BE0A48B4B40E41C6994915464C07B0AD0351A894B40E963BEE9515464C0B0107BE024884B4039AD6894AA5364C01F04258B0F8A4B4098CF6894965364C064A3CF35F6874B40B07DBEE9EA5164C0E493D0350A7B4B409A16BEE9B65264C0B07A248B9F7B4B40301FBEE9B95364C023B979E06C7D4B401875BEE9A75464C004CC7AE0CC7F4B409A16BEE9365564C0975ECF351E824B409B16BEE9165464C0483CCF3592814B404E146994CE5364C0B8C5CF3502824B40F3F16894E25364C0AC5ECF35DE834B40EA63BEE9415464C06C7479E0D4854B4020036994C85464C0FB35248BC7864B402ED86894595564C094F7CE357A864B409C16BEE9A65564C0E048258BA7844B405BE96894EF5564C050877AE034824B40321FBEE9495664C00C81CF356A804B402ED86894295764C0985ECF35DE7C4B40C827BEE9FC5664C00481CF35EA7B4B404E146994EE5664C02704258B4F7B4B406130BEE90F5764C0E493D0350A7B4B4000C76894335764C0B7107BE0E47A4B4097CF6894165864C0284FD035F2784B40545BBEE98E5864C0D0FD79E044784B40D6FCBDE90D5964C00CCC7AE0CC774B4096CF6894365B64C00417268BAF774B4089FA6894155C64C00417268B2F784B40A4A46894775D64C004CC7AE08C7A4B40C927BEE9AC5D64C008CC7AE04C7B4B40E61C6994C15D64C0D42CD035667C4B40BD52BEE9EB5D64C00FE8CF350E7D4B40826CBEE9F45E64C0D0FD79E0047F4B40D7FCBDE92D5F64C074BF248B37814B40CA27BEE97C5E64C000CC7AE0CC814B408AFA6894A55D64C08F427AE0DC814B40D1B568946D5D64C008CC7AE08C824B40B70B6994FB5D64C08F8D258BBF834B40BD52BEE95B5F64C0284FD035F2844B406D05BEE9F05F64C068557BE07C864B4089FA6894C56064C0E0B2CE35E28A4B406C05BEE9506164C074BF248BB78C4B4098CF6894066264C098F7CE357A8D4B4098CF6894666264C0C82CD035A68D4B409816BEE9166364C090427AE05C8E4B407D256994746364C03CD5CE356E8E4B401675BEE9E76364C02804258B0F8E4B40525BBEE9BE6464C03CD5CE35EE8C4B40264ABEE9386564C028D5CE35AE8C4B40B07DBEE9CA6464C0AC7A248B9F8D4B40EA63BEE9E16364C047D2258B178F4B407D256994746364C048D2258B17904B40E61C6994216464C0707479E014914B409C16BEE9066564C08071D035BE914B40B90B6994DB6564C02C04258BCF914B408D41BEE9556664C0F8CB7AE00C914B401775BEE9676664C0DC93D0358A8F4B40BB52BEE94B6664C0D0B2CE35E28D4B408F41BEE9256664C08B71D0357E8C4B40254ABEE9186664C007E8CF35CE8B4B40C827BEE97C6664C0F035248B078B4B40E61C6994E16664C09CF7CE357A8B4B406ABE6894A06764C098F7CE357A8D4B405AE968949F6764C02C04258B8F8B4B409A16BEE9666764C0A45ECF355E8A4B40826CBEE9046764C0A87A248BDF894B40264ABEE9886664C01F04258B0F8A4B409C16BEE9F66664C01CE8CF35CE854B40FFC66894936664C037D5CE356E824B40A5A46894976564C074BF248B37804B408E41BEE9A56364C0D0FD79E0047F4B406C05BEE9E06264C070557BE0FC7D4B409C16BEE9266264C0607479E0947C4B40806CBEE9B46164C0E493D0350A7B4B4021036994986164C008E8CF358E784B4069BE6894006264C0DCB2CE35E2764B4000C76894536464C018B979E0AC734B4039AD68947A6564C0E0B2CE35E2704B402ED86894696664C078557BE0BC6F4B401975BEE9676764C0E0B2CE35226C4B40B80B69940B6864C01BE8CF354E6B4B406C05BEE9E06864C060A3CF35B66A4B40020EBEE9436A64C018B979E02C684B40C4E06894EC6A64C04F3CCF35D2674B405F30BEE96F6B64C0D848258BA7684B40F838BEE9C26B64C0B4C5CF35426A4B40D2B568940D6C64C0E048258B276C4B40254ABEE9786C64C0FB16268BEF6D4B4068BE6894F06A64C098F7CE353A704B40A3A46894776A64C02FD5CE356E714B40F638BEE9626A64C01CE8CF350E724B40816CBEE9646A64C09C8D258B7F734B407E256994446A64C0E4B2CE3522744B401875BEE9F76964C027D5CE35AE744B408AFA6894A56964C040877AE0F4744B40525BBEE94E6964C0BCC5CF3502754B40826CBEE9F46864C03CD5CE35EE744B405CE968947F6964C073557BE0BC764B40C4E068940C6B64C0F816268BAF754B405DE968941F6B64C028B979E06C784B4021036994886A64C0B7C5CF35C27B4B405DE96894CF6964C0BCC5CF35C27A4B406C05BEE9006964C0FC80CF35EA784B40301FBEE9296864C0DCFD79E0C4794B40525BBEE9DE6764C0CF48258B277C4B4097CF6894066964C06C557BE0BC7E4B405F30BEE95F6964C028D5CE35AE814B40F2F16894926964C038B6D035D6874B40AE7DBEE9CA6964C070BF248B77894B40F4F16894326A64C030D5CE35EE8A4B40A4A46894676A64C07871D0353E8C4B401675BEE9076A64C098F7CE357A8D4B401675BEE9076A64C03CD5CE356E8E4B40E51C6994416A64C090427AE05C8E4B401975BEE9676A64C0680AD0359A8E4B402DD86894896A64C05BA3CF35F68E4B407B256994B46A64C0FFCB7AE04C8F4B407D256994C46464C00881CF352A974B4039AD6894CA6064C00817268B6F9F4B4021036994B85F64C00436248B079F4B40321FBEE9496064C0D8B2CE35629E4B40C727BEE9FC6064C0747479E0149D4B40A4A46894A76164C00B17268B6F9B4B406030BEE91F6264C0E393D035CA994B40F638BEE9726264C0B87A248B1F974B4000C76894036264C0908D258B7F964B40FFC66894C35F64C0F419CF3546974B406C05BEE9805F64C00881CF352A974B40AE7DBEE97A5F64C00417268BEF964B40F4F16894625F64C0D32CD03566964B40C927BEE93C5F64C0747479E0D4954B406E05BEE9105F64C08471D0357E954B40244ABEE9C85E64C0DBB2CE35A2954B403AAD6894AA5C64C0F419CF3546984B405DE96894FF5B64C0C82CD035A6994B40D1B56894AD5A64C098427AE05C9D4B40F4F16894325B64C0F780CF356A9F4B405F30BEE96F5C64C040B6D035969F4B40525BBEE9AE5C64C0DCB2CE3522A24B403CAD68949A5964C0D848258B27A54B404E1469946E5964C06F7479E054A64B4088FA6894955764C000CC7AE0CCA74B401875BEE9D75664C0A87A248B1FA94B401975BEE9E75464C0E819CF3546AE4B40311FBEE9895464C027B979E0ACB04B40E963BEE9515464C00481CF356AAE4B40A2A46894A75364C07771D035FEAC4B407E256994D45264C008CC7AE04CAC4B40F638BEE9225264C060BF248B37AC4B40E51C6994A15164C090427AE09CAC4B40BD52BEE94B5164C017E8CF354EAD4B40B07DBEE99A5064C068BF248BB7AF4B406C05BEE9605064C06F557BE0FCAF4B4000C76894235064C0747479E0D4AF4B4020036994E84F64C0A45ECF35DEAF4B4096CF6894B64F64C027B979E0ACB04B40D6FCBDE9AD4F64C0503CCF3552B14B405F30BEE9AF4F64C017B979E02CB24B40C5E06894BC4F64C0D448258BE7B24B40F2F16894D24F64C064A3CF3536B34B40D4FCBDE93D5064C00481CF352AB44B406C05BEE9205064C0DF19CF3546B64B40F838BEE9225064C0B87A248B5FB84B40C6E06894EC5064C0687479E054B94B40F838BEE9D25164C040877AE034B94B40F838BEE9A25264C088F7CE35FAB74B40B80B69943B5364C070557BE03CB64B40F3F16894E25364C038B6D03516B44B40311FBEE9595364C0F419CF3506B74B40331FBEE9E95264C088F7CE35FAB74B406030BEE96F5264C040B6D03516B94B402ED86894995164C06CBF248BB7BA4B40FFC66894434764C0607479E054D94B40826CBEE9C44464C0F419CF3586DC4B40311FBEE9294464C07871D035FEDD4B4096CF6894F64264C0F8CB7AE0CCE14B409A16BEE9764264C02C04258B8FE24B40D6FCBDE99D4164C0EC93D0350AE34B409916BEE9363D64C0780AD0355AEA4B404D146994BE3C64C0EB19CF35C6EB4B406E05BEE9703A64C0B77A248B9FF04B402ED86894993964C0CFB2CE35E2F14B40050EBEE9C33864C0F716268BAFF24B40C4E068940C3664C0E448258BA7F34B40EB63BEE9813464C058A3CF3576F54B406D05BEE9D03064C00C81CF35AAF74B408AFA6894A52E64C07C0AD0351AFA4B40EC63BEE9712C64C0780AD0351AFB4B407C256994142C64C030B6D03596FB4B402DD86894692B64C050A3CF35F6FC4B401F036994F82464C030D5CE352E024C401A75BEE9372764C078557BE07CFF4B405CE968943F2864C064A3CF3536FE4B404F146994BE2864C07871D0353EFD4B40F638BEE9C22B64C0543CCF3552FA4B404E1469949E2664C0543CCF3552FA4B40A4A46894772564C0607479E094F94B40030EBEE9F32464C034B6D03596F94B40311FBEE9692464C058A3CF35B6FA4B402ED86894F92364C0EC93D0350AFB4B40040EBEE9532264C08471D0357EF84B407D256994B42164C064A3CF3576F84B40F838BEE9422164C0607479E014F94B40C6E068945C2064C0A85ECF351EFB4B401875BEE9B71E64C050A3CF35F6FC4B40244ABEE9481E64C064A3CF3536FE4B408E41BEE9D51D64C0C0C5CF35C2FE4B40244ABEE9F81B64C0A87A248B1FFF4B40F2F16894E21B64C0780AD0351AFB4B4067BE6894C01B64C0403CCF3512F94B40264ABEE9881B64C0A05ECF359EF74B40C827BEE9CC1C64C0B07A248B9FF74B40A3A46894171E64C07C557BE03CF84B4098CF6894561F64C07771D035FEF74B408E41BEE9752064C067BF248B77F54B408C41BEE9C52064C0543CCF3592F34B405CE96894BF2064C0DCFD79E004F24B405DE968947F2064C0E493D035CAF04B407D256994242064C044B6D035D6EF4B40331FBEE9791F64C09CF7CE35FAEE4B4022036994E81E64C00436248B47EF4B40311FBEE9591E64C01CE8CF350EF04B4021036994B81D64C0B77A248B9FF04B4001C76894331E64C088427AE0DCEC4B409B16BEE9661E64C0AF7A248B9FEA4B40244ABEE9481E64C0D4B2CE35A2E94B40A3A46894C71D64C0244FD03532E94B40244ABEE9481D64C0D02CD03526E84B4069BE6894401A64C090427AE09CDE4B40E41C6994911964C0533CCF3592DB4B407E256994041964C0DBB2CE3522E04B407C256994941864C040D2258B17E14B40244ABEE9E81764C0C0C5CF3582DF4B40F3F16894F21664C0F419CF3586DC4B405E30BEE95F1664C0B8C5CF3502DA4B406C05BEE9101664C0607479E054D94B40D6FCBDE99D1564C08471D035BED94B405BE968949F1564C0403CCF3552DA4B408D41BEE9451564C0F880CF356ADD4B40D6FCBDE92D1564C008CC7AE0CCDD4B4069BE6894501564C07C557BE03CDF4B40020EBEE9A31564C0D0B2CE35A2DF4B40264ABEE9081664C0B8C5CF35C2DF4B40E61C6994611664C0DFB2CE3562E04B406ABE6894A01664C0B8C5CF3542E14B408D41BEE9351764C06C557BE0BCE24B409C16BEE9361864C0B77A248B9FE44B40816CBEE9741864C0B7C5CF3502E74B404E146994CE1864C0670AD0355AEC4B40321FBEE9091964C008E8CF35CEEE4B40F838BEE9721964C044B6D035D6EF4B4000C76894931964C01CE8CF350EF04B40501469948E1964C0473CCF3592F04B40030EBEE9731964C0B87A248B1FF14B407C256994541964C09C8D258B7FF14B40B07DBEE91A1964C0AC7A248B9FF14B40E61C6994E11864C06F0AD0355AF14B40816CBEE9741864C0B77A248B9FF04B40F3F16894F21664C0E0B2CE35E2EE4B40321FBEE9091664C0B47A248B5FEE4B40040EBEE9631064C0740AD0355AEF4B40D1B568941D1064C0B0C5CF3502EE4B40244ABEE9580F64C038B6D035D6EC4B402ED86894490F64C0483CCF3552EB4B40B90B69946B0F64C0DB48258B67E94B40D3B568943D0F64C0B7C5CF3502E74B40311FBEE9B90E64C050D2258BD7E54B409C16BEE9260E64C06CBF248B77E64B4089FA6894850D64C0533CCF3592E74B4097CF6894D60C64C00FE8CF35CEE74B40F2F16894A20C64C030B6D03556E74B405E30BEE95F0C64C0E093D035CAE54B404E1469942E0C64C028D5CE352EE54B406130BEE9CF0B64C054877AE0B4E44B402DD86894E90964C0C4C5CF35C2E34B404E1469943E0964C0D7B2CE3522E34B406E05BEE9900864C0730AD035DAE24B40B07DBEE9CA0764C00017268B6FE34B40C6E06894EC0864C0D448258BE7E44B4098CF6894360964C0A77A248B9FE54B40050EBEE9E30964C0A85ECF35DEE84B409A16BEE9360A64C0D4B2CE35A2E94B401675BEE9970764C018E8CF354EEB4B401775BEE9070864C0AC5ECF351EED4B402CD86894B90864C070BF248BF7ED4B409A16BEE9360A64C0E0B2CE35E2EE4B40301FBEE9A91064C040877AE0B4F74B40D6FCBDE94D1164C098F7CE35BAF74B40545BBEE91E1264C0483CCF35D2F64B40E61C6994511264C0A05ECF359EF74B405AE96894AF1164C074557BE07CF94B407C256994641164C00817268BAFFA4B40321FBEE9391164C04C3CCF3512FC4B4068BE6894401164C0EC19CF3506FE4B408F41BEE9851164C0E448258B27FF4B403CAD6894FA1164C0C02CD03566FF4B404E1469948E1264C0F716268BAFFE4B40D6FCBDE92D1264C067BF248BF7004C401875BEE9071164C0C02CD03526054C408D41BEE9851064C008E8CF35CE084C40501469943E0F64C0BC7A248B5F0C4C40D2B56894CD0E64C00881CF356A0E4C40EC63BEE9C10E64C0985ECF355E134C40050EBEE9930E64C02804258B0F164C40331FBEE9090E64C068557BE03C174C40321FBEE9B90D64C073557BE0BC184C40BC52BEE9EB0C64C038D5CE35AE1E4C404F1469949E0C64C07B0AD0351A1F4C40C6E06894CC0B64C0FF16268B6F234C401675BEE9970764C00481CF356A2B4C40321FBEE9090664C0E719CF3586314C40B80B69948B0064C0B0C5CF3502394C40F3F16894B2FD63C038B6D035963E4C4068BE689420FB63C00C17268B2F454C40C927BEE9DCF763C0E448258B274A4C408E41BEE975EF63C0503CCF35D2524C40F4F16894E2F163C0D848258B674F4C408D41BEE985F163C068557BE07C4E4C40C6E06894DCF063C0A85ECF35DE4E4C40040EBEE913F063C098F7CE35BA4F4C403AAD68949AEE63C010E8CF358E504C40F638BEE962EA63C0F019CF3546564C40BC52BEE9DBE963C00381CF35AA574C40D0B568943DE963C043B6D03596584C40826CBEE964E763C0543CCF3592584C40525BBEE9AEE663C0E4FD79E004594C407C25699414E763C054A3CF35B6594C40F638BEE982E763C058A3CF35F6594C40D6FCBDE96DE863C0CB2CD035E6594C40D6FCBDE96DE863C0204FD035B25A4C40FFC6689463E663C067BF248B37604C40BD52BEE99BE563C0BFC5CF35C2614C4000C76894C3E263C0737479E094644C405CE968944FE163C03CB6D03556684C409A16BEE9B6DF63C0740AD035DA6B4C407C25699434DE63C050D2258B576F4C407E25699474DC63C0A85ECF35DE714C401675BEE9B7DB63C0274FD03572724C40311FBEE999DC63C038D5CE35EE6F4C40FFC66894B3DE63C07871D0353E6D4C40AE7DBEE9EADF63C034B6D035166A4C40D5FCBDE9CDE063C0E493D0358A684C40B70B6994FBE063C0F019CF3586674C40BD52BEE9CBE063C058A3CF35F6654C40A4A4689457E063C068BF248BF7644C408BFA6894C5DF63C0988D258B7F644C40BD52BEE93BDF63C05BA3CF3576644C408AFA689455DF63C0D0B2CE3522674C40F638BEE912DF63C023B979E0EC694C4089FA6894A5DE63C044B6D035D66B4C40D2B568943DDE63C0BF107BE0E46B4C409916BEE926DD63C00B81CF35AA684C40826CBEE9F4DB63C0B47A248B1F664C403CAD68942ADB63C0D893D0350A654C40E963BEE911DA63C0E819CF3506644C40BC52BEE9FBD863C0E819CF3586634C40264ABEE938D863C078557BE0FC634C40C4E06894CCD763C0D42CD035A6644C40E41C699451D763C0D893D0350A654C40AE7DBEE95AD663C0B0C5CF3542654C404F146994CED563C00417268BAF644C40BA52BEE9FBD463C0BFC5CF3542624C401875BEE977D463C0BFC5CF35C2614C40C827BEE9ECD463C03FB6D03516674C40BB52BEE9EBD463C0700AD0359A684C4020036994D8D463C0E893D035CA694C40050EBEE9E3D463C0E093D0350A6B4C4096CF6894D6D563C0F019CF35466F4C40CA27BEE90CD663C06FBF248B37714C40BB52BEE90BD663C0E4FD79E044784C40C4E068943CD663C018E8CF350E7C4C402103699438D663C00881CF356A7D4C407C25699404D663C0C82CD035E6804C40020EBEE9D3D563C0543CCF35D2824C40D6FCBDE9DDD463C0C82CD035A6874C40050EBEE973D363C018B979E0EC8C4C405CE96894FFC963C017E8CF354EA84C406030BEE99FC963C0985ECF35DEA84C402ED8689419C963C037B6D03556A94C4022036994D8C563C03FB6D03556AE4C40BB52BEE9DBC163C078557BE0FCAE4C402DD8689409C263C0EF35248B47B04C40321FBEE959C263C030B6D035D6B04C405CE96894BFC263C0DC48258BE7B04C40B80B69942BC363C06F557BE0BCB04C40C4E068948CC263C0DCFD79E0C4B24C40BB52BEE98BC063C0730AD035DAB64C40E963BEE9E1BF63C0A85ECF351EB94C40F538BEE9C2BE63C088F7CE35FABD4C403CAD68941ABE63C02CB979E0ACBF4C40D4FCBDE9EDBB63C08871D035BEC14C40BC52BEE92BB963C034D5CE352EC74C405BE968943FB863C091F7CE353AC84C40CA27BEE98CB763C0F835248B87C74C40F4F1689422B763C0DF93D0354AC84C408AFA6894B5B663C0E093D035CAC84C401875BEE9C7B563C0F035248B47C94C40EA63BEE921B663C00781CF356AC74C40CA27BEE9DCB563C0D8B2CE3522C54C40FEC66894E3B463C064A3CF3576C04C40806CBEE954B563C09F5ECF359EBE4C40020EBEE903B563C0CC2CD035E6BD4C40C827BEE94CB063C058A3CF35F6BC4C405F30BEE96FB063C060A3CF35B6BB4C40806CBEE984B063C06FBF248B37BB4C4000C7689453AF63C031B6D035D6BD4C40E71C699441AE63C097427AE0DCBD4C401975BEE9B7AD63C093427AE01CBE4C40D5FCBDE93DAD63C050A3CF35B6BE4C4020036994A8AC63C02804258B4FC04C40816CBEE9A4AC63C0DCB2CE35A2C14C402FD8689409AD63C0533CCF35D2C24C40D2B56894ADAD63C0EC93D0350AC44C40040EBEE963AD63C008CC7AE00CC54C40BC52BEE90BAD63C0B3107BE0E4C54C40CA27BEE9BCAC63C03BD5CE35EEC64C40BC52BEE98BAC63C077557BE07CC84C409C16BEE906AD63C045D2258BD7C74C406130BEE90FAE63C08471D0353EC74C40D1B568948DAE63C0F880CF35AAC64C40F638BEE932AE63C0F319CF35C6C44C404E1469946EAD63C0AC5ECF359EC14C40D5FCBDE93DAD63C02CB979E0ACBF4C40EA63BEE971B063C0988D258B3FC14C40F638BEE912B163C0F816268BEFC04C40FFC6689463B163C0E493D0350AC04C40B90B6994CBB163C03CB6D03556BF4C40311FBEE939B263C0B97A248BDFBE4C40D2B568949DB263C050A3CF35B6BE4C40D3B568940DB363C0D0B2CE3522BF4C40525BBEE91EB363C0AF7A248B1FC04C40BC52BEE9EBB263C0D793D0354AC24C40B07DBEE9CAB263C037B6D03516C84C4098CF6894E6B263C0EF35248BC7CA4C40806CBEE944B363C0988D258B3FCD4C405F30BEE94FB363C0C3107BE0E4CD4C402DD8689439B363C05FA3CF3576CE4C401875BEE927B363C0607479E014CF4C40806CBEE944B363C0B47A248BDFCF4C406D05BEE970B363C0DFB2CE3562D04C40244ABEE9C8B363C0F780CF352AD14C40CA27BEE9ECB363C0A85ECF359ED14C402ED8689429B463C018E8CF350ED24C40F2F1689472B463C098F7CE35FAD14C40EB63BEE9A1B463C08D71D0357ED14C407D25699494B463C058A3CF35B6D04C40234ABEE908B463C0E319CF3586CE4C40D5FCBDE9CDB463C0FFCB7AE08CCE4C406ABE689480B563C0AC5ECF351ECF4C401775BEE917B663C00781CF352AD04C40BC52BEE98BB663C0A85ECF359ED14C40A5A46894B7B663C0E719CF3586D34C4022036994B8B663C0DF19CF3546D64C40BD52BEE99BB663C0C0C5CF3502D94C405F30BEE96FB663C037B6D035D6DA4C404F146994AEB663C030D5CE356EDD4C40254ABEE958B663C05FA3CF3536E14C402003699458B563C0503CCF35D2E84C4068BE6894A0B463C0F880CF356AF04C405CE968945FB463C0D32CD03566F44C40311FBEE929B463C08B71D0353EFD4C405AE96894AFB363C0DFFD79E044054D408C41BEE985B363C0473CCF35D20B4D4068BE689460B363C06FBF248B770D4D40BC52BEE9EBB263C013E8CF354E104D40B07DBEE98AB263C06BBF248BF7114D407B256994B4B163C07F71D035BE144D407B25699464B163C0C0C5CF3582164D40E863BEE9A1B063C01BB979E06C154D40B80B69948BAF63C030D5CE352E154D40040EBEE973AE63C0740AD0359A154D40D2B56894ADAD63C0C0C5CF3582164D40BD52BEE91BAD63C0B0107BE024184D40F2F16894C2AC63C0DF93D0358A194D40B70B69944BAC63C0B1C5CF35821A4D405F30BEE95FAB63C0B37A248BDF1A4D401775BEE937A663C0543CCF35D2184D408E41BEE9C5A563C0988D258B3F184D408B41BEE975A563C0E3B2CE3562174D405F30BEE93FA563C0F880CF356A164D40234ABEE9F8A463C01F4FD035B2154D4096CF689476A463C007E8CF358E154D40331FBEE939A563C0E0FD79E084184D40C6E06894FCA563C088F7CE353A1A4D40535BBEE91EAB63C0975ECF359E1E4D408D41BEE925AC63C0A05ECF355E1E4D405CE96894DFAD63C0DF48258B671C4D40FEC66894A3AE63C0F319CF35461C4D40EC63BEE971AF63C08C71D0357E1D4D40D6FCBDE9EDB063C0D0FD79E0C4204D40030EBEE973B163C0E0FD79E004234D40E61C699431B163C088427AE05C254D406C05BEE930B263C018E8CF350E294D40C4E06894FCB163C0F7CB7AE08C2E4D408E41BEE915B063C0790AD0355A3B4D409916BEE9A6AE63C0B0C5CF3502414D40816CBEE9F4AD63C0E0FD79E0C4424D40D2B568943DAC63C0E348258BA7444D402FD8689479AB63C00917268BEF454D40D1B568948DA863C0B4107BE0644F4D40C6E068944CA463C00381CF35EA574D405F30BEE9AFA363C01CE8CF358E594D406030BEE9EFA263C0700AD035DA5A4D406230BEE9DF9F63C0C82CD035A65C4D40FEC66894039F63C090F7CE35BA5D4D40B80B69941B9E63C0D048258B675E4D40B80B69941B9E63C0F035248B475F4D40501469944E9F63C047D2258B975E4D40E963BEE9C1A063C08871D035FE5C4D40B07DBEE9FAA163C04B877AE0F45C4D40515BBEE97EA263C0294FD035F2604D4000C7689433A263C0B0107BE0A4634D40F3F1689412A063C0D7FD79E0846B4D406D05BEE9D0A063C0EF19CF35866E4D40311FBEE9B9A063C0473CCF35526F4D405CE968944FA063C037B6D035D6704D40F2F16894A29F63C030B6D03596724D401975BEE9879F63C0A85ECF359E734D40311FBEE9899F63C09C8D258B7F744D4020036994989F63C0687479E014754D40F2F16894A29F63C064A3CF3536754D406030BEE96F9F63C08F8D258BBF784D40D6FCBDE93D9F63C003CC7AE00C7A4D40F638BEE9C29E63C0473CCF35527B4D40E963BEE9819D63C050877AE0F47C4D40D2B568943D9C63C02F4FD035F27D4D401675BEE9879B63C068BF248B377F4D4068BE6894409B63C05F7479E054824D40535BBEE93E9B63C0975ECF35DE894D40254ABEE9F89A63C064A3CF35368D4D40826CBEE9549A63C0304FD035B28F4D40311FBEE9999963C0AFC5CF35C2914D405F30BEE90F9963C0A75ECF35DE934D406D05BEE9509B63C07D0AD0355A8F4D40525BBEE9AE9B63C068557BE03C8E4D406ABE6894C09B63C0C82CD035268D4D40244ABEE9189C63C0F335248B078A4D406E05BEE9609C63C02C4FD035B2884D40545BBEE94E9C63C050D2258B17874D40C3E068942C9C63C06C7479E054854D40525BBEE91E9C63C0C4107BE024844D4020036994789C63C06C0AD0359A814D405DE968941F9D63C0CC2CD035A67F4D40525BBEE9EE9D63C0D02CD035667E4D40CA27BEE9BC9F63C00881CF35AA7D4D40E51C699481A063C038D5CE35AE7C4D40D4FCBDE91DA163C018E8CF35CE7A4D405CE968949FA163C0607479E0D4774D40331FBEE939A263C0FC80CF352A734D40030EBEE9B3A263C08071D0357E714D4096CF689456A463C007CC7AE04C704D407E25699424A863C0747479E0946B4D4068BE6894F0AB63C0483CCF3592694D406E05BEE960AC63C0493CCF3512694D4050146994CEAC63C0CFB2CE3562684D40525BBEE91EAD63C0A85ECF359E674D40E61C699491AD63C0D993D035CA664D40806CBEE934AF63C0740AD0355A664D40F973B4842EB263C0BCA901F7BA5F4D4076DEF5E809B563C0B3C7CA5D3B5E4D4006DF35C70DBA63C04813E9D706584D40C4E068944CBF63C0D8B2CE35E2524D40AD7DBEE9EAC463C04CD2258B974E4D40E863BEE981C663C04FA3CF35764E4D403CAD68946AC863C02404258BCF4F4D40B80B69941BCA63C0B0C5CF35C2524D40D5FCBDE90DCB63C00481CF356A574D40535BBEE9BECA63C0D893D035CA594D40C5E068940CCB63C028D5CE35AE5C4D40F2F16894A2CB63C02D04258B4F5F4D403CAD68942ACC63C0294FD035F2604D406E05BEE910CD63C0433CCF3592624D40311FBEE979D163C008E8CF354E664D40264ABEE9D8D163C087F7CE353A674D40D6FCBDE91DD263C0B0107BE0E4684D40321FBEE919D263C03F3CCF35526A4D4020036994E8D163C0D7FD79E0846B4D408E41BEE9A5D163C068BF248B776C4D40A4A4689437D163C0700AD0359A6D4D40254ABEE9E8D063C01F4FD035326E4D40FFC66894A3D063C0E0FD79E0046F4D40E61C699451D063C037B6D035D6704D40AE7DBEE9DACF63C0334FD035B2744D407C256994A4CF63C0687479E014764D40311FBEE9F9CF63C0284FD03572794D40A4A4689447CF63C0E793D0354A7B4D40301FBEE979CD63C03F3CCF35127D4D40525BBEE9CECD63C0985ECF355E7D4D405BE968940FCE63C0C3107BE0E47D4D40545BBEE92ECE63C038D5CE35AE7E4D40EA63BEE921CE63C0F319CF35C67F4D40F838BEE972CE63C01BB979E0AC7F4D40C6E06894BCCE63C0707479E0547F4D40525BBEE9FECE63C0978D258BBF7E4D402ED8689439CF63C02F4FD035F27D4D40B70B6994EBCF63C087F7CE353A7F4D40264ABEE9B8CF63C0284FD03532804D40D4FCBDE9ADCE63C0D1B2CE35E2814D40E41C699431CE63C08371D0353E834D40040EBEE993CD63C02F4FD03532844D40244ABEE9E8CC63C0B1C5CF35C2844D40040EBEE943CC63C00817268BEF844D40A4A4689487C563C0F880CF35AA814D40FDC6689463C463C031D5CE35EE7F4D40254ABEE958C363C024B979E06C7D4D4000C7689483C263C054877AE0747A4D402ED8689439C263C08071D035BE784D40F2F1689442C263C0B8C5CF3582764D40501469940EC263C0BFC5CF3542744D40E41C6994D1C163C030B6D03516734D40C5E068946CC163C058A3CF35B6714D409C16BEE9F6C063C0DFFD79E084704D40BB52BEE98BC063C0E3B2CE35E26F4D40D5FCBDE98DC063C08071D0357E714D40E61C699471C063C0CB2CD035A6724D4096CF689436C063C008E8CF354E734D40321FBEE9D9BF63C050A3CF3576734D40321FBEE9D9BF63C0BFC5CF3542744D408E41BEE9E5C063C0F780CF352A744D40F4F1689452C163C0F880CF35AA744D404F1469949EC163C0687479E014764D401875BEE917C163C030D5CE35AE784D40C5E06894ACC163C0677479E0547C4D407C25699444C363C0D1B2CE35E2814D40C727BEE97CC463C0E0B2CE35A2844D40B80B69947BC763C0E3FD79E004854D40EB63BEE921CA63C07871D035FE874D40F838BEE9E2CC63C033D5CE356E894D40EA63BEE921CE63C0D7B2CE35228B4D407D25699424CF63C00D81CF356A8D4D4020036994A8CF63C0687479E0148F4D40E41C6994E1CF63C03F3CCF35D2904D409A16BEE9F6CF63C0FB80CF356A924D40D2B568942DD063C0FF16268BAF924D408D41BEE975D063C01704258B8F924D406C05BEE9C0D063C0888D258BFF924D40AE7DBEE9EAD063C067557BE0FC934D40C3E06894FCD063C073BF248BF7944D403BAD68941AD163C037B6D035D6954D40254ABEE968D163C0948D258B7F964D40E863BEE991D163C03CD5CE352E944D40826CBEE984D163C0D793D0358A924D406C05BEE930D163C01704258B8F914D40030EBEE983D063C0908D258B3F914D40264ABEE988D063C0EF19CF35468E4D40EA63BEE9A1CE63C05CA3CF35B6894D40301FBEE9C9CE63C0BCC5CF35C2864D40F4F1689462CF63C0C0107BE0A4854D40D2B56894ADD063C0EF35248BC7844D406C05BEE930D163C0EF19CF3546834D40BD52BEE94BD163C0E3B2CE35A2824D40CA27BEE95CD163C09B8D258BFF814D408D41BEE965D163C07871D0353E814D40254ABEE968D163C058A3CF3536804D4001C7689483D163C00781CF352A7F4D40CA27BEE9BCD163C06C7479E0947E4D4096CF6894F6D163C0BC107BE0247E4D40D5FCBDE97DD263C0EB19CF35C67A4D40C827BEE97CD363C02B4FD03572774D40525BBEE99ED463C0B8107BE0A4744D401875BEE907D663C0D8B2CE35A2724D406D05BEE9B0D663C0B4C5CF3502714D401875BEE957D763C0483CCF35D26F4D40F2F16894E2D763C087427AE05C704D40B60B69941BD863C090F7CE35FA714D406030BEE9EFD763C087F7CE353A734D402FD8689499D763C0F880CF35AA744D40040EBEE953D763C0BC7A248BDF764D40A4A4689467D863C0EC93D035CA784D40040EBEE9E3D863C00817268BEF794D40B60B69944BD963C0473CCF35527B4D40EA63BEE921D863C0F716268B6F7C4D40BB52BEE9ABD763C024B979E06C7D4D40F2F16894E2D763C043B6D035567F4D402203699468DA63C03F3CCF35127D4D405DE96894EFD963C0B0107BE0A47B4D407E256994B4D863C0403CCF35D2754D4000C76894A3D863C0A85ECF359E744D40A3A4689467D963C08B71D0357E684D40F638BEE912D963C044B6D03556664D40331FBEE909D963C038B6D03556644D409A16BEE936D963C00036248B87624D4000C7689483D963C0294FD035F2604D40B07DBEE9FAD963C0EC93D0354A5F4D404F1469947EDA63C08471D0353E5E4D40321FBEE919DB63C0304FD035B25D4D4096CF6894D6DB63C0F835248B875D4D401575BEE917DC63C08371D035BE5D4D409916BEE956DC63C02004258B4F5E4D408BFA689485DC63C0D12CD035265F4D40A4A4689497DC63C0CF2CD03526604D40B80B69947BDC63C08B71D035BE614D408AFA689435DC63C08C427AE05C624D406030BEE97FDB63C0EB19CF35C6624D40B80B69943BDA63C048D2258B57644D40C827BEE9BCD963C069BF248BB7654D40301FBEE9D9D963C0A85ECF359E674D401875BEE977DA63C0D0B2CE35E2684D40B50B69943BDB63C07B557BE0FC684D40E61C6994F1DB63C03CB6D03516684D40806CBEE964DC63C0740AD0355A664D406B05BEE990DB63C0707479E054664D40264ABEE9F8DB63C02FB6D03516654D405EE96894CFDC63C04C877AE0B4634D407E25699444DD63C0988D258B3F634D409C16BEE936DD63C088F7CE35FA604D40EA63BEE911DD63C0BC7A248BDF5E4D4034314AEE75DC63C0FC43B7CE675A4D408C615C4440DB63C0D4FE5AE7AA564D40C28167AD3EDA63C04B4C6BA8984E4D40A3A4689467D963C0B87A248BDF484D40F4C4EEC658D963C0B8EFCA6803494D40D6FCBDE9EDD863C003CC7AE00C484D402ED86894B9D863C0F419CF3586474D40040EBEE9A3D863C0EC93D0354A464D405BE96894AFD863C0D748258B27434D40040EBEE9A3D863C090427AE05C424D4089FA689445D863C030D5CE35EE404D404E146994DED763C0DB48258BA7404D40331FBEE979D763C0F7CB7AE0CC404D40E61C699421D763C0A75ECF359E404D40D2B56894ADD663C0B4C5CF35023F4D40AE7DBEE90AD763C0D32CD035E63D4D40B80B6994ABD763C0204FD035B23C4D406030BEE94FD863C090F7CE353A394D4098CF689406D963C04C877AE0F4374D40040EBEE9D3D963C0E3B2CE3522374D402203699468DA63C00D81CF35EA364D402203699468DA63C0E893D0350A364D4000C7689483D963C0E893D0350A364D40C4E068948CDA63C01804258BCF334D4074722D2A37DC63C0D50FB4C026334D40ACD70A8612DE63C05B8CB9F9F3324D404050B9B279E063C094D2A1EA0F354D40040EBEE9A3E163C090427AE05C364D40B07DBEE94AE263C00481CF35AA384D404D146994DEE163C088427AE01C384D40B60B69947BE163C0680AD0351A384D40BC52BEE92BE163C010E8CF35CE384D40B70B6994FBE063C00981CF356A3A4D4020036994C8E163C0780AD0355A3A4D40040EBEE963E263C064BF248BB73A4D40D2B56894ADE263C0E393D0350A3C4D40F838BEE982E263C087427AE0DC3E4D40AE7DBEE9AAE363C097F7CE35BA3E4D40806CBEE9D4E463C0E048258B67424D40525BBEE9AEE663C07B0AD0351A4B4D406D05BEE990E963C02404258B0F564D40494DF28B51EC63C02D21E0D6BE604D40F2F1689472EF63C03F877AE074684D402003699438F063C074557BE03C694D40F838BEE992F063C0DFFD79E0C4694D406B05BEE970F163C0503CCF35126C4D4088FA6894A5F163C068BF248B776C4D402ED8689489F263C02B04258B4F6C4D40E080AC9302F363C08B47A881756A4D401875BEE947F463C03FD2258BD76A4D401DB3253E26F563C0AF8FD2DC726B4D40EB4049F32AF463C01F10ADC4256D4D40DEDEBB213BF363C0880FA99256714D40F2C7B637C8F263C0F12128BE27744D409B4C2F73C2F363C0E4BDF39D35774D40198D9AB46BF463C08C294848B1774D402C7B7EBDD7F463C033992D3DC0774D40587B320EC4F563C0605ABEAF43774D40A57A9271B5F663C0C702573ADE764D40EE9D14BD9EF763C01F0AEECDD0764D40CD138A0552F763C03372452C99754D405A5EE1A634F763C028BE684389744D4081896C0B82F763C06055CFB943724D40AA260EF42EF863C0A8945DF1D3704D40AD08C35595F863C090BE14BBC96E4D406C4DCB59C9F763C0770459845F6D4D40C6B807F317F863C0ABBEC52DA06B4D4051537BD982F863C0B771584F6A6A4D40821B0595DCF863C0A40647CEA46C4D40240758508DF963C0B8E72753C76C4D4030441045D3F963C0280EAFE41D6C4D40AE17BB91CAF963C044AA1F10326B4D401645CF6095F963C04F081F4F6D6A4D402045552D78F963C03855BF655D694D40766F496428F963C04FBED7BF94684D40603B216C6FF963C0578784786F664D40C469B86322FA63C008AD13469C654D406D05BEE9E0FA63C05FA3CF3576654D407CFD5438B9FB63C0E7BCBD4DBA634D40432F8703FFFC63C09FD01DD1F8614D40EEEC55D82AFD63C087DB1F714D634D40549847C9BEFD63C0EFBCEEF61E654D406ABE6894D0FE63C060BF248BF7684D409A16BEE986FF63C0BF2CD035E66A4D406130BEE9AFFF63C0D7FD79E0846B4D40608BA79577FF63C05FE0F37CB36C4D40D61E2F3777FF63C0785038EB2E6E4D40EA4586E5A7FF63C0D07D33B0DC6E4D4021036994E8FF63C0E3B2CE35E26F4D40869FB390960064C0189CEE3AB0704D40A40E3B51770164C083888DB9F8704D40BA411111420264C0E8D121A596704D4052E64B47B70264C06C5BF0B613704D40495EAE8FD80264C03F2D916E386F4D4023C9CB7EF30264C05749D4E07D6E4D40349C857F190364C0E398DB80B96D4D407C2FBAF99C0364C0CCDB22C1386E4D40BA52BEE93B0464C0C72CD035E66E4D40B926D927E60464C0C42997933E6E4D40EC71A9C1490564C0D5983011A46E4D40859546D6CE0464C0514C9195C2704D40525BBEE90E0564C098427AE01C734D401B9A0CD6DE0464C030AFC9E542754D404AF9B79B750664C0AFE067FE46744D40C05D025F1D0764C0E7F3B76F7B734D40C18401E6520764C048F7411706724D400557C4D9E20764C04F7715CE85714D409247FD16190864C0241C51C007734D40AE7DBEE93A0864C093F7CE35BA744D40E41C6994210864C011E8CF35CE774D4096CF6894360864C0A45ECF351E794D406E05BEE9900864C0D02CD035A6794D407074166F340964C070AB59D458774D40E67F8C95A50964C090424813F8784D40E346FB99860A64C0A95832BD80784D405E0D279B980A64C09B49A1F4D1794D409A16BEE9360A64C054877AE0747A4D40A4A46894270A64C0E393D0358A7B4D40225865A4A30964C06BDE577D5F7C4D407688E403790964C0D493B9730D7D4D40AA78D6AD8F0864C0C0D151921E7D4D40AE7DBEE93A0864C02F4FD035F27D4D40321FBEE9290864C0C3C5CF35C27E4D40E863BEE9410864C00081CF356A7F4D40A4A46894770864C058A3CF3536804D40545BBEE99E0864C09C8D258B7F814D40244ABEE9F80864C0A05ECF355E824D405BE968945F0964C0F735248B07834D40B80B6994AB0964C050877AE0B4834D40E863BEE9D10964C0D42CD03526844D409C16BEE9260A64C06B7479E0D4844D4068BE6894500A64C00881CF356A854D406BD9440DB60A64C09BBE5D24E4864D407D256994440A64C06C0AD035DA874D40301FBEE9690A64C0DFFD79E084884D40C58932F8440B64C0CC20D75D0B894D40E2462161D90C64C023223C8140864D4006832BD3F11064C0FCAB8E633E804D40427C0457591564C08B6915604C794D408E57787B361664C0D4C847CFD0764D4074DF2E84971864C0A116D415BE724D40BCD3DBD4AD1A64C014DECF8401684D40EE7AF1C47A1A64C0B8E042812B6B4D40AAD9DC2E8A1A64C05B529885236D4D40E8FDBB48F51A64C0347AD65E196F4D404C7BC695C51B64C0F04E92167D704D40B20CE5026F1C64C0A78B81402A714D40E6077A4A0C1D64C0DCAE75952D704D40B4583AE7C31E64C019E7CF8EC66F4D40CC312534571F64C0D3D019D49B6E4D40D2400064C91F64C05B67E942606C4D405119E232102164C093F2873ED66B4D403EC1460B702264C0CF6CD03EA6684D40DA2368BA812364C0AFC3307EDF674D406A99801D672464C0F0E4484B4B664D404568C6008B2564C017FD66A416664D4071209F1BC02564C0585D6B5C30644D4011D0B174CF2764C0E77A621731644D4068F56501B42864C0B4AD6476BF644D402E46C1DF512964C05707213C74654D403CAD6894EA2864C063A3CF35B6674D40525BBEE9AE2864C0DBFD79E004684D40525BBEE9AE2864C060BF248BF7684D40CA27BEE99C2964C0F119CF3546684D40BB52BEE9CB2964C0DBFD79E004684D40D7FCBDE9ED2964C0790AD0351A674D4067BE6894002A64C0314FD035F2654D406E05BEE9F02964C0304FD035F2644D40D3B56894AD2964C0E319CF3586644D401D4624E4452964C010B617BF93634D402428CC1B6A2864C070FC60926A634D4021036994482964C0A05ECF359E624D40471088B9EF2964C0EF35A7E6C05F4D409169C263702B64C04C88FB9AF55C4D402CF74F8BBF2B64C06C6B2D6E115B4D40EABBE393FC2B64C0C4ECA01790594D402141B8020A2C64C0C3D4B11FE9574D40BB52BEE9FB2B64C02404258B0F564D4027CC13B9942B64C097FA1C0690554D40A086F79B772A64C050CF8DE6D1564D405C2C5A20A42964C087D06BCD45574D403901AFF7A42B64C0CC5F32536F544D40C8300A5CA02F64C0C79E1660F8514D4013480EE0263164C0D4DCA50FC84F4D40CFBD4EEA9B3164C04C1C4D9DA34D4D40E01BD2F4FE3164C000A2E9240F4D4D4022036994B83264C0F519CF35C64D4D40321FBEE9193364C068BF248BB74D4D40AE7DBEE99A3364C02FD5CE356E4D4D40244ABEE9783464C038D5CE352E4C4D40C927BEE94C3564C0BB7A248B9F4B4D407E256994A43564C033D5CE35EE4A4D40D4B56894ED3564C063A3CF35F6494D40D6FCBDE92D3664C0B87A248BDF484D40040EBEE9A33664C06C7479E0D4474D406B05BEE9403764C067557BE07C474D402FD86894793864C0750AD0359A474D40E963BEE9113864C0985ECF35DE494D404D1469940E3764C047877AE0B44C4D40311FBEE9B93664C04CD2258B974E4D409B16BEE9263764C0483CCF3512504D40545BBEE99E3764C06FBF248B37514D407C256994343864C03F3CCF3552524D40B70B69947B3864C0543CCF3592524D405F30BEE95F3864C0D32CD035A6514D40C827BEE95C3864C0E719CF3586504D40BB52BEE98B3864C0483CCF35124F4D40C4BBDC8D693864C0D498636FA54B4D40EC63BEE9F13864C0FF80CF356A4E4D4098CF6894863964C0F019CF35C64F4D40963B7E98B23A64C058E8479330504D4036185E07363D64C0F32DD7E2E0504D40D8C76AF0F73D64C0772717BE99504D40F87D9EBDB53E64C0608FD0B0C74F4D404A7E354E5D3F64C0E362238F6E504D4001A8021E634064C047F94B90734F4D40FDA45A71254164C030A821E41B504D404C161C30784264C04015926E794F4D4022036994684464C0E0B2CE3522514D400A8D2C3BA24564C00F3C05DA8C524D40E767DC94E54364C008D5E63CF9544D408AFA6894254264C0687479E054554D40244ABEE9784164C00481CF356A574D4098CF6894F64064C0E0FD79E084564D4068BE6894B03F64C024B979E0EC564D40254ABEE9E83E64C0975ECF355E564D40AE7DBEE98A3E64C040B6D03596564D407E256994643E64C064A3CF3576564D405F30BEE95F3E64C0BF2CD03526564D402ED86894693E64C0F019CF3506554D407E256994643E64C050A3CF35B6544D40E51C6994313E64C06F7479E014544D40040EBEE9133E64C0F7CB7AE08C534D409A16BEE9E63D64C0DF48258B27534D40806CBEE9843D64C058A3CF35F6524D40040EBEE9833C64C01FB979E0AC534D403BAD68947A3B64C0FF16268BAF554D4020036994F83A64C0F035248B87584D40D00C4477C23B64C047A539421E5A4D400C7E0F82B13B64C0C7AD7E83AE5B4D40CA27BEE94C3A64C0B0107BE0E45D4D40331FBEE9E93964C03FD2258BD75E4D40A2A46894773964C0888D258B7F604D40244ABEE9283964C0A05ECF351E614D4096CF6894463864C0294FD035F2604D40E07777BDF43664C0D0EF18B19E604D40C2945F3EAD3564C07BD2FEEB02634D403BAD6894FA3464C087F7CE353A674D403EBA0536EA3564C047FBE66BC7684D408524AD0ACA3664C0C74253670F684D402CE50F15793764C0A0FCD85C69674D40BC6D4B89193864C02835C3731A654D40D23BD755633864C0D8C458CCE6624D404691FBA4CA3864C01B1773F69F624D40A5A46894673864C0EC93D0350A674D40BD52BEE94B3864C0CFB2CE3562684D4096CF6894463864C0DFFD79E0C4694D40254ABEE9683864C05CA3CF35F66A4D408C60D8D1A03864C0B098001FA36C4D40931DBF10E23864C017F26796C96D4D409AE325FD223964C09FE87BD355704D4012031A284D3964C0981DE1D52E734D404E1469945E3964C07871D0357E7B4D405F30BEE96F3964C078557BE0BC7C4D408E41BEE9953964C02F4FD035F27D4D40264ABEE9D83964C00881CF35AA7E4D408D41BEE9B53A64C09F5ECF355E804D408AFA6894E53A64C008CC7AE00C814D406ABE6894403B64C06DBF248BF7824D40F638BEE9623B64C0403CCF3552844D409C16BEE9363B64C00817268BEF844D40525BBEE90E3B64C044B6D03516854D406030BEE9BF3A64C07F71D035BE854D40CA27BEE98C3A64C0BC107BE0E4854D404D1469944E3A64C030D5CE35AE854D40A3A46894473A64C020B979E02C854D405E30BEE94F3A64C054D2258B97844D40D4FCBDE93D3A64C0C4107BE024844D40C6E068942C3A64C07C0AD035DA834D40BC52BEE91B3A64C0BB7A248B5F834D406B05BEE9003A64C0403CCF35D2824D40D6FCBDE9CD3964C03F3CCF3552824D40D7FCBDE98D3964C074557BE03C824D40E41C6994B13864C0EF19CF3546834D40EB63BEE9C13764C0AC5ECF35DE834D407E256994343764C08871D0357E844D408AFA6894353664C0FF35248B07874D408C41BEE9A53364C038B6D035568A4D40C927BEE97C3364C02F4FD035F28A4D40AE7DBEE95A3364C043B6D035568C4D408E41BEE9353364C04FA3CF35F68C4D408D41BEE9053364C017E8CF350E8D4D40CA27BEE97C3264C0E493D035CA8C4D4097CF6894563264C04FA3CF35F68C4D4098CF6894363264C094F7CE35BA8E4D40D6FCBDE97D3264C027B979E06C8F4D40A4A46894873364C037D5CE356E8F4D406030BEE99F3364C0AC5ECF35DE8F4D402ED86894B93364C03F3CCF35D2904D40EA63BEE9F13364C0D0FD79E0C4914D402ED86894693464C044877AE034924D40EA63BEE9B13464C02FB6D035D6914D40234ABEE9783564C0DB93D0350A904D4039AD6894DA3564C037D5CE356E8F4D40040EBEE9233764C0413CCF35D28E4D408AFA6894E53A64C037D5CE356E8F4D4000C76894F33B64C064A3CF35368E4D40D3B568946D3C64C06C7479E0148C4D406C05BEE9303C64C07C0AD0351A8A4D40D7FCBDE91D3B64C0DFB2CE3562894D40D7FCBDE91D3B64C0DFFD79E084884D405F30BEE9AF3C64C0BF2CD035A6894D406130BEE90F3E64C0A85ECF359E8C4D40BB52BEE92B3F64C03F3CCF35D2904D40EA63BEE9F14064C047877AE0749D4D405AE968945F4164C0E793D035CA9F4D408D41BEE9A54164C0607479E094A24D40C827BEE93C4164C0ED93D0350AA54D40030EBEE9A34064C0B77A248B9FA64D40E61C6994F13F64C018E8CF350EA84D4022036994284164C06C7479E014A44D408AFA6894654164C0E1FD79E004A24D40501469941E4164C08F427AE01CA04D40331FBEE9494064C0DC48258B679E4D408AFA6894753F64C093F7CE357AA04D40BB52BEE9FB3E64C02F4FD035F2A34D40E41C6994113F64C0C0C5CF3542A74D40BB52BEE9DB3E64C09C427AE05CA84D40C3E06894CC3E64C08871D035FEA94D40525BBEE9DE3E64C0D1FD79E0C4AB4D40E41C6994113F64C007CC7AE04CAD4D40030EBEE9B33E64C0B0C5CF3502B04D4039AD68944A3E64C0D8B2CE35A2B14D40D8FCBDE9BD3D64C00081CF356AB24D4096CF6894F63C64C0A95ECF359EB24D40F638BEE9423C64C0F7CB7AE00CB64D40F638BEE9C23B64C00717268B6FB74D4068BE6894503B64C0D893D0350AB64D40D7FCBDE91D3B64C0D893D0350AB64D40D2B56894CD3A64C02C04258B4FB84D40A3A46894473A64C02704258B4FBB4D409C16BEE9A63964C044B6D03556BD4D40BC52BEE9AB3864C0CF48258B27BC4D40515BBEE92E3864C08F8D258B7FBC4D407D256994B43764C0F319CF3546BD4D40E81C6994613764C01BE8CF350EBE4D4002C76894F33664C060BF248B77BF4D4022036994D83664C018B979E02CC04D40535BBEE97E3B64C0CC2CD03566D04D406ABE6894C03B64C0E448258BE7D34D40311FBEE9093C64C070BF248B77D54D40F2F16894223C64C070557BE0FCD64D40A4A46894273C64C003CC7AE04CD84D408AFA6894353C64C068557BE03CD94D401775BEE9773C64C0BF2CD03566DA4D4096CF6894163D64C0B8C5CF3502DC4D405F30BEE9CF3F64C0403CCF35D2E74D40D6FCBDE99D4264C0A45ECF355EF04D4098CF6894064364C00017268B6FF24D40D1B568943D4364C02F4FD03532F54D40010EBEE9334364C08871D035BEF94D40AE7DBEE97A4364C0ED93D0358AFB4D40545BBEE90E4564C07F71D035FEFC4D4021036994B84564C0F019CF35C6FE4D40A4A46894474664C007E8CF350E014E409A16BEE9B64664C0B0C5CF3542034E40806CBEE9644764C08871D0353E084E404E146994AE4764C08B71D0357E0B4E406030BEE97F4764C04B877AE0F40C4E40B60B69942B4764C0988D258B7F0D4E403CAD6894DA4664C00BCC7AE0CC0E4E40C827BEE99C4664C0D7B2CE3562104E40040EBEE9834664C0BCC5CF35C2114E4067BE6894804664C0E0B2CE35E2124E40FFC66894834664C0BC7A248B9F134E40F838BEE9A24664C02FD5CE356E144E40B80B6994DB4764C038D5CE35EE184E406793048D0B4864C0D8E2911AC8194E407C256994144764C02FB6D035D6194E408E41BEE9F54564C098427AE0DC1A4E40147B55852B4564C01B1FC4E7B11B4E404F314236284564C0D82AA7D5C11D4E40F638BEE9024564C0F835248B471F4E40826CBEE9C44464C0DFB2CE35621F4E40C4E068942C4564C030B6D03516204E40B60B69949B4564C0617479E014204E40040EBEE9834664C0DFB2CE35621F4E403AAD68946A4664C00481CF35EA1E4E40254ABEE9584664C0948D258B7F1E4E4070A27BDBCE4564C0ABB65AC2C21D4E40D681BC1CCB4564C0B790A3278F1C4E40BC52BEE9BB4664C0CC2CD035E61B4E409C16BEE9F64764C06B557BE07C1B4E40301FBEE9E94864C0700AD0359A1C4E40264ABEE9B84864C0DFB2CE35621F4E402FD86894494964C0DF93D0350A1F4E40321FBEE9894964C0204FD035321E4E403AAD68949A4964C014E8CF350E1D4E4022036994984964C01CE8CF35CE1B4E4088FA6894854964C00881CF356A1B4E40D1B568945D4964C0B37A248B1F1B4E408AFA6894354964C087F7CE35FA1A4E4000C76894234964C0E3FD79E0041B4E40AD7DBEE91A4964C05FA3CF3536194E4000C76894234964C0F916268B2F194E406E05BEE9504964C00481CF352A194E40BB52BEE98B4964C073BF248B37184E403AAD68949A4964C0770AD0351A174E40E963BEE9414964C0483CCF3592164E403ADE49E33E4864C0FB2B9C9F40164E40140CA18F914764C0B8312E10D5144E40304D5EB8514764C040F1D58EA2124E406B0CE822A14764C0410FCAE25B114E409044D332724864C0E3F3C02A4B104E40F0BC7C343A4964C0F0DF2262900F4E40022E136E874964C0085579FBE60E4E403666D4DA264A64C0D373FDC2780E4E40B529A909CE4A64C047A4EF7A98104E40B07DBEE9FA4A64C047D2258BD7114E40D1B56894BD4B64C007E8CF35CE144E40D7FCBDE9ED4B64C007E8CF35CE154E405DE96894FF4B64C0483CCF3592164E40E4DEC325974B64C06842BDFA27174E4068BE6894504B64C0BCC5CF3502184E405F30BEE91F4B64C0C02CD03566184E40826CBEE9E44A64C0747479E0941A4E40525BBEE9EE4A64C00436248B071C4E40FFC66894334B64C017E8CF354E1D4E40254ABEE9A84B64C0314FD035F21E4E4001C76894334D64C0D0B2CE35E2224E40030EBEE9C34D64C094F7CE353A234E40D0B568944D4E64C04CD2258B17244E40AAD523AFAC4E64C0E86E595DC5254E4013303014284E64C0C0AED296A0274E40247567C57E4C64C0A36F3EF42B2A4E40321FBEE9A94A64C090F7CE353A334E409C16BEE9364A64C050D2258B17364E4020036994084A64C08871D0353E394E40F638BEE9B24964C0DFFD79E0443C4E402CD86894E94864C00581CF352A3E4E405E30BEE9FF4764C0533CCF35923F4E401775BEE9474764C0D02CD03526414E40D5FCBDE92D4764C093F7CE357A424E409A16BEE9464764C040B6D03516444E40EA63BEE9514764C033D5CE356E454E406230BEE90F4764C08071D035FE454E40321FBEE9094764C028B979E0AC464E40BB52BEE91B4764C097F7CE35FA494E40BA52BEE92B4764C08471D0353E4B4E408BFA6894A54664C0DBB2CE35624B4E40E963BEE9214664C0D7FD79E0044C4E40F838BEE9824364C0473CCF35D2504E40E51C6994214364C038B6D035D6514E4097CF6894F64164C06F7479E054534E40F4F16894F23E64C0BC107BE0A4524E40C927BEE92C3E64C094F7CE35BA554E4096CF6894A63E64C00017268B6F564E407C256994D43E64C0670AD0359A564E40C827BEE93C3E64C034D5CE35AE574E408AFA6894353C64C0730AD0351A5A4E4000C76894233D64C0780AD0355A5B4E408E41BEE9053E64C0707479E0945A4E40E61C6994E13E64C0E0B2CE3522594E406030BEE94F4264C0C82CD03526554E4088FA6894054364C094F7CE35BA554E40F738BEE9D24264C028B979E0EC574E40515BBEE9AE4364C07B557BE03C5B4E40B90B6994EB4464C0B7C5CF35C25D4E40C6E06894DC4564C03FB6D035965D4E4022036994284464C0F035248BC7594E40806CBEE9E44364C05F7479E0D4584E40E81C6994E14364C03BD5CE356E564E40F1F16894F24364C054D2258B57544E40F638BEE9424464C0A45ECF35DE524E40E61C6994E14564C0A87A248BDF514E40331FBEE9994764C073BF248BF74F4E405AE968945F4864C0FF35248B874F4E40A2A46894D74864C048877AE0744E4E40A2A46894174964C077557BE0FC4B4E40F4F16894424964C054877AE034494E40C5E068947C4964C088F7CE353A474E401A75BEE9974964C00BCC7AE08C464E40B70B6994CB4964C0988D258B3F444E408BFA6894B54B64C0BDC5CF35023D4E405DE96894FF4B64C0AFC5CF35823B4E40F2F16894124C64C0CC2CD035A63A4E40F638BEE9224C64C0B0107BE0A4384E40CA27BEE93C4C64C034D5CE35EE374E40C927BEE99C4C64C0F716268B6F374E40301FBEE9B94D64C034D5CE35EE374E404F1469941E4E64C0204FD03532364E40040EBEE9F34D64C01CE8CF35CE344E40E61C6994914D64C090F7CE353A334E405EE968944F4D64C0204FD035F2304E409B16BEE9764E64C040877AE0742F4E405DE96894DF4E64C0F980CF35AA2F4E40525BBEE99E4E64C074557BE0BC314E40B952BEE9DB4E64C0F816268BAF324E40B80B6994FB4F64C0B1107BE0E4304E40B70B69944B5064C094F7CE35BA2F4E404E146994EE4F64C07C71D0353E2E4E4097CF6894665064C030D5CE356E2D4E4088FA6894355164C034D5CE35EE2C4E402ED86894995164C044D2258B172C4E40A4A46894E75164C02B4FD035322B4E40B70B69942B5264C0EC19CF35C62A4E4089FA6894655264C0B07A248B1F2B4E40F638BEE9925264C08471D0357E2C4E40D5FCBDE9BD5264C0304FD035722B4E409C16BEE9E65264C018B979E0EC2A4E40545BBEE91E5364C0BCC5CF35C22A4E40A4A46894775364C08C71D035BE2A4E40A4A46894775364C0A75ECF35DE294E407E256994745264C07F71D035BE284E40F638BEE9225264C0B37A248B1F284E40B07DBEE9EA5264C00CCC7AE04C274E403BAD68943A5364C0908D258B3F274E40D2B56894FD5164C088427AE09C254E401775BEE9B75164C0E3B2CE35A2244E403AAD68949A5164C02404258B4F234E40B70B6994AB5164C0284FD03532224E40B80B6994EB5164C01FB979E06C214E403AAD68945A5264C0D7B2CE3522214E40E41C6994815664C0AFC5CF3502224E40254ABEE9085564C06BBF248B37204E404E146994DE5164C0C82CD035661E4E4000C76894034F64C08FF7CE353A1A4E4021036994684E64C04C877AE074184E408AFA6894854E64C0F780CF352A164E40B07DBEE96A4F64C0E719CF3546134E4020036994C84F64C0C0C5CF3582114E404E146994EE4F64C0DFB2CE35220F4E4098CF6894C64F64C0304FD035B20C4E4089FA6894754F64C03CB6D035160B4E40A2A46894374F64C0D02CD03566094E4098CF6894464F64C0B8C5CF35C2064E409C16BEE9864F64C00036248B87044E40F838BEE9E24F64C0F419CF3586024E40050EBEE9535064C09D427AE0DC004E4000C76894D35064C033D5CE35AEFF4D407C256994845264C00017268BEFFD4D40244ABEE9785464C0A85ECF359EFD4D402ED86894695664C0483CCF3592FE4D40D4FCBDE90D5864C0DFB2CE35A2004E409B16BEE9165864C00517268BEFFB4D40B07DBEE9DA5964C0C02CD035A6F84D40D6FCBDE9CD6264C06FBF248BF7ED4D406ABE6894206A64C0DF19CF3546EA4D40D1B56894AD7364C0B7C5CF3582E64D40E51C6994117C64C050D2258B57E64D408AFA6894258364C050A3CF35B6EA4D40CA27BEE91C8464C08B427AE0DCEB4D40D1B568941D8564C00781CF35AAEE4D40BC52BEE9FB8564C08C427AE01CF24D40D1B568948D8664C02F4FD03532F54D40AE7DBEE9CA8664C078557BE03CFA4D40E71C6994E18564C070557BE0FCFB4D402DD86894098364C0B8107BE024FD4D402DD86894098364C0DBFD79E004FE4D408E41BEE9658364C02CB979E0ECFD4D40D2B56894BD8364C0BCC5CF3502FE4D406030BEE90F8464C02304258B4FFE4D40D6FCBDE95D8464C0B0107BE0E4FE4D40B07DBEE92A8464C08471D0353EFF4D40BC52BEE9AB8364C0DFB2CE35A2004E40EA63BEE9B18464C030B6D03556014E40AE7DBEE96A8664C0B7107BE064044E40040EBEE9238B64C0B0C5CF3582084E40040EBEE9538C64C0A05ECF35DE0A4E40311FBEE9C98C64C054877AE0340B4E407B256994348D64C0948D258BBF0B4E401875BEE9E78D64C0E048258B270E4E404E1469941E8E64C0304FD035B20E4E401675BEE9378E64C08071D0353E0F4E407C256994548F64C02C4FD03532124E405F30BEE99F8F64C0E719CF3546134E4020036994D88F64C060A3CF3576144E40B60B6994DB8F64C097427AE09C154E40A5A46894878F64C0483CCF3592164E40A5A46894878F64C0DCFD79E084174E40A4A46894679064C0C02CD03566184E406030BEE90F9264C068BF248BF71B4E40B80B6994AB9364C03BD5CE35AE1D4E40311FBEE9999464C0F735248BC71F4E401775BEE9279564C0770AD0351A224E408E41BEE9C59464C018B979E0AC234E40E41C6994019564C0B07A248BDF244E404E1469948E9564C0FF35248BC7254E403AAD6894AA9564C02004258BCF264E40B60B69948B9564C057A3CF35F6274E408E41BEE9C59464C08C71D035BE2A4E406D05BEE9E09664C08BF7CE357A264E40C4E068941C9864C0948D258BBF244E4088FA6894159964C00B17268BEF254E40EA63BEE9E19964C00717268B6F274E408AFA6894A59F64C02C4FD035B22B4E406C05BEE930A064C0DFB2CE35622C4E40D0B568943DA164C0D0B2CE35622F4E40311FBEE949A264C0C0C5CF3542314E40515BBEE93EA364C008E8CF350E344E40E963BEE921A464C0BBC5CF3542374E408AFA689495A464C038D5CE35AE394E40040EBEE9E3A364C00881CF35AA394E40254ABEE9B8A164C0AFC5CF35823B4E408E41BEE915A164C087F7CE35BA3B4E407C256994C4A064C0FB35248B073C4E40E51C6994A1A064C07871D035BE3C4E408AFA689495A064C08471D035BE3D4E408E41BEE975A064C0747479E0143F4E402CD8689449A064C08F8D258B3F404E408BFA689415A064C0908D258BBF404E401775BEE9779F64C0EB93D0354A414E4022036994289F64C090427AE09C424E40C5E068942C9F64C018E8CF354E444E40311FBEE9899F64C08071D035FE454E408AFA689455A064C09CF7CE35FA464E4068BE689420A564C02804258BCF424E4000C7689493A564C067557BE0FC414E40F2F1689442A664C0EB93D0354A404E402203699418A764C0BB7A248BDF3F4E40806CBEE9D4AB64C0F8CB7AE08C414E40C4E068944CAC64C00081CF352A424E40C5E06894CCAD64C0D893D035CA464E40C4E068942CAD64C0B8107BE0A4484E40254ABEE948AC64C0AF7A248B5F4A4E40806CBEE954AB64C0403CCF35524B4E404F1469940EAA64C0700AD0355A4A4E409C16BEE986A964C0E4B2CE35A24A4E4089FA689405A964C0D048258B674B4E40826CBEE9A4A864C0B7C5CF35824C4E40264ABEE948A864C0FB80CF35EA4D4E4098CF6894F6A764C020B979E0AC4E4E409B16BEE986A664C004CC7AE00C504E40331FBEE979A564C01704258B4F524E40C827BEE9CCA364C007E8CF354E544E407B25699494A264C0C0C5CF3542574E405DE96894BFA064C01FB979E02C594E402ED86894F99F64C013E8CF350E5B4E40BD52BEE9AB9F64C0D42CD035665D4E407E256994E49F64C0E0B2CE35625F4E401675BEE9F7A064C06F0AD0355A634E406C05BEE900A164C074557BE0BC644E40D6FCBDE97DA064C00FE8CF354E654E408F41BEE9D59F64C0F835248B87654E40D4FCBDE96D9F64C038D5CE35EE654E4098CF6894169F64C0EB93D035CA664E40F3F16894929D64C00036248B07694E405BE96894FF9B64C0BC107BE0A46C4E4039AD6894BA9C64C0F019CF35466F4E409B16BEE9269E64C0BC7A248BDF714E40321FBEE9A99E64C06C0AD0355A754E405CE96894FF9D64C0985ECF35DE774E40C827BEE94C9D64C0687479E054764E4021036994A89C64C0FC80CF356A734E409A16BEE9269C64C07B0AD035DA714E40E71C6994E19B64C038D5CE356E714E40806CBEE9249B64C0473CCF35926F4E4096CF6894B69A64C0C92CD035266F4E401775BEE9379A64C0E793D0358A6F4E40BC52BEE9FB9864C0CF2CD035A6724E403CAD68941A9864C07871D035FE734E406D05BEE9C09664C0C72CD03566754E40FFC66894639564C073557BE0FC754E409A16BEE9769464C0D748258BE7744E40BB52BEE98B9464C00317268B2F734E406C05BEE9F09564C018E8CF350E6F4E40F4F16894529664C0CF2CD035666D4E402ED86894699564C02C4FD035B2694E408BFA6894159364C0473CCF35D2684E406030BEE9DF8E64C00036248B07694E403AAD6894BA8D64C0CB2CD035E6664E40F638BEE9528D64C00981CF356A664E40FFC66894038C64C00981CF356A664E406ABE6894708B64C053D2258B97654E405F30BEE93F8B64C057A3CF3576654E40F438BEE9128964C057A3CF3576654E403AAD6894AA8864C07D0AD035DA644E406E05BEE9908864C02BB979E06C634E40816CBEE9948864C064A3CF35B6614E40806CBEE9848864C0F8CB7AE04C604E40525BBEE94E8864C08071D035FE5E4E40EA63BEE9118864C0403CCF35125E4E402ED86894B98764C03FB6D035965D4E405F30BEE92F8764C03FB6D035965D4E40244ABEE9888764C0443CCF35925C4E402BD86894898764C05FBF248B375B4E406C05BEE9508764C08071D035BE594E40CA27BEE9FC8664C040D2258B57584E40D2B568943D8A64C0F419CF35C6544E406D05BEE9808A64C01BE8CF350E544E40AE7DBEE99A8A64C0AFC5CF3582534E405BE96894CF8A64C04F877AE0F4514E40BC52BEE9EB8A64C088427AE05C514E406E05BEE9F08A64C08371D035FE504E408C41BEE9E58A64C0E4B2CE35E24F4E40BC52BEE9EB8A64C0FF35248B874F4E405BE968940F8B64C0B8107BE0644F4E40D2B568946D8B64C09F5ECF359E4F4E4001C76894938B64C0FF35248B874F4E4020036994D88B64C040B6D035164F4E406ABE6894608C64C00436248B874E4E40B90B6994AB8C64C098427AE0DC4D4E401975BEE9C78C64C060A3CF35364D4E404E146994FE8C64C0985ECF351E4B4E406ABE6894208D64C0E093D0354A4A4E40FFC66894538D64C0443CCF35D2494E401675BEE9378E64C0A95ECF359E484E40FFC66894738D64C0304FD035F2464E4088FA6894B58C64C087F7CE35BA474E40BD52BEE95B8B64C0D893D0350A4C4E40040EBEE9938964C0BBC5CF3542504E40F438BEE9128964C038B6D035D6514E40C6E068944C8864C0A95ECF359E534E40F3F16894528764C088F7CE353A544E4021036994388564C01BE8CF350E544E40F3F16894528464C03F877AE0F4544E40040EBEE9D38364C087427AE01C574E40E61C6994418364C017B979E0EC5B4E40F2F16894B28264C0F019CF35065E4E406C05BEE9008264C077557BE0BC5F4E40EA63BEE9A18064C0A85ECF351E624E406130BEE98F7F64C09F5ECF355E634E407E256994947E64C0403CCF35D2634E406C05BEE9707C64C0E093D035CA634E4001C76894B37B64C05CA3CF3576634E4096CF6894D67A64C00017268B6F624E404F1469941E7A64C0DB48258BA7604E40E963BEE9D17964C0403CCF35125E4E408F41BEE9157A64C094F7CE357A5B4E40A4A46894877A64C0A85ECF355E594E40D6FCBDE99D7A64C0E919CF3586574E40E963BEE9D17964C094F7CE35BA554E40244ABEE9287A64C030D5CE356E544E408D41BEE9857A64C0503CCF3552534E40E963BEE9C17A64C087427AE0DC514E409B16BEE9B67A64C0FF35248B874F4E40545BBEE96E7A64C063BF248BB74D4E407C256994F47964C0E819CF35064C4E40B60B69946B7964C0EF19CF35C64A4E40806CBEE9F47864C0E093D0354A4A4E401975BEE9677764C037B6D035964A4E40A4A46894F77564C078557BE07C4B4E401775BEE9977464C0988D258BFF4C4E40B80B6994DB6E64C0670AD0359A564E40E863BEE9F16D64C0E019CF3546594E40B70B6994BB6D64C0EC19CF35C65B4E40050EBEE9236E64C0AB5ECF351E5E4E401975BEE9176F64C0F8CB7AE04C604E40F638BEE9B26E64C0DF19CF3586604E4098CF6894166D64C0F8CB7AE04C604E40040EBEE9936D64C0D0B2CE35E2614E4089FA6894657164C02FD5CE35AE674E40E61C6994917B64C0CF2CD035666D4E408F41BEE9357D64C08C8D258BBF6C4E408D41BEE9C57D64C0CF2CD035666D4E403BAD68944A7B64C00CE8CF350E714E40F638BEE9E27964C07F71D0353E724E40F4F16894827864C07B0AD035DA714E40BB52BEE9FB7664C0FB35248B876F4E40F538BEE9527664C0C92CD035266F4E40F4F16894827264C00481CF352A714E40E963BEE9017264C00917268BEF714E40AF7DBEE9CA7164C0244FD03532734E40244ABEE9087264C0D748258BE7744E40AF7DBEE98A7264C08B71D035BE754E40040EBEE9337764C048D2258B57774E407E256994347864C08071D035FE784E403AAD6894DA7764C050A3CF35767B4E4021036994287764C01F4FD035727A4E4098CF6894767664C03CD5CE356E7B4E40B80B6994DB7564C00FE8CF354E7D4E40D6FCBDE96D7564C058A3CF35F67E4E401675BEE9877664C048877AE0F47F4E40311FBEE9997864C0988D258B7F7D4E40331FBEE9997964C060A3CF35367D4E4020036994787964C03BB6D035967A4E40535BBEE9FE7964C0730AD035DA794E40301FBEE9C97A64C0770AD0359A794E408AFA6894757B64C02F4FD03572784E406030BEE9BF7B64C03F3CCF3592774E405CE968945F7C64C0F835248BC7764E40264ABEE9A87C64C0B0107BE024764E40D7FCBDE9DD7C64C0C42CD03526754E40D5FCBDE90D7D64C030D5CE352E734E40331FBEE9397D64C08F8D258B3F724E40040EBEE9A37E64C0AC7A248B1F6F4E40331FBEE9398064C090427AE05C6E4E407F6CBEE9548464C08B71D035FE6E4E40030EBEE9A38B64C0A87A248B9F6F4E406030BEE90F9264C0CF2CD035666D4E401875BEE9579264C0F419CF35C66D4E40331FBEE9F99264C008CC7AE08C6F4E4021036994489364C0680AD0351A704E407B256994B49264C054A3CF3536734E405BE96894BF9264C067557BE07C744E4021036994489364C0B0107BE024764E40254ABEE9189464C037B6D03556774E406D05BEE9E09664C071BF248BF7774E40E41C6994419764C037D5CE35AE774E409A16BEE9D69764C034D5CE356E764E40F638BEE9929864C07C557BE0BC754E402FD86894399964C028D5CE35EE734E408AFA6894859964C0F419CF3586734E40FEC66894139A64C07B557BE03C744E40FEC66894D39A64C08071D035FE774E40F738BEE9629B64C058A3CF35B6794E407D256994249C64C008CC7AE08C7A4E409C16BEE9069D64C073BF248BB77A4E40244ABEE9E89D64C0D1B2CE35627A4E40321FBEE9A99E64C058A3CF35B6794E40CA27BEE97CA064C0B8107BE0E4754E40D2B568942DA164C06C0AD0355A754E40B70B69949BA264C018B979E06C754E4067BE689420A464C04B877AE034764E409C16BEE976A564C0DF19CF3586784E40321FBEE959A664C060A3CF35367D4E401875BEE9C7A364C0204FD035B2814E408F41BEE9D5A264C0DF93D0358A824E40C5E068942C9F64C08771D0353E834E40CA27BEE96C9E64C0DF93D0358A824E40D0B568947D9E64C004CC7AE04C874E40CA27BEE96C9E64C0C82CD035A6884E40826CBEE9149E64C090F7CE35BA8A4E40B80B6994AB9D64C0E0B2CE35228B4E40321FBEE9A99B64C061A3CF35368A4E40C6E068946C9B64C0D893D0358A8A4E40C6E068940C9B64C01FB979E0AC8B4E40D5FCBDE97D9A64C08071D035BE8C4E40826CBEE9249964C0770AD0355A8D4E409A16BEE9869864C0C82CD035E68D4E40E51C6994119964C089427AE05C8F4E406B05BEE9109A64C02C4FD035328F4E40AD7DBEE90A9C64C0C82CD035E68D4E403BAD6894CA9D64C0FF16268BAF8E4E402ED86894F99F64C0FF16268BAF8E4E409C16BEE966A064C0700AD0359A8D4E40D3B568942DA064C02F4FD035328B4E406D05BEE920A064C0E093D035CA884E40020EBEE913A164C0334FD035B2874E406C05BEE9E0A164C008CC7AE00C884E409B16BEE9B6A264C08871D035FE884E406130BEE97FA364C0AC5ECF355E8A4E4088FA689425A464C0503CCF35128C4E409C16BEE926A464C0D02CD035A68D4E40B80B69949BA564C040B6D035968F4E40CA27BEE91CA664C070BF248B77914E408E41BEE965A564C0CB2CD035A6924E406ABE6894B0A464C0F780CF352A934E40806CBEE924A464C008CC7AE00C944E40F738BEE9B2A364C0BC107BE064984E409916BEE926A364C07771D035FE994E406D05BEE9F0A164C060A3CF35F69B4E408AFA689495A464C054877AE034A14E409A16BEE936A464C044877AE0F49E4E406D05BEE9D0A364C06F557BE07C9D4E4067BE689450A364C02004258B8F9C4E40F638BEE9A2A264C060A3CF35F69B4E40311FBEE949A364C03BD5CE35AE9A4E40AE7DBEE9DAA364C097427AE05C9A4E40AE7DBEE95AA464C09BF7CE35BA994E40CA27BEE9CCA464C0B8C5CF3582974E4050146994BEA464C024B979E0AC964E40B70B69949BA464C06BBF248B77954E40545BBEE99EA464C0C32CD03566944E40806CBEE904A564C00017268BEF934E407D256994C4A664C0B8107BE024934E402DD8689419AB64C09CF7CE353A994E40806CBEE9D4AB64C0204FD035B2994E40B80B69949BAB64C07C557BE03C9B4E40826CBEE974AA64C0CB2CD035A69D4E40F638BEE962A964C0A85ECF359EA04E4000C76894B3A864C094F7CE353AA14E409A16BEE936A764C054877AE034A14E404F146994CEA664C02C4FD035F2A14E40CA27BEE99CA664C08071D035BEA34E40D3B568948DA664C0C92CD035E6A54E40C4E068948CA664C0BCC5CF35C2A74E40B07DBEE9AAA664C0757479E0D4A94E40F838BEE902A764C04F877AE074AA4E406D05BEE950A864C0DF19CF3506AA4E406D05BEE950A864C01804258BCFAA4E402ED8689439A764C02804258B8FAC4E40A3A46894D7A564C008CC7AE00CAD4E40331FBEE979A564C0FF16268B6FAD4E40C5E068940CA564C0403CCF35D2AE4E40D6FCBDE92DA564C0607479E0D4AF4E40E963BEE981A564C048877AE0F4B04E40C827BEE9ACA564C030D5CE35AEB24E407D25699414A564C034B6D03596B54E4068BE689470A264C038D5CE35AEB54E4096CF689486A164C02FD5CE35EEB74E409C16BEE9F6A164C064A3CF3536B94E402CD86894D9A164C0503CCF35D2B94E40E71C699431A064C0998D258B7FBB4E403BAD68942AA064C0C1C5CF35C2BB4E40F638BEE922A064C010E8CF354EBC4E407C25699414A064C0CC2CD035E6BC4E402ED86894F99F64C06C7479E054BD4E40A4A46894F79E64C00081CF35AABE4E40D6FCBDE9CD9B64C0A75ECF35DEBF4E40C4E068941C9B64C01F4FD035B2BF4E40D6FCBDE9ED9A64C0A75ECF35DEBF4E409B16BEE9E69A64C06B0AD0355AC04E408AFA6894F59A64C0BFC5CF3502C24E40D6FCBDE9ED9A64C08471D0357EC24E40535BBEE98E9A64C08871D0353EC34E40D7FCBDE92D9A64C00881CF35AAC34E404D1469942E9964C04F3CCF3552C44E40D2B568946D9864C040B6D03556C54E40C927BEE9EC9764C09B8D258BFFC64E40A3A46894C79764C049D2258B17C94E409916BEE9169864C0D8B2CE3562CB4E403AAD68941A9664C094F7CE35FACC4E402DD86894A99664C0F335248B07CF4E40B70B69942B9764C04C3CCF3512D04E4068BE6894C09764C030D5CE356ED04E409A16BEE9869864C09BF7CE357AD04E4098CF6894569864C0CB2CD03526D04E40F2F16894129864C0D0FD79E084CF4E40545BBEE9DE9764C098F7CE35BACE4E40545BBEE9DE9764C034D5CE35EECD4E40AE7DBEE92A9864C0700AD0351ACD4E40D7FCBDE97D9864C004CC7AE00CCD4E40816CBEE9D49864C0204FD03532CD4E404D1469942E9964C094F7CE35FACC4E40B80B6994AB9964C09CF7CE35BACB4E4098CF6894469A64C0F816268BAFC84E4088FA6894159C64C0747479E054C34E40CFB56894AD9C64C08471D0357EC24E405DE96894EF9E64C0BB7A248B1FC24E408BFA6894B59F64C04F877AE074C14E4098CF689446A064C0334FD03572C04E40816CBEE984A064C014E8CF358EBF4E40C4E06894ACA064C067BF248B77BE4E401675BEE9F7A064C0BC107BE0E4BC4E4097CF689446A164C0E319CF3546BC4E40545BBEE99EA164C0978D258B7FBC4E4020036994F8A164C0F835248B07BD4E40311FBEE949A264C06C7479E054BD4E404F146994BEA264C057A3CF35F6BC4E401975BEE9C7A264C00BE8CF350EBC4E402DD86894A9A264C0BF2CD035E6BA4E40E51C6994A1A264C04FA3CF35F6B84E401575BEE987A264C03F877AE074B84E402203699488A264C0244FD035F2B74E408F41BEE9D5A264C0D7B2CE3522B74E40F3F1689432A364C0A45ECF35DEB64E407F6CBEE994A364C037D5CE352EB74E40F2F16894F2A364C00881CF35AAB74E40E51C699441A464C02FD5CE35EEB74E4000C76894F3A464C09CF7CE357AB74E407C256994F4A564C0F835248B47B54E40C4E068948CA664C0C0C5CF3582B44E406ABE689440A664C0B77A248BDFB14E40CA27BEE91CA664C0E3FD79E004B14E40806CBEE994A664C024B979E02CB04E405BE968949FA764C0543CCF3512AF4E402BD8689419A864C02004258B4FAE4E40B90B69946BA864C040B6D03556AD4E406C05BEE9B0A864C07871D0353EAC4E404F146994FEA864C01804258B4FAB4E40254ABEE968A964C01804258BCFAA4E402ED86894F9A864C0E993D035CAA84E40D3B568945DA864C0DBB2CE35A2A84E40E41C6994C1A764C0DF93D0350AA94E40F638BEE952A764C0DBB2CE35A2A84E407C25699444A764C0E393D0358AA74E402003699468A764C0473CCF3552A64E40AE7DBEE97AA764C06D7479E0D4A44E402ED8689439A764C04B877AE0F4A24E40F838BEE992A864C02904258B8FA24E4000C7689403AA64C0AF107BE064A14E406030BEE95FAB64C03F877AE0749F4E40C927BEE97CAC64C0978D258BBF9C4E402CD86894C9AC64C0D793D0350A994E40F838BEE9D2AB64C0E819CF3586964E4089FA689415AB64C02704258B0F944E40C927BEE90CAC64C0E319CF3586904E4021036994C8AB64C0DFFD79E0848F4E40A5A46894A7AB64C03CB6D035D68D4E40D3B568949DAB64C027B979E0EC894E4088FA6894F5AB64C00481CF352A894E40AD7DBEE9BAAC64C0D048258B67894E405CE96894FFAD64C0C02CD035668A4E40234ABEE968B064C0E0B2CE35228B4E40F3F1689482B164C0E5FD79E0048C4E406ABE6894A0B264C0C82CD035E68D4E40C927BEE95CB364C0F816268BEF8F4E407F6CBEE9E4B364C0A45ECF355E924E40AD7DBEE93AB464C054877AE034954E405F30BEE95FB464C058A3CF3576984E40D6FCBDE94DB464C0770AD0355A984E40A3A4689427B464C06B557BE07C984E40E41C699401B464C0FC80CF35EA984E405F30BEE9EFB364C0204FD035B2994E403BAD68940AB464C01F4FD035329A4E4000C7689443B464C07B557BE0BC9A4E40C827BEE97CB464C0F880CF356A9B4E40A4A4689497B464C0680AD0355A9C4E40B80B69949BB464C0F035248B879E4E40C6E068948CB464C090427AE0DC9F4E40D0B568943DB464C00117268B6FA04E40806CBEE984B364C0707479E054A04E40EA63BEE9F1B364C018E8CF358EA14E402103699418B464C0E093D035CAA24E408AFA6894F5B364C0CC2CD035E6A34E40806CBEE984B364C0E019CF35C6A44E40F3F1689482B464C00881CF35EAA44E40E963BEE961B664C03CB6D035D6A64E40806CBEE984BA64C02004258B0FA84E40F2F1689462BB64C03F3CCF3512A94E40501469940EBC64C06B7479E014AB4E40AE7DBEE97ABD64C09F5ECF351EB34E40F838BEE962BD64C040B6D03516B54E40040EBEE983BC64C0E0B2CE35E2B64E40B07DBEE9BABA64C0AF7A248BDFB84E40FFC66894B3B964C0BBC5CF3582B94E40301FBEE949B964C060BF248BF7B94E4097CF6894F6B864C0A77A248B9FBA4E40D5FCBDE9ADB864C06FBF248BB7BB4E40D1B568948DB864C0AC5ECF35DEBC4E408AFA689485B864C045B6D03516BE4E4096CF689486B864C0B7107BE064BF4E40CA27BEE9DCB864C0EF19CF3506C24E403BAD6894AAB964C0780AD0359AC34E40F2F1689462BB64C0A75ECF351EC54E401975BEE9C7BB64C074BF248BB7C54E40E61C699481BC64C0DFFD79E044C74E40535BBEE9EEBC64C02004258BCFC74E406ABE689490BD64C04C877AE0F4C74E40C827BEE99CC164C018E8CF358EC54E40D6FCBDE9BDC264C0B87A248B1FC44E40F3F1689412C364C08471D0357EC24E408E41BEE9D5C264C0670AD035DAC14E402FD8689419C264C038B6D03556C14E40D2B56894BDC164C08C71D035BEC04E408C41BEE965C364C02704258BCFBF4E40C6E068946CC464C02004258B0FC24E406130BEE93FC664C049877AE0F4CA4E408C41BEE965C664C0700AD0351ACC4E409B16BEE946C664C0700AD0351ACD4E405F30BEE90FC664C08371D035FECD4E4050146994EEC564C00DE8CF35CECE4E4050146994EEC564C018E8CF350ED44E402CD86894C9C564C060A3CF3536D64E4095CF689486C564C0F780CF35EAD84E40F638BEE922C564C0E0B2CE3562DB4E40535BBEE99EC464C0A45ECF35DEDC4E40C727BEE9FCC464C090F7CE353AD54E40D5FCBDE9EDC464C018E8CF350ED44E409C16BEE9B6C464C027D5CE35AED34E403CAD68941AC464C09CF7CE35FAD14E40311FBEE9B9C364C020B979E06CD14E40C5E06894CCC164C095F7CE353AD24E40321FBEE969C164C053877AE0B4D24E4068BE6894A0C064C087427AE01CD44E402DD8689409B964C01804258B8FD74E4096CF689486B864C018B979E06CD84E40E863BEE9F1B864C0D0B2CE3522D94E40F838BEE982BA64C018B979E06CD84E40D6FCBDE9EDBA64C04FA3CF35B6D84E409A16BEE986BB64C037B6D035D6D94E40A2A46894D7BB64C0988D258B3FDA4E408D41BEE945BC64C0985ECF355EDA4E402003699428BD64C0D0B2CE3522DA4E409A16BEE996BD64C0988D258B3FDA4E4020036994F8BD64C02804258BCFDA4E40A5A46894A7BE64C0B1C5CF3582DC4E4096CF6894E6BE64C0A45ECF35DEDC4E40B90B69941BC064C04B3CCF3512DE4E40AE7DBEE96AC164C038B6D03516E14E4068BE689490C264C013E8CF350EE54E40331FBEE949C364C0780AD0351AE94E4039AD68943ABF64C030D5CE35EEEA4E409C16BEE926BD64C09CF7CE35FAE94E40D1B568942DBB64C0DCFD79E004EB4E40F838BEE982BA64C030D5CE35EEEA4E406D05BEE960B964C043B6D035D6E94E4097CF6894F6B864C09CF7CE35FAE94E409A16BEE9C6B764C068557BE03CEC4E40BC52BEE93BB764C0670AD0359AEC4E40D1B568947DB364C06BBF248BF7EC4E40F738BEE9D2B264C07C0AD0355AEE4E4097CF689486B364C0D42CD035A6EE4E40C4E068949CB464C050D2258B97F24E40545BBEE90EB664C0D4FD79E084F44E4095CF6894B6B664C057A3CF35B6F64E4097CF6894A6B764C0F835248B87FB4E40F738BEE902B864C0C0C5CF3502FE4E408AFA689445B864C028B979E0AC004F40D5FCBDE94DB864C00436248B47034F40030EBEE963B764C0EB93D035CA094F409A16BEE9D6B664C0F880CF35EA0A4F40AE7DBEE9BAB664C00C81CF352A0C4F404F146994AEB664C0C02CD035A60D4F40030EBEE993B664C01FB979E0EC0E4F407D25699424B664C0C82CD035A6104F40FEC6689463B564C04D877AE0F4124F4039AD68948AB464C067BF248BF7144F409C16BEE906B364C0483CCF35D2164F4001C7689453AE64C0D7FD79E0C4264F409B16BEE906AB64C0780AD035DA2E4F409916BEE9B6AA64C050D2258B17304F406ABE689410AA64C047877AE0B4334F40525BBEE97EA964C030D5CE35EE354F406E05BEE9C0A864C08971D035FE374F4021036994E8A564C090427AE01C3D4F40E963BEE941A464C0AFC5CF3502424F405F30BEE90FA364C02404258BCF434F4022036994C8A164C0BF2CD035E6444F4098CF6894A6A064C0BFC5CF3542454F403BAD6894CA9D64C02004258B4F444F4089FA6894659C64C0B7C5CF3502454F408AFA6894C59B64C0AB5ECF35DE444F40AF7DBEE92A9B64C0DCFD79E084434F40A3A46894879B64C02804258B8F424F40EB63BEE9C19B64C0A35ECF355E414F40545BBEE9BE9B64C0BB7A248B1F404F40F738BEE9629B64C03F3CCF35123F4F40040EBEE9239B64C02BB979E02C3D4F40F638BEE9F29964C03FB6D035163C4F40AF7DBEE98A9764C07871D0357E3B4F4089FA6894259764C00436248B073B4F40806CBEE9749664C000CC7AE0CC384F403AAD68941A9664C08971D035FE374F405CE968947F9564C0A97A248B9F374F40B70B69947B9364C08971D035FE374F406ABE6894D09464C0204FD03572364F40C6E068944C9564C0780AD0359A354F40D6FCBDE93D9664C0978D258BBF324F40806CBEE9D49664C028D5CE356E314F40321FBEE9799764C094F7CE357A304F40A2A46894979664C040B6D03596304F406C05BEE9F09564C095F7CE357A314F40D6FCBDE9CD9464C0A95ECF351E354F40F838BEE9829464C0C3C5CF35C2354F4020036994289464C0888D258B3F364F405BE968941F9364C0344FD03532364F40535BBEE99E9264C007CC7AE08C364F40030EBEE9639264C08971D035FE374F40826CBEE9C49264C070BF248B373A4F40030EBEE9B39364C0CC2CD035E63A4F40F638BEE9729564C0DFB2CE35223B4F40AE7DBEE9AA9564C05FBF248BB73C4F40E61C6994319564C05BA3CF35B63E4F4020036994289464C00717268BAF414F408E41BEE9B59464C0780AD0359A414F40D2B568940D9564C01804258B4F414F403AAD6894AA9564C02F4FD035F23F4F40E963BEE9319664C03FB6D035163E4F406030BEE98F9664C0473CCF35523D4F406D05BEE9E09664C051A3CF35B63D4F408BFA6894C59764C0E093D0358A3F4F40E71C6994F19964C08771D0353E3E4F40D6FCBDE9ED9A64C03F3CCF35123F4F40C6E068949C9964C0DBFD79E004434F40BC52BEE96B9964C02004258B4F444F404E1469949E9964C0D793D0350A464F404E1469941E9A64C094427AE01C474F40B90B6994BB9A64C0DF48258BA7474F40A2A46894479B64C01CE8CF35CE474F407D256994749B64C0C1107BE024484F40BB52BEE95B9B64C0D8B2CE35E2484F40C6E068940C9B64C0F119CF35064A4F408E41BEE9B59A64C008CC7AE0CC4A4F402CD86894499A64C040B6D035164B4F40BC52BEE96B9964C018E8CF354E4B4F40C827BEE98C9664C0D02CD035664E4F407C256994548F64C088F7CE357A5F4F40F638BEE9229064C0D893D0350A604F408C41BEE9459164C0533CCF35925E4F408E41BEE9659264C0C82CD035265C4F403AAD68949A9364C04B877AE0B4584F40B07DBEE93A9564C0493CCF35D2564F406E05BEE9B09764C05FA3CF3536514F404E146994EE9864C094F7CE353A4F4F408D41BEE9059A64C0D0B2CE35624F4F404E1469947E9A64C09BF7CE35BA534F405CE968949F9A64C0483CCF3552574F40BD52BEE9FB9A64C0C5C5CF35425A4F40AD7DBEE98A9B64C0C72CD035A65C4F40F638BEE9429C64C0670AD0359A5E4F406030BEE9EF9B64C070BF248B375F4F40BC52BEE9BB9B64C0DB48258BE75F4F40D3B56894BD9B64C0740AD0359A604F40AD7DBEE90A9C64C09CF7CE353A614F40E51C6994F19B64C008CC7AE0CC614F40030EBEE9E39B64C0BBC5CF3542624F40D2B56894CD9B64C03BD5CE35AE624F40B07DBEE99A9B64C013E8CF350E634F40234ABEE9D89B64C0F880CF356A634F40AF7DBEE97A9C64C098F7CE35BA644F406D05BEE9F09B64C0D32CD03566654F40D3B568947D9B64C08771D035BE654F402ED86894099B64C0543CCF35D2654F404E1469947E9A64C038D5CE35AE654F40244ABEE9589964C098F7CE35BA644F408D41BEE9D59864C034D5CE35EE644F409A16BEE9869864C01CE8CF358E664F407B256994A49A64C0EC93D0358A674F4000C76894939B64C0C32CD035E6684F40F638BEE9429C64C06FBF248BB76B4F405CE968947F9B64C04B3CCF35526D4F40A2A46894479B64C0D793D0358A6D4F40CA27BEE92C9B64C04F3CCF35126E4F40040EBEE9239B64C07C0AD0359A704F40C6E068940C9B64C0D3FD79E084714F40525BBEE9AE9A64C03FD2258B17734F40D2B568941D9A64C034D5CE35AE764F40BB52BEE91B9864C053D2258BD77E4F409B16BEE9269764C0D848258BA7814F403AAD68941A9664C06CBF248B77834F40050EBEE9339564C0680AD0351A844F409C16BEE9E69064C02C4FD03572844F4021036994889064C0AC5ECF35DE834F40B80B69944B9064C090F7CE353A834F4020036994988F64C0EB19CF3506824F405DE968944F8F64C015E8CF35CE814F405F30BEE91F8F64C0F880CF352A824F406030BEE9FF8E64C097F7CE35FA824F405E30BEE9CF8E64C03F3CCF35D2834F405F30BEE96F8E64C0D3FD79E044844F40E51C6994218E64C0747479E014844F406ABE6894208D64C048D2258B97824F40F4F16894D28C64C0E4B2CE35A2824F40C5E068944C8C64C090F7CE353A834F40264ABEE9088C64C0F835248B07834F40BD52BEE95B8B64C015E8CF35CE814F40D3B56894AD8A64C0D748258B27814F406C05BEE9608A64C0F880CF352A814F40BC52BEE90B8A64C015E8CF35CE814F408E41BEE9958A64C00DCC7AE04C854F4039AD68943A8B64C0CFB2CE35A2874F40D2B568940D8C64C0F019CF3506894F40AE7DBEE9BA9064C007E8CF354E8B4F409C16BEE9469164C03BB6D035168D4F40F2F16894929164C0B07A248BDF8E4F405CE96894FF9164C0F816268BAF8F4F40B90B69940B9364C0E348258BA7904F401775BEE9879264C08871D035FE914F40F3F16894B29064C0B07A248B9F944F4000C76894139064C090427AE01C954F40BC52BEE99B8F64C0680AD035DA954F40D3B568948D8D64C0878D258BBF9A4F40816CBEE9B48B64C02FB6D035569D4F409C16BEE9A68464C015E8CF358EA14F4000C76894D37F64C007CC7AE0CCA04F40321FBEE9797A64C0680AD0351A9C4F40D6FCBDE98D7864C0DFFD79E0C49C4F40F3F16894127864C0988D258B7F9C4F408F41BEE9557764C0948D258BBF9B4F405BE968942F7764C0FF35248B479B4F406030BEE96F7764C06F0AD0355A9A4F4001C76894237764C04BD2258B97994F403BAD68947A7664C07B71D035BE984F409C16BEE9367664C02FB6D03516984F40545BBEE9DE7564C04B877AE034964F401875BEE9A77564C027D5CE356E954F4068BE6894B07464C04BD2258B57944F40C827BEE96C7464C0A45ECF359E924F4096CF6894967464C010E8CF35CE904F40B90B69943B7564C0E093D035CA8F4F40B90B69943B7564C00D81CF35EA8E4F40535BBEE94E7464C0CFB2CE35628F4F40816CBEE9D47264C0DF93D0354A914F40A3A46894277264C0F835248B87914F4097CF6894567164C078557BE07C904F406ABE6894107264C088427AE01C8F4F401775BEE9477364C0DBFD79E0848D4F40BD52BEE9EB7364C01804258BCF8B4F40D1B56894FD7464C099F7CE35BA874F40A4A46894577964C00FE8CF35CE824F40E963BEE9D17964C08BF7CE353A7E4F408C41BEE9657864C0204FD035F2814F407D256994E47464C0CFFD79E0C4854F40301FBEE9397364C050A3CF35B6884F40F2F16894D27164C0E048258B678D4F40311FBEE9E97064C0FF16268BEF8E4F40254ABEE9B86F64C0EF35248B078D4F40321FBEE9196E64C0D793D0354A8C4F40B952BEE9AB6C64C050A3CF35B6884F40A5A46894B76B64C0CB2CD035E6844F40A2A46894376B64C02B4FD035F2834F40224ABEE9486964C08F8D258B3F864F40E863BEE9016364C04DD2258B57874F40C927BEE95C6264C04CD2258BD7874F4097CF6894166164C0BC7A248B1F8A4F40AD7DBEE96A6064C038B6D035D68A4F4000C76894A35F64C07871D035BE8C4F40A4A46894675F64C02704258B8F8D4F40040EBEE9035F64C0B7107BE0A48E4F402ED86894895D64C0E093D035CA8F4F405BE968942F5C64C0D893D0350A924F406030BEE98F5B64C07771D0357E934F40EA63BEE9215B64C090427AE01C954F40F2F16894025B64C0670AD0355A964F40E41C6994115B64C00717268B2F984F403CAD6894EA5A64C0CF2CD03566994F40515BBEE9AE5A64C093F7CE353A9A4F40D2B56894CD5964C0680AD0351A9C4F40AF7DBEE94A5664C02FB6D035569D4F4095CF6894165364C00481CF356AA34F40301FBEE9B94D64C0334FD035B2B34F40826CBEE9144D64C08871D0357EB64F40311FBEE9D94C64C02F4FD03532B74F407C256994944B64C0473CCF3552B94F40BB52BEE93B4B64C0687479E054BA4F407D256994944A64C0B8C5CF35C2BB4F4002C76894B34964C0E019CF3506BD4F408E41BEE9F54864C0780AD0359ABE4F40264ABEE9B84864C04FA3CF35F6C04F4020036994084A64C0D7B2CE3562C44F409B16BEE9E64964C063A3CF35F6C54F40E963BEE9614964C0354FD03572C64F40BD52BEE90B4864C04FA3CF3536C64F40A4A46894974764C018B979E0ECC54F406030BEE99F4664C01FB979E0ACC44F4000C76894A34564C0FF80CF352AC44F406030BEE94F4464C060A3CF35B6C24F405BE968942F4364C037D5CE356EC24F40EB63BEE9B14264C0DBB2CE35E2C14F4021036994E84164C08D71D0357EBF4F402FD86894794164C0878D258BBFBE4F40E71C6994014164C0D893D0354ABE4F40050EBEE9934064C00817268B2FBE4F40040EBEE9334164C070557BE0FCBD4F405F30BEE9BF4164C05BA3CF35B6BC4F40F638BEE9424264C06F0AD0351ABB4F401F036994C84264C0C82CD035E6B94F40BB52BEE96B4364C0473CCF3552B94F407E256994C44464C04CD2258BD7B84F40A4A46894674564C0CF2CD03526B84F40A4A46894674564C02F4FD03532B74F40C6E06894443D64C0E148258BA7B94F40E51C6994213564C09B427AE01CBC4F40D0B56894DD3364C06CBF248BB7BB4F40D6FCBDE9DD3264C0D0B2CE35A2BA4F402ED86894593264C0E793D0354ABA4F4098CF6894D63164C0E393D0358ABA4F40525BBEE95E3064C0D4FD79E084BC4F40F2F16894E22F64C04D877AE0B4BC4F4020036994782F64C07B0AD0359ABC4F40E41C6994112F64C0B1107BE024BC4F40C827BEE99C2E64C08771D0353EBB4F40244ABEE9182E64C0D748258BE7BA4F401875BEE9872D64C09C427AE09CBB4F407E256994F42C64C00881CF35AABC4F40B07DBEE96A2C64C0DFB2CE3562BD4F408F41BEE9F52564C063A3CF35B6C04F40525BBEE9CE2164C0E019CF3586C94F407E256994742164C09BF7CE35FACA4F408AFA6894152164C037B6D03516CE4F408AFA6894352064C038B6D03596CF4F40E51C6994311F64C00781CF356AD04F408BFA6894651E64C07871D0357ED14F405CE968948F1C64C0FC80CF35AAD74F40F2F16894321B64C0D0B2CE3562D94F40A5A46894771A64C05F7479E054DB4F407C256994541964C013E8CF358EDF4F40AE7DBEE98A1864C078557BE07CE94F40F638BEE9C21964C0F119CF35C6F34F4021036994B81D64C085C0E71A150350405BE968943F1E64C0F049E81A25065040050EBEE9731E64C068A492C5330D504096CF6894261F64C00F8292C507105040321FBEE9D91F64C0D8E2E71A01115040A2A46894072264C056AFE71AEF1250405D30BEE9DF2264C03ABA3C704A13504089FA6894B52364C0986AE71AD7135040D6FCBDE99D2564C082C0E71A751650406030BEE97F2664C03C05E81A4D1750406030BEE97F2664C06716E81AB3175040806CBEE9342664C0D8E2E71AC1175040816CBEE9042664C028E992C5EB1750405F30BEE99F2564C06416E81A93185040AE7DBEE93A2664C07C0B93C517195040D4FCBDE99D2764C0A6433D707A1950405CE968943F2864C03E05E81AED1950406E05BEE9D02764C0C438E81A3F1A5040E41C6994412764C0B0D1E71A5B1A5040AE7DBEE90A2664C060883D70521A5040AE7DBEE90A2664C0F2FE3C70C21A5040D3FCBDE99D2A64C09427E81AB91A5040D4FCBDE9BD2D64C0B2D1E71ABB1B50401675BEE9A72E64C0DEE2E71AA11B5040321FBEE9792F64C06B59E71A311B5040F738BEE9F22F64C00C8292C5871A50402ED86894493064C0C67BE71ABD1950402FD86894A93064C0C238E81A1F195040501469943E3164C0ECFE3C7002195040501469943E3164C06016E81A73195040826CBEE9D43064C08CDC3C70761B50409A16BEE9963064C06859E71A111C50405DE968941F3064C06A16E81AB31C5040C4E06894CC2F64C01C5BE81AEB1C5040AF7DBEE98A2F64C0D8E2E71A411D50409916BEE9462F64C0DEE2E71A411E50408E41BEE9252F64C0BCAA3D703E1F5040331FBEE9192F64C0B65F92C5FB1F50403BAD6894FA2E64C0F08CE71AA32050405BE968949F2E64C0A0433D705A2150401775BEE9172E64C0CC7BE71ADD215040525BBEE93E2D64C00CF4E71A6722504096CF6894662C64C07059E71AB1225040C827BEE9DC2B64C07159E71A712250407C256994E42A64C0289EE71A89215040C5E06894FC2264C030BA3C702A205040545BBEE91E2164C0C438E81A7F2050407D256994242064C038BA3C70CA215040E963BEE9312264C0AED1E71ADB2250405E30BEE9BF2264C0C47BE71A5D23504096CF6894261F64C06616E81A932350401775BEE9A71E64C0F81A92C5C32350406ABE6894501E64C09F433D703A2450401875BEE9071E64C034BA3C70CA24504021036994B81D64C0249EE71A492550405F30BEE9AF1A64C0F1FE3C708227504000C76894B31964C03405E81A2D295040311FBEE9491964C0225BE81A4B2D504020036994381964C0CE7BE71A9D2D5040806CBEE9341964C06C59E71AF12D50407C256994541964C07CC0E71A752E50408D41BEE9A51964C0DCE2E71A212F5040331FBEE9691A64C049213D70EE2F50408CFA6894C51A64C0CE7BE71A7D3050405BE968944F1C64C09027E81AD933504022036994D81C64C0148292C5A73450406030BEE94F1D64C01F9EE71A09355040816CBEE9D41E64C0BAAA3D707E355040B60B69941B2064C08FDC3C70B6365040B70B69946B2164C070A492C5333750406230BEE9AF2464C0001B92C5C33A50401F036994F82464C08CDC3C70363B5040040EBEE9432464C0F58CE71A233B50404E146994BE2264C04C213D706E3A50404F1469941E2264C06816E81A933A5040F2F16894F22064C0CC7BE71A9D3B5040F2F16894522064C0B85F92C5FB3B5040806CBEE9B41F64C0CCC692C51F3C50405DE968941F2064C070A492C5733C50407F6CBEE9A42064C0C438E81A9F3C50405E30BEE92F2164C0EC49E81AA53C5040B952BEE9AB2164C0F049E81A853C50406D05BEE9D02164C09C6AE71A573C5040BA52BEE9EB2164C04E213D70CE3B5040F738BEE9022264C0543D92C5AF3B5040A2A46894D72564C0DCE2E71A213C5040CA27BEE9BC2664C0543D92C5AF3B504069BE6894A02664C09427E81A393A5040A4A46894572764C0820B93C5573950401575BEE9D72964C04EAFE71ACF375040BD52BEE91B2A64C0F88CE71A633750405F30BEE94F2A64C0C47BE71A1D3650405E30BEE98F2A64C0CC7BE71A9D355040F838BEE9E22A64C0BAAA3D703E355040040EBEE9932B64C0F68CE71AE3345040D6FCBDE9BD2B64C004663D70663450407C256994D42B64C060883D70D23350409041BEE9F52B64C09827E81A593350408D41BEE9A52C64C0A8433D705A325040826CBEE9142D64C0F88CE71AE3315040F4F16894822D64C04EAFE71A8F3150408D41BEE9352E64C06BA492C5533150402CD86894A92F64C026E992C54B315040525BBEE95E3064C0BC38E81A1F3150407C256994C43064C006663D70C6305040BC52BEE91B3164C06616E81A533050409C16BEE9763164C04C213D700E30504095CF6894E63164C0C038E81A3F3050405CE968940F3264C04C213D704E315040F3F16894A23464C0209EE71A29325040050EBEE9833564C020E992C5AB3250406ABE6894703664C06CA492C5F33350402CD86894793764C00AF4E71A87345040D6FCBDE9CD3964C0148292C5A7345040D4B568940D3964C00AF4E71A4734504089FA6894B53764C060883D7012335040CA27BEE9EC3664C0C038E81ADF3250404F146994AE3C64C0D8E2E71A413050407E256994643E64C07CC0E71A752E50406D05BEE9D03D64C0B4AA3D70FE2D504068BE6894403D64C0946AE71A372E50408AFA6894353C64C0CBC692C55F2F504068BE6894903B64C0BCAA3D70DE2F50408E41BEE9953964C09027E81AB9305040C5E06894FC3964C07059E71A31305040E51C6994313B64C0DCE2E71A212F50409A16BEE9A63B64C0543D92C5EF2E50407C256994B43B64C0108292C5C72E5040E71C6994513C64C0800B93C5D72D5040A4A46894A73C64C03A05E81A8D2D50406E05BEE9903D64C06816E81A932D50406C05BEE9703F64C0C338E81AFF2C504096CF6894964264C004663D70262E5040806CBEE9E44364C0C8C692C59F2D5040F538BEE9724364C00EF4E71A672D50401875BEE9874264C006663D70262D50406ABE6894204264C0DCE2E71AC12C5040E963BEE9914464C04CAFE71A8F2C5040C827BEE9AC4564C01C5BE81A0B2C50409A16BEE9B64664C0DEE2E71A012B50408BFA6894054764C036BA3C708A2A5040264ABEE9E84764C0CC7BE71A9D2850404D1469943E4864C028E992C50B28504089FA6894A54864C0EEFE3C70A2275040D2B568942D4A64C0ACD1E71A3B275040BB52BEE95B5064C0D8E2E71AC1235040E41C6994D15164C0583D92C50F225040244ABEE9A85264C06816E81A53215040D6FCBDE96D5364C054AFE71A6F205040F3F16894E25364C0205BE81A2B1F5040030EBEE9E35364C0583D92C56F1E5040A2A46894A75364C060883D70321D504039AD6894AA5364C01A5BE81A8B1C5040D6FCBDE9ED5364C0CA7BE71AFD1B50407C256994545464C09A27E81A791B50409C16BEE9965464C0F81A92C5E31A504067BE6894705464C0BF38E81A1F1A504068BE6894905464C0BCAA3D703E195040EA63BEE9815764C0C8C692C57F17504000C76894335864C0209EE71A8916504068BE6894005964C0C238E81AFF155040D0B56894BD5964C0F0FE3C7042165040D3B568943D5A64C06716E81AB3175040FFC66894435A64C06016E81AB3185040FFC66894235A64C0860B93C5771950401F036994185A64C020E992C52B1A5040BC52BEE95B5A64C0A4433D70FA1A50408AFA6894055B64C023E992C56B1C50405DE968945F5B64C07059E71AF11C5040C927BEE9FC5B64C0225BE81A6B1D50406030BEE98F5B64C0F88CE71A231F50408BFA6894355B64C072A492C5931F50403BAD68947A5A64C0543D92C58F1F50403BAD68947A5A64C03ABA3C700A205040F738BEE9D25B64C0A2433D70DA205040D2B56894AD5C64C00EF4E71A27215040535BBEE97E5D64C00AF4E71A072250405E30BEE9DF5D64C09A27E81A39225040244ABEE9185E64C0249EE71A69225040C927BEE9BC5E64C0108292C5472350406E05BEE9105F64C06616E81A93235040E963BEE9B15F64C0B85F92C5BB235040806CBEE9B46164C06616E81A93235040806CBEE9B46164C09227E81AF9235040E763BEE9716164C0F649E81A0524504068BE6894D06064C06816E81A732450405CE96894CF6164C0F049E81AE5255040D2B568946D6364C03C05E81AED2650402ED86894B96464C0F68CE71A232850407D256994C46464C0E2E2E71A212A50405BE96894DF6664C0021B92C5E3295040F1F16894C26764C0C038E81A7F2950402ED86894796B64C0F81A92C5A3265040254ABEE9786C64C06016E81A33265040254ABEE9786C64C0F48CE71AC32550401875BEE9C76B64C0BAAA3D709E2550401675BEE9076A64C09227E81AF9235040F638BEE9526964C04A213D70AE23504067BE6894C06664C06616E81A932350408D41BEE9356664C0209EE71A09235040E71C6994316564C0249EE71A69215040E41C6994916464C07EC0E71AF52050401675BEE9C76364C0269EE71AE920504089FA6894456164C0A0433D705A215040545BBEE98E6164C0289EE71A09215040EB63BEE9B16164C0F08CE71AA3205040C827BEE9AC6164C0F049E81A25205040C927BEE97C6164C0543D92C58F1F504021036994186364C06FA492C5731E5040AD7DBEE9AA6364C0D8E2E71A811D50407E256994E46364C09027E81AD91B5040E863BEE9516464C00DF4E71A671A5040535BBEE94E6564C004F4E71A471A5040321FBEE9696664C0D8E2E71AE11A504068BE6894306764C0DEE2E71AA11B50405F30BEE9EF6864C08CDC3C70161F50401875BEE9976964C0543D92C58F1F50407C256994946A64C00E8292C5C71F50405F30BEE96F6B64C080C0E71A5520504098CF6894166D64C038BA3C70CA215040B80B69942B7164C0E2E2E71A2124504096CF6894B67564C004663D70862550408E41BEE9257A64C0F48CE71AC325504089FA6894157F64C06816E81A7324504000C76894738C64C06816E81A73245040806CBEE9848864C09927E81AD92450406ABE6894F08A64C0F48CE71AC32550405E30BEE9CF9464C0F049E81A25205040545BBEE9DE9764C0543D92C58F1F50409A16BEE9369764C030BA3C702A205040F838BEE9029564C0A0433D705A215040F2F16894229664C0E0E2E71A0122504097CF6894D69964C0A0433D705A215040F4F16894C29A64C05E883D70F2205040A4A46894579C64C084C0E71A751F5040D2B568941D9D64C0543D92C58F1F5040F1F16894E29C64C03B05E81AAD2050405CE968940F9D64C0289EE71A89215040C5E068947C9D64C05F16E81A13225040F4F16894029E64C09A27E81A39225040F4F16894029E64C038BA3C70CA2150402ED86894C99D64C0B05F92C59B215040F3F16894929D64C0A0433D705A2150408D41BEE9D59D64C07059E71AD1205040806CBEE9249E64C0B35F92C57B205040501469947E9E64C0C038E81A5F205040EA63BEE9E19E64C0A4433D707A2050409B16BEE9869E64C0001B92C5A31F5040C727BEE9EC9D64C0F0FE3C70221F50406030BEE93F9D64C0BEAA3D70BE1E5040CFB56894AD9C64C0DEE2E71A411E5040F3F16894929D64C0225BE81A6B1D50408E41BEE9F59A64C0168292C5871D5040F1F16894A29964C0225BE81AEB1D50409A16BEE9869864C0A8D1E71ABB1E5040C6E068947C9964C0289EE71AA91D50402FD86894C99A64C0ECFE3C70221D5040F838BEE922A164C07059E71AB11C5040A3A4689447AE64C0F2FE3C70C22050407C25699414BC64C094DC3C7016235040FEC6689413C064C05C883D7092245040EB63BEE911C664C068A492C573255040321FBEE9D9CB64C058883D70D22850408E41BEE945CE64C0DCE2E71A412C50402203699478CF64C05C883D70B22E50406F87521D30CF64C034FFA07CE12F50405288AA0C31CF64C03E98905357315040BC52BEE94BCF64C02A9EE71A89325040EAB85D3F5FCF64C0388455225433504023E7A8C90ACF64C0B0251FE6AB335040857BADFD0DCE64C078950293DA335040AE7DBEE99ACC64C0148292C5A734504039AD68945ACC64C06416E81AF334504096CF689456CC64C0DFE2E71A81355040244ABEE988CC64C09627E81AD9355040C6E06894ECCC64C0BAAA3D707E3550401DF4FC0120CD64C07017EB9FB036504021411B2D15CD64C0D8FD59AFA6375040C5E068947CCC64C0DCE2E71A81395040D6FCBDE90DCD64C0E8FE3C70E23950403BAD6894DACD64C0BA5F92C5FB3A5040F3F1689412CF64C0205BE81A8B3B5040A3A4689427D064C0BE38E81ADF3C50406030BEE9DFD064C0C8C692C5FF3C5040C827BEE97CD064C0F049E81A053C5040BC52BEE93BCE64C0DCE2E71A813950408AFA6894F5CE64C06816E81A133A5040F2F16894D2D064C04CAFE71AEF3B5040967C04158DD264C076F51370FD3C50406CDAD5A9E7D564C0C2C31B09DC3E50409F35CCF166D664C0F8FAD8CC9D3F5040FC34714F40D664C0D293AF947D405040FC44E9FBFED564C0F82168FF75415040080B7CB2C3D664C04CF27633CC425040BA21C2FCFBD764C0D834B5FAF7435040A5A4689487DA64C03305E81A4D455040D1B568941DDC64C06816E81A934650403FA479DCC4DE64C07C3CA705E1495040F638BEE9A2DE64C000663D70664B50401C7085F910DE64C064EB0A04214E5040E59999C4A9DD64C0CA89BA9F8B4F5040DD88AE3E20DD64C000196C1DEE5050402F67DD3C9EDC64C088E79BF0AF515040B07DBEE92ADC64C03405E81A0D525040301FBEE949DB64C02A9EE71AC9515040FFC6689493DB64C0B4AA3D701E5150401602B09C75DC64C0B07A63EF424F504081145522FDDC64C04C04BACE1D4E50408A83CC4762DD64C0D2C7DE8DF04C504000C76894D3DD64C044213D70CE4A50405C2402755DDD64C078AB2274E1495040B9F34F66EFDC64C0A2DEB787A84950404F1469947EDC64C090DC3C70B64950402FD8689409DC64C0185BE81A8B495040050EBEE903DB64C09827E81AB9485040F538BEE922D864C004663D7066475040D6FCBDE9CDD664C0AA433D703A475040050EBEE903D564C0E0E2E71A01485040806CBEE984D364C068A492C5D3475040B80B69948BD264C06E59E71A514850408E41BEE9E5D164C0CC7BE71A5D485040F2F1689482D164C0F08CE71AC34850405BE968945FD164C0E8FE3C70C2485040C3E068943CD164C09827E81AB94850401875BEE917D164C020E992C5CB48504000C7689413D164C090DC3C70F6485040C827BEE91CD164C020E992C58B4950401875BEE917D164C090DC3C70B6495040BC52BEE98BCF64C0B85F92C51B4B5040050EBEE903CF64C0C87BE71A1D4C5040525BBEE93ECF64C05B883D70724D504000C76894A3CF64C0B8AA3D70FE4E5040050EBEE903CF64C004F4E71AA74F5040C6E06894ECCC64C0F81A92C5435050402FD8689489CC64C0128292C5A7505040264ABEE938CC64C08CDC3C7016515040E61C6994E1CB64C06859E71A71515040301FBEE969CB64C0C87BE71A9D515040CAA45AFFEFCA64C0946014EB11515040DB061FC45ACA64C05CA02C68595050407F47601B0DC864C048C8D10084505040B89B4E82FCC364C09233CA56FE4E5040D60A587AE6C264C0344B136DC94E504014B6B772CEC164C032608B15E94E5040E78BAA7DFFC064C0589F71028F4F5040CAD0F4E973C264C0A6252479DE505040BC49EA3C7EC464C004B824CA485250409A122EE94AC764C0F7B30FB44D53504098845197ECC964C06C1BC6E4FA535040B1FF7D9D26CB64C07CD9033BCB5350408F41BEE9F5CB64C037BA3C708A5350404BFE26C8E3CD64C0B49E7DF9655450409A16BEE916D064C0F049E81A85555040C28DF8A1B4D464C01E3EEF217C56504096CF689406DE64C0EF49E81AA55850402ED8689489DD64C094DC3C7036585040120CE46237DD64C0582E1D0BBB57504098AFE5D7D7DB64C01AB1660917575040CBD88841FFD964C0487F47D8A05650408356D3673AD764C03CE76D8DE45550404F3DBD45CCD464C054CB04A0EA545040E068179E8AD864C0068B5F257D555040DE1B7282A2DB64C096A667057C565040922B7AAF03E064C002756C0C33585040A3004BC0E5E564C0F3C1BADD2A5950406CF85EF5C0EC64C01EECF051AB5950407DE4D8A556F364C09C54D8D2045D5040D1B1947694F464C0E305AAE9745E5040031B76961BF764C0340186524C605040D43901AB55FA64C0C881218F866150409AE7BF6F62FC64C02AE5CC1B0C635040A3A46894070165C06016E81AB3645040D3B56894AD0165C0BF38E81A1F6550404F146994EE0165C054AFE71A6F655040A4A46894970265C0A8D1E71ADB655040FFC66894E30265C06B59E71A31665040525BBEE90E0365C0CEC692C59F665040B07DBEE93A0365C06E59E71A91675040F838BEE9520365C07059E71AF16750409B16BEE9160465C09327E81A19695040F738BEE9320465C0CC7BE71A7D695040AE7DBEE93A0465C0249EE71AC96950408D41BEE9650465C0543D92C58F6A50406C05BEE9500465C0BAAA3D70DE6A50403CAD68940A0465C04BAFE71A0F6B5040AF7DBEE9FA0365C0EBFE3C70426B5040E41C6994B10365C00EF4E71AE76B504039AD68944A0265C0E0E2E71A416D50408AFA689465FF64C0225BE81AEB6E5040CCAC1E9091FD64C0AC0EF130E96F5040B6EC66FF39FC64C03A35502059705040C927BEE9BCFB64C0573D92C5EF6F5040A4A4689417FC64C0F81A92C5436F50408E41BEE985FC64C09227E81AF96E5040331FBEE919FD64C0F649E81AC56E5040B60B69941BFE64C0BCAA3D70DE6D50408D41BEE9B5FF64C0ECFE3C70626D504089FA6894E50065C0800B93C5976C50406ABE6894D00165C0820B93C5576B504000C76894030265C0583D92C5AF69504097CF6894460165C06816E81AB3685040FFC66894030065C0C4C692C51F695040D2B568949DFD64C0543D92C58F6A5040F738BEE9A2FC64C0F049E81AE56A5040806CBEE964FB64C0BE38E81ABF6B504068BE689470FA64C0F68CE71AE36C5040040EBEE953FA64C09627E81A196E50409A16BEE996F264C0CCC692C51F6E50405E30BEE9FFF064C09827E81A796E5040806CBEE904F064C0289EE71A696F5040020EBEE9E3EF64C0CC7BE71AFD7050401975BEE9C7F064C0FC653D7086715040816CBEE9E4F164C08FDC3C70D6715040E61C699471F264C09427E81AB9725040030EBEE9F3F164C0F049E81AC5735040D5FCBDE9CDF064C03E05E81A0D745040D2B568947DEE64C058883D70D2735040C5E06894FCEE64C0C238E81A3F7450409B16BEE986EF64C020E992C58B7450401875BEE917F064C06F59E71AB1745040C827BEE9ACF064C004F4E71AA7745040C827BEE9ACF064C0E2E2E71A21755040EB63BEE911EB64C0F0FE3C7082795040301FBEE939E964C04CAFE71AEF7950402FD8689409E964C0E0E2E71A41795040BA52BEE95BE864C0F1FE3C7082785040F538BEE9D2E664C07059E71A51775040311FBEE9D9E564C03805E81AED7650408F41BEE9D5E464C00BF4E71A077750403CAD6894EAE164C0185BE81A2B7850406ABE689490DF64C00CF4E71A277A50409A16BEE996DC64C0AAD1E71A7B7B5040535BBEE90EDC64C09A27E81A997C5040F738BEE922DF64C09827E81A597E5040F4F16894B2DD64C06316E81A737F50409A16BEE9B6DC64C0BC38E81ABF7F5040826CBEE944DB64C0F049E81A85805040535BBEE9BEDA64C09A6AE71AF78050405E30BEE91FDB64C094DC3C7096805040EA63BEE981DB64C03805E81A4D80504096CF6894D6DB64C0249EE71AE97F5040535BBEE90EDC64C0830B93C5377F50405D30BEE95FDB64C06416E81A337F5040B80B69941BDA64C090DC3C70D67E50405BE968946FD964C0830B93C5377F5040C4E068949CD964C0E0E2E71A817F5040B70B6994EBD964C06416E81A33805040A4A4689417DA64C0C87BE71A7D805040545BBEE99ED964C06E59E71AD18050401775BEE957D864C09E6AE71AB7825040F538BEE932D764C03E05E81AED835040030EBEE923D164C0EC49E81AA5875040525BBEE9BECE64C0AF5F92C53B8850405AE968940FCD64C0800B93C57789504068BE689470CB64C0ED49E81A058A5040F638BEE9F2C964C09427E81A398B5040F738BEE932C964C0BC38E81A7F8B5040B07DBEE9EAC564C06616E81A338B50404E1469946EC464C020E992C5AB8A50403AAD6894DAC264C0C438E81ABF89504039AD68947AC364C0BCAA3D70BE895040826CBEE9A4C464C0ED49E81A058A5040E61C699441C564C0C438E81ABF8950405CE96894FFC264C0F649E81A05885040264ABEE928B864C0C87BE71ABD8650406D05BEE900B064C0C438E81ABF895040806CBEE984B064C04CAFE71A8F8A5040CA27BEE94CB164C0A2433D701A8B5040FEC6689493B364C07CC0E71AB58B50405CE96894BFB664C0B45F92C59B8D5040F638BEE982B864C09C6AE71A178E50403AAD68942ABB64C093DC3C70168E5040A3A46894F7BB64C0593D92C56F8E504039AD68947ABC64C03805E81A6D8F50404F146994EEBB64C0B85F92C5DB90504098CF6894D6BA64C0B4AA3D707E92504096CF689486B864C090DC3C70B6945040AF7DBEE99AAF64C0C238E81ABF995040EB63BEE9A1AB64C05C3D92C5CF9A5040AE7DBEE9BAAA64C0B05F92C57B9B504020036994C8A964C09E6AE71AF79B5040D6FCBDE95DA364C0CCC692C57F9C50408E41BEE965A264C03805E81A2D9C504000C7689473A264C03805E81AED9B5040B80B69947BA264C08F27E81AB99B5040A5A4689487A264C0FE1A92C5839B5040F638BEE9A2A264C0F81A92C5439B5040BC52BEE95BA264C05C3D92C58F9A5040B80B6994FBA164C084C0E71A159A50403AAD68948AA164C0F28CE71AC3995040E61C699411A164C04E213D708E9950402DD86894D9A064C036BA3C700A9B5040020EBEE933A064C06416E81A939B5040FDC66894639F64C0F68CE71AC39B5040321FBEE9A99E64C03805E81A2D9C504089FA6894959E64C084C0E71A759C5040AF7DBEE96A9E64C06516E81A739D50403BAD68943A9E64C0F08CE71AE39D5040BC52BEE9CB9D64C09327E81A399E5040F2F16894C29C64C0CC7BE71A9D9E50409C16BEE9669764C0946AE71A17A250403AAD6894FA9664C0B0D1E71A9BA350402ED86894B99064C002663D7046A55040A3A46894C78864C020E992C58BA6504069BE6894907F64C052AFE71A2FA750406030BEE98F7764C0C438E81A9FA650405CE968949F7564C00CF4E71AE7A550404E1469941E7464C0ACD1E71A7BA450405CE968940F7D64C0EEFE3C7062A5504000C76894C37D64C0C97BE71A7DA550401775BEE9777D64C054AFE71AAFA4504068BE6894407C64C05C883D7072A45040E963BEE9D17964C0ACD1E71A7BA45040D2B568942D7964C0C038E81ADFA35040F2F16894B27864C0F0FE3C70E2A2504087FA6894657864C00AF4E71AA7A150403AAD68944A7864C056AFE71A4FA050409B16BEE9867864C06859E71A119F5040B80B69941B7964C0F08CE71A239E50401875BEE9A77B64C050AFE71AEF9B50404E146994CE7B64C0B05F92C57B9B504020036994E87B64C0F2FE3C70E29A50408E41BEE9257C64C05C3D92C54F9A50404E1469946E7C64C09627E81AD9995040264ABEE9A87C64C04E213D708E99504001C76894537C64C0583D92C54F985040BA52BEE96B7C64C09C6AE71A77975040F3F16894A27C64C020E992C5AB965040264ABEE9A87C64C07CC0E71A959550404E146994CE7B64C020E992C5CB9350403CAD6894DA7B64C0B0D1E71ABB9350407E256994D47B64C0BCAA3D705E935040D6FCBDE9AD7B64C004663D70E69250402ED86894597B64C002663D7086925040C927BEE90C7C64C0EC49E81A0591504096CF6894667D64C004663D70C68F50406C05BEE9E07E64C0289EE71AE98E5040331FBEE9F97F64C03C05E81A8D8E5040AE7DBEE9BA8164C00EF4E71A878E50406C05BEE9808264C0C038E81A3F8E50408AFA6894258364C092DC3C70768D50402DD86894D98364C04E213D700E8D50405CE968949F8564C058883D70528D5040D3B568941D8664C0C638E81A5F8C50409C16BEE9068164C028E992C54B8C50403AAD68948A7F64C0BAAA3D703E8D5040F0F16894B27F64C0A8D1E71A1B8C5040A3A46894477F64C0BC38E81ABF8B504096CF6894B67E64C07E0B93C5F78B5040D3B568946D7E64C06859E71A918C504000C76894437E64C0AED1E71A5B8D5040C5E06894DC7D64C09C6AE71A978D5040BA52BEE95B7D64C0B85F92C57B8D50408E41BEE9E57C64C0BAAA3D703E8D5040545BBEE97E7C64C0A4433D70BA8A5040BD52BEE95B7B64C054AFE71A8F8850409C16BEE9D67964C0CC7BE71ADD8650403AAD68944A7864C001663D70C685504096CF6894C67564C00C8292C5078550409A16BEE9566B64C0C4C692C53F8650409B16BEE9D66A64C09A27E81AF9855040C827BEE9BC6964C052AFE71A0F8550403AAD68942A6964C0B25F92C5DB8450407E256994E46364C0DCE2E71A81845040B80B69944B6164C06A59E71A118550409B16BEE9066064C0C638E81A9F85504096CF6894D65E64C06416E81A73865040FFC66894535E64C0CCC692C59F865040301FBEE9A95B64C000663D70468650401675BEE9175964C0B9AA3D70BE8650408D41BEE9455864C0CCC692C51F875040264ABEE9785864C004663D70A686504050146994BE5664C09427E81A79855040321FBEE9D95564C09C6AE71A778450406030BEE9BF5564C0C238E81A5F835040D1B56894ED5564C0DEE2E71A01835040F538BEE9125664C0BC38E81A9F825040806CBEE9245664C0B4AA3D701E8250409A16BEE9165664C003F4E71A67815040E51C6994E15564C06016E81A93805040244ABEE9A85564C01B5BE81A6B805040545BBEE96E5564C0FE653D70A68050409A16BEE9365564C09A6AE71AF78050403BAD68942A5564C05D883D7052815040F638BEE9225564C0289EE71AE981504000C76894F35464C0976AE71A7782504067BE6894705464C09E6AE71AB782504000C76894935164C0249EE71A49835040F4F16894425064C0F28CE71AE3835040C927BEE99C4F64C0FC653D7006845040806CBEE9644F64C0185BE81A2B845040F738BEE9324F64C054AFE71A6F845040D6FCBDE9FD4E64C02AE992C58B845040D2B56894BD4E64C0FC1A92C5438450406030BEE96F4E64C072A492C593835040F638BEE9424E64C004663D7046835040F838BEE9124E64C008F4E71A278350405DE96894AF4D64C00CF4E71A078350408AFA6894D54C64C070A492C5738250403BAD68946A4C64C00CF4E71A47825040A4A46894174B64C08CDC3C7056825040B70B6994CB4964C09E6AE71AB7825040254ABEE9B84664C090DC3C7096845040D6FCBDE9BD4564C0B25F92C5DB845040CA27BEE94C3D64C09E6AE71AB7825040D7FCBDE9DD3D64C0AA433D709A825040D2B568945D3E64C06816E81A338250407D256994443F64C09A6AE71AF78050402FD86894B93E64C0AED1E71ADB805040EC63BEE9A13D64C0ACD1E71A9B8150405F30BEE90F3D64C003F4E71A67815040BD52BEE9BB3C64C0209EE71AC980504097CF6894C63C64C06416E81A33805040F638BEE9123D64C0249EE71AA97F5040806CBEE9843D64C0830B93C5377F50409C16BEE9A63C64C05C3D92C5AF7E504098CF6894763B64C02AE992C58B7E5040F838BEE9423A64C0C47BE71ABD7E50404E1469945E3964C0830B93C5377F50404E1469945E3964C0BEAA3D709E7F5040D7FCBDE91D3B64C0C87BE71A7D805040D2B56894AD3A64C06B59E71A91815040A3A46894273A64C026E992C58B8250406ABE6894903964C0E0E2E71A6183504050146994EE3864C0FC653D70068450406C05BEE9E03764C060883D7092845040A4A46894573764C0EC49E81A058550408F41BEE9453764C048213D708E855040B07DBEE99A3764C0148292C5A78550406D05BEE9203964C0B25F92C5DB8450406D05BEE9203964C0986AE71A57855040C927BEE96C3864C08F27E81AD9855040D8FCBDE9ED3564C0BC38E81ADF885040F4F16894523564C0B75F92C5DB895040040EBEE9133564C0E8FE3C70628A504000C76894B33464C03805E81ACD8B5040B60B69946B3464C0B2D1E71A7B8C5040C4E06894FC3364C0001B92C5C38C50401875BEE9C73364C030BA3C700A8D50409C16BEE9E63264C0F68CE71A438F5040A3A46894B73264C0B65F92C5FB8F5040D3FCBDE98D3264C03305E81A4D905040A5A46894473264C0F48CE71A839050405CE968949F3164C0C47BE71ABD90504069BE6894303064C09027E81AD99150408E41BEE9852B64C0CE7BE71A9D9150407E256994A42B64C053AFE71A6F9150409041BEE9F52B64C004F4E71AC7905040F838BEE9422A64C002663D70E68E5040545BBEE98E2964C03C05E81A8D8E5040826CBEE9942764C0168292C5478E50405F30BEE99F2564C03C05E81A8D8E5040D5FCBDE91D2464C0A8D1E71ABB8F5040E61C6994612364C003663D7006905040050EBEE9C32264C03805E81A6D8F504050146994AE2264C0138292C5C78E5040E41C6994D12264C0A8433D70FA8D504098CF6894262364C0AED1E71A5B8D504020036994A82364C0BAAA3D703E8D50406C05BEE9902364C0DCE2E71AA18C5040C3E068946C2364C05A883D70128C504039AD68943A2364C048213D708E8B5040BA52BEE9FB2264C04A213D700E8B50409A16BEE9562364C0C87BE71A9D8A5040F738BEE9922364C0B0D1E71A1B8A5040525BBEE99E2364C00CF4E71A87895040B80B69946B2364C0BC38E81ADF885040EA63BEE9F12364C048213D706E885040E963BEE9912464C04C213D704E8850401875BEE9D72564C0EC49E81A658850401875BEE9D72564C07FC0E71AF587504000C76894332564C09C6AE71A97875040F2F16894722464C0F08CE71A83875040D3B56894AD2364C00C8292C5A7875040BA52BEE9FB2264C07FC0E71AF58750402FD86894792264C0BC38E81A5F885040AE7DBEE92A2264C0CA7BE71ADD885040B952BEE9AB2164C0F049E81A258A5040806CBEE9C42064C038BA3C70CA8B50405BE968948F2064C0C638E81A5F8C504098CF6894262064C0C37BE71ADD8E5040A4A46894E71F64C03805E81A6D8F50406C05BEE9702064C0F48CE71AC390504098CF6894D62164C0BB38E81A3F925040D1B568946D2264C0249EE71A299350407E256994042364C0EC49E81A65945040040EBEE9A32364C04C213D704E9550401975BEE9572464C096DC3C70F69550407C256994542864C0D8E2E71AA1975040E963BEE9E12964C0168292C5E79750402CD86894F92A64C0F0FE3C7082985040B90B69948B2B64C0F449E81AA598504021036994982D64C0205BE81A8B985040A5A46894573064C09C6AE71A179A5040040EBEE9D33764C072A492C5F3995040234ABEE9383864C030BA3C70CA9950404E1469945E3964C0F449E81AA59850407C256994043A64C0DEE2E71A61985040D2B56894FD3B64C01E5BE81A2B9850406ABE6894F03C64C0C038E81A5F975040234ABEE9683D64C0249EE71A099650402DD86894393D64C0279EE71AE99450408AFA6894353C64C090DC3C70B69450408E41BEE9953C64C0B85F92C53B945040816CBEE9643C64C084C0E71AD59350405AE96894FF3B64C01C5BE81A6B9350406ABE6894C03B64C024E992C5EB9250408BFA6894D53B64C0E0E2E71A0192504068BE6894303C64C0185BE81A6B9150404F146994AE3C64C052AFE71A4F9150404E1469942E3D64C09027E81AD991504020036994683D64C0239EE71A699250409A16BEE9963D64C094DC3C701693504098CF6894B63D64C03E05E81ACD935040EB63BEE9C13D64C0B8AA3D707E94504022036994E83D64C0583D92C5EF9450403CAD68943A3E64C0289EE71A299550409A16BEE9863E64C0148292C587955040C4E068949C3E64C01A5BE81A6B96504020036994583E64C084C0E71A759750404D146994BE3C64C024E992C52B9A50404E1469945E3C64C00DF4E71A079B50401875BEE9073C64C030BA3C702A9C5040C827BEE9CC3B64C094DC3C70769D50406ABE6894C03B64C03705E81ACD9E5040D3B568946D3C64C05C3D92C58FA150409C16BEE9D63D64C0B0D1E71A9BA35040B07DBEE98A4264C0F0FE3C70E2A75040244ABEE9384564C05C883D70B2AB50409A16BEE9B64664C0F08CE71A43AD50409B16BEE9764864C0DEE2E71A41AE5040234ABEE9184E64C0F449E81AC5AE5040E61C6994114F64C0FC1A92C543AF5040E963BEE9814F64C0C238E81A9FAF50401A75BEE9D74F64C004F4E71AC7AF50408BFA6894255064C0C47BE71AFDAF5040C827BEE97C5064C0EC49E81A85B0504022036994A85064C003F4E71A07B150409C16BEE9B65064C0B2D1E71AFBB1504000C76894D35064C01A5BE81A8BB250401675BEE9475164C0D8E2E71A81B35040C827BEE96C5264C01F9EE71A29B550403BAD6894CA5264C072A492C513B6504021036994585364C09827E81AD9B55040F2F16894025464C0E8FE3C7022B750402FD86894795464C0F049E81AC5B8504067BE6894705464C06616E81A93B9504068BE6894005364C0F249E81AA5BA50409A16BEE9765264C07E0B93C5D7BA5040FFC66894A35064C038BA3C70EABA5040806CBEE9845064C0B2D1E71A1BBB5040501469947E5064C0F0FE3C7062BB5040C827BEE93C5064C09727E81A19BC504000C76894135064C05C3D92C5AFBC5040264ABEE9D84F64C0ACD1E71A3BBD504000C76894834F64C0946AE71A77BD5040E61C6994214F64C0FA8CE71A43BD5040A2A46894D74E64C0ECFE3C70C2BC5040D0B568944D4E64C0F449E81A85BB5040244ABEE9584D64C034BA3C700ABB50403CAD68944A4C64C06916E81AD3BB504021036994484B64C05E883D70F2BC50401875BEE9774A64C0946AE71A77BD50405E30BEE9CF4964C0C47BE71AFDBC5040D2B568941D4964C09627E81AF9BB5040BC52BEE9BB4664C0F68CE71AA3B7504050146994DE4364C09C6AE71A97B350407B256994044364C09C6AE71AD7B250404E1469940E4164C058883D7052B25040321FBEE9894064C0B2D1E71AFBB150403CAD68947A4064C04C213D706EB150406C05BEE9B04164C024E992C50BAF5040C4E068946C4264C060883D7032AD50402F1FBEE9A94264C06BA492C5F3AB50408AFA6894954264C0EF8CE71AA3AA5040C6E068941C4264C024E992C5CBA95040C4E068947C4064C07CC0E71A95A850408AFA6894D53F64C026E992C5CBA750402ED86894493D64C0209EE71AA9A35040D6FCBDE9DD3B64C04EAFE71A0FA250401775BEE9473464C0543D92C54F9D5040D6FCBDE96D3364C03405E81A0D9D5040FFC66894E32D64C0B45F92C5FB9D5040B07DBEE96A2C64C03705E81ACD9E50406D05BEE9502B64C0205BE81A0B9F50403CAD6894DA2A64C007F4E71A479F504000C76894E32A64C03405E81AAD9F50407C256994042A64C03E05E81A0DA050402ED86894692864C0BC38E81ADFA15040311FBEE9992764C024E992C54BA25040244ABEE9882664C09027E81A79A2504068BE6894302664C04CAFE71A4FA250401875BEE9F72464C0C87BE71A3DA0504039AD68948A2464C0CCC692C5DF9F504000C76894F32164C0CC7BE71A1D9F5040060EBEE9132164C03C05E81A6D9E5040331FBEE9791F64C058883D70329C5040C827BEE91C1964C0840B93C5F7975040D7FCBDE97D1864C07EC0E71AB5975040D2B568947D1664C01E5BE81A2B9850406130BEE9BF1364C0EC49E81AC5975040D6FCBDE96D0E64C06316E81A3399504022036994F80764C0C238E81ABF9950406030BEE94F0764C0C438E81A5F9A5040B07DBEE9EA0664C06216E81AB39B504096CF6894E60664C03405E81ACD9C5040D7FCBDE90D0764C0860B93C5979F504000C76894030764C03605E81A0DA25040B80B6994FB0764C054AFE71AEFA35040301FBEE9690A64C080C0E71AB5A650407D256994440A64C020E992C5CBA65040AF7DBEE9FA0964C03C05E81A0DA75040A4A46894C70964C0A4433D701AA750402BD86894290A64C07CC0E71A95A8504097CF6894960964C06016E81AF3A85040C4E068949C0864C058883D70F2A85040B07DBEE9CA0764C072A492C553A95040C6E06894CC0864C0F049E81AE5A95040C4E068942C0A64C084C0E71AF5A95040A4A46894570B64C0ED49E81A45A950402CD86894B90B64C06BA492C593A750408CFA6894B50C64C01D5BE81A4BA85040525BBEE91E0E64C068A492C5B3A85040020EBEE9830F64C0B2D1E71A9BA85040030EBEE9731064C026E992C5CBA75040EB63BEE9B11064C0168292C507A75040030EBEE9D31064C00C8292C567A65040F638BEE9121164C0B85F92C5FBA55040A3A46894A71164C084C0E71AD5A55040D5FCBDE94D1464C0F049E81A45A6504020036994581664C09227E81A39A7504020036994081A64C0C038E81A5FAA50406C05BEE9301C64C0289EE71A09AB5040030EBEE9E32164C09327E81AB9A950403CAD68945A2464C09327E81AB9A95040D1B568947D2564C0BCAA3D703EA950406030BEE97F2664C0FE1A92C503A85040A4A46894872664C0D8E2E71AC1A750401775BEE9772664C0986AE71AF7A650406030BEE97F2664C080C0E71AB5A65040E963BEE9C12664C0C87BE71A7DA650403AAD68946A2764C0EBFE3C7062A65040A4A46894972764C0F049E81A45A650405AE96894AF2764C0B05F92C59BA550408D41BEE9952764C06216E81A13A550407C256994842764C00C8292C587A450408E41BEE9B52764C0820B93C5D7A35040040EBEE9B32864C0CCC692C5BFA25040331FBEE9092A64C0EEFE3C7042A250401875BEE9A72C64C024E992C54BA25040D4FCBDE9BD2D64C0860B93C5B7A25040B60B69944B2E64C03405E81ACDA25040254ABEE9682F64C0205BE81A2BA250403AAD6894DA2F64C09A27E81A59A250409A16BEE9963064C084C0E71A35A350406E05BEE9003264C0C4C692C53FA450402FD86894193264C08CDC3C70F6A45040B80B69947B3164C0F049E81A45A65040F638BEE9223364C0F049E81A85A650403AAD6894CA3464C09227E81A39A75040254ABEE9C83B64C070A492C533AD5040C827BEE9DC3C64C024E992C50BAF50408AFA6894E53B64C0F48CE71A43B050406ABE6894C03B64C0EC49E81A85B05040F4F16894D23B64C06416E81A33B150408AFA6894353C64C01A5BE81A8BB250407C256994543C64C0D8E2E71AC1B35040D4B568942D3C64C0EC49E81A25B450404E1469944E3B64C06859E71A71B45040D4FCBDE93D3A64C0A8433D709AB55040AE7DBEE99A3964C0F81A92C5A3B65040F838BEE9A23964C01E5BE81A6BB75040C927BEE9DC3964C0209EE71A49B85040D6FCBDE9CD3964C06616E81A93B95040CA27BEE93C3964C080C0E71A75BA5040D4B568947D3764C06CA492C513BB5040CA27BEE9EC3664C0108292C527BC504067BE6894203764C0A8433D705ABC5040A4A46894373764C04CAFE71A8FBC504097CF6894463764C004F4E71AC7BC5040E81C6994613764C004F4E71A07BD5040C927BEE92C3564C0F349E81AA5BD50405BE968941F3464C06416E81AB3BD5040D6FCBDE9DD3164C05A3D92C54FBD50408E41BEE9953064C0B45F92C57BBD504096CF6894F62F64C004663D7026BE50404E146994CE3064C072A492C573BF5040BA52BEE96B3164C02A9EE71AA9BF5040D2B56894DD3264C06E59E71A91BF50405BE968944F3364C0C438E81ADFBF50409A16BEE9B63364C0C8C692C57FC05040040EBEE9333464C050AFE71AEFC0504068BE6894003664C0CAC692C5DFC15040301FBEE9493664C0CAC692C5DFC150407F6CBEE9843664C06859E71AB1C15040331FBEE9A93664C0E0E2E71A61C15040AE7DBEE9BA3664C08CDC3C7016C15040311FBEE9B93664C090DC3C70F6C050405AE968942F3764C06816E81AF3C050406130BEE9AF3764C0B2D1E71A1BC15040C5E068942C3864C0B05F92C57BC150408BFA6894953864C0C77BE71A1DC250403AAD68947A3964C0A8433D701AC350402CD86894B93A64C0EC49E81A85C350406030BEE9AF3F64C006663D7026C350406030BEE9EF4764C090DC3C70F6C050405AE968943F4864C07259E71A51C15040050EBEE9434864C0AFD1E71A1BC25040C727BEE92C4864C04C213D70EEC250401975BEE9274864C0F08CE71A63C35040AE7DBEE97A4864C06C59E71AF1C35040545BBEE9CE4864C09D6AE71A57C450402DD86894394964C0229EE71A89C45040B70B6994CB4964C0BC38E81A7FC450406C05BEE9804964C094DC3C7036C35040E963BEE9D14964C044213D708EC25040040EBEE9034A64C0001B92C5E3C1504068BE6894604964C06C59E71A91C0504000C76894034A64C0C8C692C53FC05040A3A46894C74B64C06C59E71A91C050405CE96894EF4D64C03405E81A6DBF5040525BBEE99E4E64C004F4E71AA7BF504067BE6894F04E64C0021B92C523C0504096CF6894F64E64C0ACD1E71A9BC05040244ABEE9B84D64C07CC0E71AB5C3504067BE6894A04D64C04FAFE71A0FC450403CAD6894FA4C64C058883D7092C45040D0B568945D4C64C0209EE71AC9C550401875BEE9574B64C0860B93C577C850405CE96894CF4A64C0289EE71A49C95040A4A46894B74A64C0168292C5A7C950401675BEE9E74A64C0830B93C537CA50408E41BEE9854B64C0946AE71AB7CA5040331FBEE9694C64C03805E81ACDCA50406D05BEE9504D64C09027E81A99CA50409C16BEE9F64D64C0830B93C537CA50408CFA6894C54C64C0C47BE71A3DCA504088FA6894454C64C0C8C692C5DFC950405DE96894FF4B64C0209EE71AE9C850404E1469947E4C64C03405E81A8DC85040C4E068948C4F64C01E5BE81AEBC35040E61C6994E15164C00CF4E71A47C15040F638BEE9925264C090DC3C70F6C05040D2B568943D5564C00CF4E71A07C15040341FBEE9A95564C0205BE81A2BC150409A16BEE9165664C06859E71A71C1504020036994085664C0205BE81AABC150406030BEE9FF5564C0E0E2E71AE1C15040FEC66894F35564C09727E81A19C250402DD86894D95564C0B0D1E71A5BC25040A4A46894775764C0C8C692C51FC35040EA63BEE9715C64C0CCC692C5BFC250406C05BEE9105E64C07FC0E71A15C350408F41BEE9755E64C090DC3C70D6C250404F146994FE5D64C0CAC692C5DFC150408C41BEE9555D64C07CC0E71A55C15040F738BEE9D25B64C06816E81AF3C05040EA63BEE9215B64C06C59E71A91C05040264ABEE9F85B64C0966AE71A57C05040D1B568945D6264C0FE653D7046C25040D4FCBDE98D6464C006663D70A6C35040B07DBEE9FA6C64C0A8D1E71ADBC45040BB52BEE9DB6D64C07059E71A71C5504097CF6894067664C0ACD1E71A9BC65040F838BEE9327764C0BC38E81A1FC750406030BEE97F7864C084C0E71AF5C850408F41BEE9C57864C0195BE81A8BCB50406030BEE9BF7864C06759E71A71CE50403AAD68942A7964C0C4C692C53FD15040BC52BEE95B7964C0C038E81A7FD25040BD52BEE9EB7964C06016E81A73D55040D5FCBDE95D7A64C06C59E71AB1D650408AFA6894C57E64C038BA3C70EADF5040C5E068947C8164C067A492C513E45040264ABEE9D88464C0108292C5A7E750408C41BEE9458E64C050AFE71A6FED5040F838BEE9029164C03805E81A0DF050406D05BEE9209364C020E992C58BF15040E51C6994319664C0FC653D70C6F450405DE968943F9764C0269EE71A69F550409A16BEE9869864C0EF8CE71AA3F55040525BBEE9BE9864C0EF8CE71AA3F550408C41BEE9759864C0840B93C5B7F45040D2B56894ED9764C024E992C54BF45040FDC66894739764C0AED1E71AFBF350403AAD6894FA9664C06016E81A73F350404D146994EE9764C07CC0E71AD5F350408E41BEE9A59964C0168292C5A7F550407C256994649B64C0C538E81A5FF65040311FBEE9B9A164C0966AE71AB7FB5040F2F1689472A764C09927E81AD9FF5040D0B56894FDAD64C0AED1E71ADB0351409A16BEE9D6B364C0EFFE3C70E2055140B70B69949BB864C0996AE71AD7065140F638BEE9B2BD64C0001B92C5C3085140B80B6994CBBF64C06F59E71AB10A5140D4FCBDE9DDC064C0583D92C56F0C5140BC52BEE92BC264C0C87BE71ADD0D5140050EBEE983C264C0168292C5670E51405BE968944FC364C0A0433D705A0F514095CF689496C664C056AFE71ACF105140D5FCBDE97DC964C03805E81A2D1351402FD8689499D464C03805E81A0D16514098CF689446D964C0BA5F92C5BB1551407C25699454DA64C0C87BE71A7D165140A5A4689487DA64C0C87BE71A7D1651403CAD6894FAD964C0EF8CE71A031751407C25699424D364C0B7AA3D701E1A5140AE7DBEE93AD064C06A59E71A111B5140BC52BEE93BCE64C0F649E81AE51A51406E05BEE970D064C038BA3C708A1A5140F3F1689402D764C0021B92C5E3175140254ABEE9E8D764C0D8E2E71A41175140050EBEE943D564C0C87BE71A7D16514039AD68948AD164C09A6AE71AF7165140D1B568948DCE64C00CF4E71A871951405DE96894AFCD64C0205BE81A6B195140C4E068940CCC64C03805E81AAD18514067BE689450CC64C030BA3C706A19514039AD68942ACD64C0B0D1E71ADB1951402CD8689499CD64C094DC3C70761A5140F4F16894D2CA64C09827E81A9919514089FA689415CA64C0B55F92C5FB1951409A16BEE9A6CA64C020E992C56B1A51403AAD68943ACB64C01E5BE81AEB1B5140321FBEE9D9CB64C08CDC3C70361C51406D05BEE990CA64C0225BE81AEB1D5140E61C699411CA64C0249EE71AC91E51406030BEE99FC964C055AFE71A2F205140C927BEE9CCC964C0269EE71A6921514067BE689430C964C00BF4E71A67225140545BBEE94EC864C0FA1A92C543235140D5FCBDE9ADC764C0C47BE71A1D2451407C25699464C764C0CA7BE71A1D2551406C05BEE970C764C06416E81A93255140C827BEE99CC764C094DC3C70F6255140D5FCBDE9ADC764C0B35F92C5BB26514098CF689496C764C03B05E81A6D2751406C05BEE900C764C0AED1E71A5B295140E71C699461C764C02A9EE71AE9295140E61C699451C764C054AFE71A4F2A5140C6E068940CC764C049213D70AE2A5140D5FCBDE9CDC664C0F249E81A252B51405CE968949FC664C086C0E71AF52B51405F30BEE98FC664C07C0B93C5972C514095CF689496C664C0B45F92C5FB2D5140C5E068947CC664C0F38CE71A632F5140C4E068944CC664C0B6AA3D709E305140FFC6689433C664C002663D70E63151404E1469945EC664C06516E81A73335140B60B69944BC764C0CCC692C55F36514000C7689493C764C0CC7BE71AFD3751405CE968941FC764C06859E71AB1385140D2B56894BDC264C03405E81A0D3951403BAD68944AC064C0B2D1E71ADB375140244ABEE908BA64C0239EE71A493851408AFA689445B564C0021B92C5233751404F1469944EAA64C07C0B93C517385140244ABEE968A164C030BA3C706A385140D5FCBDE94D9964C0F98CE71A833A51408E41BEE9158B64C0B1D1E71A7B3B51402DD86894398864C094DC3C70963C514001C76894738564C0185BE81A0B3D5140E71C6994E18264C008F4E71AA73E5140D1B56894DD7E64C06616E81A33405140C827BEE9EC7D64C028E992C5CB405140D6FCBDE90D7C64C09827E81A79425140B80B69944B7A64C05C3D92C50F435140BD52BEE9EB7364C0DEE2E71AA14751401875BEE9276964C00CF4E71AE7535140264ABEE9786864C00CF4E71AE75451406030BEE93F6664C06016E81A935A5140331FBEE9A96564C058883D70525B5140BA52BEE9FB6464C04CAFE71AEF5A5140D4FCBDE9AD6764C0F88CE71A035551401675BEE9B76864C0946AE71A775351401675BEE9B76864C07059E71A11535140F638BEE9C26764C0BB38E81A7F535140BA52BEE9FB6464C0CEC692C5FF565140264ABEE9386564C0583D92C56F57514068BE6894906464C0FC1A92C50358514096CF6894066464C084C0E71AF5585140C4E06894DC6364C0F88CE71A035A51407C256994546464C04CAFE71AEF5A5140AE7DBEE9EA6364C0185BE81A8B5B514020036994D86364C030BA3C700A5C514022036994E86364C0F649E81A855C51407E256994E46364C06CA492C5135D51409A16BEE9A66364C0946AE71AD75D5140321FBEE9696364C0FF1A92C5635E5140BC52BEE95B6364C084C0E71AF55E5140C5E06894AC6364C0C47BE71ABD5F51402ED86894A96264C06759E71A11605140040EBEE9436264C048213D704E615140A5A46894376264C0EC49E81AA56251404E1469943E6264C004663D7046635140F3F16894126264C07CC0E71A95635140BB52BEE92B6264C004663D70466451407C256994646264C0F48CE71A03655140826CBEE9946264C094DC3C707665514068BE6894006364C02AE992C5CB6551407D256994C46464C0C038E81A5F6651407D256994C46464C0F249E81AC5665140BD52BEE9BB6264C0BC38E81AFF6651409B16BEE9B66164C0FB1A92C56367514068BE6894D06064C084C0E71A156851405F30BEE91F6164C0820B93C5776851406030BEE91F6264C0021B92C563695140D1B568940D6164C04CAFE71A4F6A5140806CBEE9546164C096DC3C70766A51406030BEE91F6264C0FA1A92C5236B5140CFB568948D6164C0B45F92C5FB6B5140D5FCBDE97D5F64C0F08CE71AA36B5140BA52BEE99B5E64C0021B92C5036C5140A5A46894075E64C0F049E81A856D51407D256994A45E64C020E992C54B6E51403AAD6894CA5F64C09C6AE71A976E514068BE6894D06064C0ECFE3C70A26E51402FD86894996064C0B05F92C5BB6F5140BA52BEE92B6064C06216E81A3370514068BE6894A05F64C0583D92C56F7051406E05BEE9105F64C0B85F92C5DB705140D5FCBDE94D5F64C024E992C54B7151407D256994645E64C0986AE71A97725140F638BEE9525964C0C97BE71A9D765140B60B69943B5864C03405E81ACD7751408AFA6894C55664C0C77BE71A5D78514068BE6894705564C0F049E81A057A51401A75BEE9F75264C0F449E81A457C514088FA6894355164C0A8D1E71A3B7D5140D0B568945D5064C0FC653D70867E5140331FBEE9A94F64C0CC7BE71A1D80514098CF6894464F64C0185BE81A8B815140BC52BEE96B4F64C0820B93C5F781514096CF6894B64F64C01C5BE81A4B8351407E256994C44E64C07059E71AD1835140AE7DBEE98A4B64C0583D92C5AF835140A4A46894A74B64C06A16E81A13845140EA63BEE9E14B64C090DC3C70168551405DE96894FF4B64C0A4433D707A8551401675BEE9E74A64C034BA3C70EA855140060EBEE9434B64C0543D92C5EF8651402ED86894494A64C0EC49E81A25885140040EBEE9D34764C09827E81AD9895140D0B568949D4664C06A16E81A538A5140E51C6994614664C0EC49E81A858A5140A5A46894374664C084C0E71AF58A51401675BEE9174664C0F549E81A658B514022036994F84564C09027E81A998B514022036994784564C06859E71AD18B5140545BBEE9FE4364C0E0E2E71A018D51404F1469942E4364C0BCAA3D701E8E51406C05BEE9B04164C0B2D1E71A9B8F51403CAD68947A4064C0C4C692C5BF915140D2B568940D4064C0A4433D70FA915140C4E068949C3E64C0CAC692C57F935140B90B6994FB3C64C0F649E81A85945140A4A46894273C64C0225BE81AAB94514068BE6894503B64C0CCC692C55F9451408AFA6894653B64C0F38CE71A23945140D1B568948D3B64C0CAC692C57F9351406C05BEE9E03A64C092DC3C7076935140264ABEE9A83A64C0CAC692C57F935140264ABEE9A83A64C0583D92C50F9351407F6CBEE9E43A64C0E0E2E71A01935140D1B568948D3B64C096DC3C709692514020036994283764C0986AE71A97915140E963BEE9813664C0D8E2E71AE190514020036994783764C0F449E81A0590514089FA6894853B64C044213D708E905140C827BEE9DC3C64C06E59E71A719051408E41BEE9C53B64C0138292C5878F5140501469944E3964C0F249E81A658F514096CF6894463864C06A59E71AB18E51406D05BEE9403964C038BA3C70AA8E51407C256994A43A64C0158292C5478E51406D05BEE9803B64C056AFE71A8F8D51408AFA6894E53A64C0F0FE3C70828C5140F4F16894B23B64C0A4433D707A8B5140244ABEE9C83C64C054AFE71A6F8B5140A3A46894474064C0573D92C58F8C51406E05BEE9D04064C0F0FE3C70828C51408E41BEE9454164C0B2D1E71A3B8C5140D6FCBDE91D4264C0ACD1E71A7B8B51408AFA6894954264C05E883D70328B5140806CBEE9E44364C06A16E81A538A5140806CBEE9E44364C09827E81AD9895140AE7DBEE9AA3B64C06816E81AD38A5140FEC66894233B64C0C8C692C51F8B51409041BEE9053A64C0205BE81A4B8C5140C827BEE92C3964C008F4E71AC78C5140E963BEE9813664C0F0FE3C70828C5140B70B69940B3764C0DCE2E71AE18C5140D5FCBDE94D3764C05C883D70F28C5140545BBEE99E3764C05C883D70F28C514096CF6894563764C03E05E81ACD8D5140D2B56894CD3664C09C6AE71A578E5140501469942E3664C0C47BE71A9D8E5140EA63BEE9A13564C06A59E71AB18E51409041BEE9553564C0A4433D70DA8E5140B80B69943B3564C09027E81A398F51403AAD68942A3564C0229EE71AA98F51403BAD6894FA3464C0DCE2E71A019051409C16BEE9963464C0F48CE71A43905140254ABEE9383464C0001B92C563905140F638BEE9F22A64C0543D92C58F905140D2B56894BD2664C0966AE71AB7915140816CBEE9242264C0FC653D7026945140C4E06894CC2064C0CCC692C55F945140C4E06894CC2064C0A8433D70FA9351407C256994042164C0A8433D70FA9351407C256994042164C0CAC692C57F9351406C05BEE9502064C0B0D1E71A7B9351408BFA6894651E64C096DC3C7096925140B80B69949B1E64C0205BE81A4B9351409A16BEE9461F64C058883D7012945140CA27BEE97C1F64C054AFE71ACF9451409A16BEE9A61E64C026E992C54B9551403AAD68948A1B64C0A0433D703A96514000C76894E31364C0B8AA3D707E9B5140E41C6994311364C00CF4E71A479C514089FA6894351564C00CF4E71AC79B514001C76894A31664C06616E81AD39A5140E61C6994011A64C0128292C5C7985140C827BEE9BC1864C07C0B93C5F79951404F1469940E1664C00CF4E71AC79B5140D4FCBDE95D0E64C096DC3C70569F5140B07DBEE9EA0664C04FAFE71A0FA5514096CF6894060664C092DC3C7036A65140F738BEE9820564C09A6AE71AB7A65140254ABEE9F80464C04E213D70CEA65140B80B69945B0564C0249EE71A29A65140B80B69941B0564C0DEE2E71AA1A551406E05BEE9900464C0C3C692C53FA55140030EBEE9130464C04FAFE71A0FA55140B80B69944B0364C002663D7006A551401675BEE9370164C04CAFE71AEFA551404F1469944EFE63C09827E81A39A65140030EBEE9B3FD63C04CAFE71AEFA551407C25699494FD63C0946AE71A37A551402DD86894B9FD63C0D8E2E71A61A4514089FA689405FE63C02FBA3C70AAA35140B90B69945BFE63C04CAFE71A4FA35140B90B69945BFE63C0C238E81ADFA2514098CF689426FE63C0209EE71AE9A251406E05BEE980FD63C0C238E81ADFA25140010EBEE933FE63C00C8292C567A151403AAD68945A0064C03C05E81A4DA1514096CF6894560164C06A16E81A73A05140545BBEE95E0264C0BC38E81A3F9F5140C3E06894AC0364C0001B92C5C39E51409041BEE9750664C0E2E2E71A819E514097CF6894660564C060883D70D29D51408D41BEE9050464C06816E81AD39D5140311FBEE959FE63C0F449E81AA59F51406E05BEE980FD63C096DC3C70569F51409C16BEE906FE63C0840B93C5779E5140CA27BEE92CFF63C056AFE71A2F9D51406130BEE9AFFF63C00CF4E71A479C5140E863BEE9710064C03E05E81A4D9A5140F738BEE9F20064C0209EE71A899951401875BEE9A70164C09A27E81A39995140D2B56894CD0164C0BC38E81AFF975140A4A46894A70364C004663D70069651409C16BEE9460464C054AFE71ACF945140F4F16894120364C06C59E71A91945140301FBEE9490064C0E8FE3C702297514000C7689403FF63C0C038E81ADF975140311FBEE959FE63C084C0E71AB5975140C6E06894DCFD63C05E3D92C52F975140F638BEE982FD63C0B0D1E71A5B965140050EBEE943FD63C0C038E81A3F95514097CF689456FD63C0EC49E81A2595514001C7689483FD63C0C038E81AFF945140C4E06894ACFD63C0C038E81ABF945140030EBEE9B3FD63C0CCC692C55F945140D2B568949DFD63C04CAFE71A2F9451409B16BEE976FD63C04D213D700E94514000C7689453FD63C0C87BE71AFD935140050EBEE943FD63C0A8433D70FA935140050EBEE923FD63C092DC3C70769351405BE96894FFFC63C0F349E81A259351406030BEE9EFFC63C03805E81ACD925140BD52BEE90BFD63C06B59E71A31925140AE7DBEE9BAFB63C0FC653D70C6915140301FBEE9A9FA63C0E0E2E71A21905140F838BEE9B2F963C09427E81A198E5140D2B56894ADF863C0F0FE3C70828C514020036994A8F863C0289EE71A698E5140C927BEE92CF963C0CC7BE71A3D8F51405F30BEE9EFF963C03405E81ACD8F5140816CBEE9A4FA63C0D8E2E71AE19051401875BEE9C7FA63C0FA8CE71A8391514096CF6894D6FA63C038BA3C704A925140A2A46894D7FA63C0C77BE71ABD935140341FBEE909FB63C056AFE71A0F9451406D05BEE930FB63C0DCE2E71A61945140C4E068944CFB63C054AFE71ACF945140A5A4689437FB63C03705E81A2D955140D6FCBDE9FDFA63C09027E81A7995514096CF6894D6FA63C06416E81AD39551408E41BEE9F5FA63C0C87BE71A5D965140B60B69942BFC63C0225BE81A0B9851407B25699464FC63C0128292C5C798514068BE689460FC63C008F4E71A879951403BAD68943AFC63C094DC3C70169A51404E1469940EFC63C09C6AE71A979A51402DD86894F9FB63C05A3D92C52F9B51404E146994AEFB63C0205BE81A6B9C51406E05BEE910FB63C0860B93C5379D5140040EBEE983FA63C0269EE71A299E5140C727BEE96CFA63C0583D92C5CF9F5140D5FCBDE9EDF963C03E05E81A0DA05140040EBEE993F963C06A16E81AF39F5140C4E068944CF763C0C4C692C53F9E51408C41BEE9B5F663C07059E71A119E5140D2B568946DF563C004F4E71A479E5140C827BEE9FCF263C000663D70869F5140501469944EF163C06A16E81AF39F51402CD86894D9EF63C0F08CE71A03A151406C05BEE960EF63C0B8AA3D70FEA0514069BE689460EE63C056AFE71A0FA051402DD86894E9ED63C0583D92C5CF9F51407E25699464ED63C0B0D1E71AFB9F51405CE96894BFEB63C0E2E2E71A21A15140BC52BEE96BEA63C0C47BE71A5DA15140264ABEE9C8E963C03805E81AADA15140F638BEE952E963C0583D92C56FA251402FD8689479ED63C006663D7086A15140C6E06894FCF063C06416E81A13A251408AFA689415F263C0CEC692C5FFA151406ABE689430F263C0840B93C5D7A151407C25699444F263C0185BE81A8BA1514069BE689450F263C0D8E2E71A41A15140EA63BEE951F263C0E2E2E71A21A15140525BBEE98EF263C06DA492C513A15140F4F1689432F463C0ACD1E71A1BA151407D25699484F463C037BA3C70EAA05140F638BEE9D2F463C06A16E81A73A05140D5FCBDE93DF563C0E0E2E71A01A051406E05BEE9D0F563C028E992C5CB9F5140254ABEE9E8F663C0583D92C5CF9F5140545BBEE96EF763C0BAAA3D70FE9F5140E61C6994C1F763C0F049E81A45A0514089FA689475F863C0E2E2E71A21A15140254ABEE968FA63C03405E81ACDA251408E41BEE9F5FA63C003F4E71A87A351404F1469942EFB63C0C47BE71AFDA35140D5FCBDE95DFB63C0FA8CE71A83A45140D4FCBDE97DFB63C080C0E71A15A551402FD8689489FB63C05C883D70B2A55140AF7DBEE9AAFB63C09C6AE71A57A65140C4E06894FCFB63C057883D7092A6514068BE689460FC63C06F59E71AB1A65140816CBEE954FE63C0A8D1E71ABBA85140545BBEE92E0064C09E6AE71AF7A851408E41BEE9150264C03805E81A2DA851409B16BEE9D60364C04E213D70CEA65140301FBEE9E90364C054AFE71A0FA75140C6E06894FC0364C003F4E71A67A75140030EBEE9130464C06CA492C513A851407C256994140364C0108292C527A95140A3A4689437FD63C09C6AE71AD7AC5140AE7DBEE96AFC63C00C8292C527AD5140F2F16894C2FA63C06C59E71A51AD5140C927BEE9FCF963C020E992C5CBAD51407E25699414FB63C020E992C5CBAD5140826CBEE904FA63C07CC0E71A95AE51405F30BEE9AFF663C0CEC692C5DFB15140C827BEE9DCF563C020E992C50BB35140E41C699461F563C0F049E81A85B35140F2F16894A2F463C09C6AE71AD7B35140D2B568940DF363C07DC0E71A15B451405CE968948FF163C0F0FE3C7022B551406E05BEE9A0F063C0CC7BE71A7DB551405CE968942FED63C0001B92C5E3B55140040EBEE943EC63C068A492C533B65140806CBEE914EB63C0E2E2E71A41B751409C16BEE926E563C0F88CE71AC3B851402CD8689499E663C06416E81A73B7514000C7689433EA63C0AAD1E71A1BB75140EA63BEE9F1EB63C0FA1A92C523B65140FEC6689493E563C000663D70A6B651409A16BEE9F6E463C030BA3C702AB651405AE968947FE463C06CA492C5D3B45140D2B56894CDE563C0F649E81A45B451403BAD6894FAE963C0C038E81AFFB351408E41BEE925ED63C0F349E81A65B251404E1469945EEE63C07CC0E71A35B251404E1469945EEE63C0B1D1E71ABBB15140BA52BEE98BEC63C0B05F92C51BB151407E256994F4EB63C06616E81AB3B05140B07DBEE96AEB63C00EF4E71AA7B051402ED86894D9EA63C052AFE71A0FB151401A75BEE947EA63C0B35F92C53BB15140D7FCBDE9BDE963C0CCC692C57FB05140BD52BEE9EBE963C0DCE2E71A41B05140F838BEE932EA63C0DCE2E71AC1AF51408AFA689465EA63C092DC3C7096AF5140E71C6994A1E963C0239EE71A89AE5140F638BEE9E2E763C08FDC3C7036AD51404F1469941EE763C09E6AE71A17AC5140BC52BEE9EBE663C0C87BE71A7DAC51401875BEE9A7E863C0108292C5A7AF5140D6FCBDE9EDE863C06C59E71AF1B05140501469948EE763C080C0E71A55B15140806CBEE9D4E363C0F649E81AE5B05140BB52BEE9ABDF63C0B1D1E71ABBB15140C4E068941CE063C000663D7006B35140545BBEE9EEE063C008F4E71A87B35140AD7DBEE9BAE263C0F049E81A85B35140545BBEE9EEE163C0E8FE3C7042B451407C256994E4D663C0F449E81AA5B251406C05BEE9D0CA63C0A4433D705AB451404E1469940ECE63C0C47BE71A9DB4514097CF6894C6CF63C0F449E81A45B551406C05BEE9C0D063C070A492C593B65140B90B69945BCF63C0B85F92C59BB651408E41BEE975CC63C03405E81A8DB551406ABE689460C163C04CAFE71A8FB55140CFB56894ADBB63C06CA492C573B75140D0B568948DB563C054AFE71A0FBB5140AE7DBEE9FAB363C0AA433D709ABB5140BA52BEE9FBB263C044213D708EBC51404E1469947EB263C0FC653D70C6BC5140010EBEE9E3B163C0EF8CE71AE3BC51408F41BEE965A763C06859E71A91C451405BE96894CFA263C020E992C5EBC951406D05BEE9D0A063C0D8E2E71A01CD514097CF6894269A63C0ACD1E71A9BD35140E41C6994D19563C06816E81A93D651406C05BEE9F09263C0800B93C557D75140A2A46894B79063C07059E71AF1D851407C256994F48F63C0021B92C5E3D9514098CF6894168F63C002663D7066DA5140331FBEE9E98D63C0F81A92C503DA5140,-6.7%,-12,168,56,112,Alaska,true
11,0106000020E610000004000000010300000001000000160000004B947CD3115D54C048084A161FBC3E401B837CD38B5D54C0B0914A16CFB93E40F4FF267E065E54C0EF14A06BB4BA3E40D1C77CD3A35E54C009029F6B54CE3E407AA57CD3975E54C0A80EF5C0E9D43E40D1C77CD3A35E54C0016C48160FD73E405222277ED25E54C0A1914A164FD93E40D0C77CD3635F54C050BD9E6B3CDE3E40D4C77CD3835F54C0A059A06BCCDF3E40AAF97BD3DB5E54C05F8B9F6B84E73E404206D228B15B54C019029F6B54F03E40E4E3D128255B54C0AF469F6B6CF83E40735AD128B55A54C0AF469F6B6CF83E404306D228B15A54C05F6CA16B2CF33E4075A57CD3D75A54C0272E4C16DFEC3E40FC4AD228695B54C0271B4B167FE43E40E4E3D128A55B54C037EF9D6BF4DC3E40C0AB277E425C54C0AF914A16CFD33E40BE607CD33F5D54C057BD9E6BBCCC3E40DC0A7CD3415D54C05772F3C0D9C83E40944F7CD3D95C54C080789E6B24C13E404B947CD3115D54C048084A161FBC3E4001030000000100000012000000DEAE63FEBF5054C0B02B155E46633F40E8149923E55154C0DF6C04E7AE623F40CC0F0930A35254C0E7306BF22C653F40CCF43773385354C01FE27A2359693F400481283A805254C04FA83FF3A0703F40AA8E83155E5154C05FCF73463F763F405249F2C97B5054C0D0F109FA877D3F4024871120155054C068A240072C813F40D4F6F7CB074F54C00066B6C6C8863F40A40AE444214E54C0876FBC2416873F403A932A75FC4C54C00805021ECA883F4056CD8470D64B54C0EF4995ACB3873F403E9646782D4B54C0A0A21EDA7B853F4044500C8EE74B54C0785EC24DB8803F4096DC665FB64C54C0C06EF097AC7B3F401AE94781AD4D54C0D0AD12781C743F40E8DA2AFD0E4F54C08F2FAD830C6F3F40DEAE63FEBF5054C0B02B155E46633F40010300000001000000110000005A272F11934954C08FB1029F46963F40F862DA2A4D4A54C058D252793B913F40C439A45D344B54C0FFC50C780C923F40AA9701C2E24A54C00F8665E03E963F408A19759BBA4A54C0E81C90C699993F40EF75A53A644B54C040D3DC5BA89C3F40309FAEAC7C4B54C0C1836D1FCDA23F400DC0300D014B54C0D0ECF0EE00A73F40A6F22888464A54C0F89E8CDD7DAB3F4068EDA3718D4954C02F364753C6B23F40003FE757BB4854C0AF6279F7CAB23F405A74638E664854C09FBF960667B13F406FDE5DCC8E4854C0E805DD8E0BAE3F4028F442B38B4854C09884AB4D2DA83F4030278AEB334854C0001E78ADEBA03F4020FB69A1D94854C0F000F454B79C3F405A272F11934954C08FB1029F46963F40010300000001000000AC020000465494E669C754C0E89917EF5C7E4140601261B3C6C754C09BE37E55DB7C414072538B4003C854C0E0AB40832F7B4140C762CA5D9BC854C088583498A37841403C8A6C8422CA54C07840D18EB4774140C4329388B4CB54C0B0FEC2A328754140D455233910CD54C0F4C7E15F0973414002FA12DB1FCE54C07FA03F3982714140CA9915F35ACF54C0C881C1FE5170414030B0C71965D054C0900B7D55536E41405698C71909D154C06B10B088866C4140786660B3E6D154C0909F7E553F6B4140ADDA94E6DDD254C04826E4BB316A41408ACF93E6B9D354C0C8A27D55F76841403A862E8043D454C068EFE3BB216741406042FB4C84D454C03091B18866664140B720FB4C9CD454C0081118EF7465414006C461B3A8D454C0504AB1886A64414010A8FA4CC6D454C034367E55636341405C31FA4C0CD554C06FE0E3BB59624140DB6261B322D654C040B47D55136041401CDDFA4CC0D654C0DC33E3BBAD5A4140CA7560B3BAD454C0E447B088FA5541402ACAC719E3CE54C01853B288B24F4140066D94E6BDCC54C0BC33B288F24D4140F90CC71939CB54C080507D55AB4E414042112E80C5CA54C0B8937D557B4E4140409560B3A6CA54C090D9E4BBC14C41401CF3FA4C2CCA54C0D0A0B0882A4B414074FDFA4CCAC754C0D8AFE5BBF1484140F88CFA4C70C654C0508417EFEC454140344C61B316C554C09020B1887E4441407A8EFB4C0EC454C008F5E2BB7941414058E293E605C354C03360E3BB913F4140E666C819F5C054C0505A17EFA83D41401AFA94E6EFBD54C0E440E3BBD13D4140D88D2D8091B954C0E440E3BBD13D4140CDD394E6DDB654C0C849B188F63A4140B8AA60B326B654C0C7624922A0374140665794E6D5B554C0888317EF20344140BC4794E6F5B454C0409E7E55FF2F4140F4ED94E661B454C0E0904A22DC2E414052E3C719BBB054C028EEE2BB792541404ACAFA4C38B054C0541BE4BB912241402C02C71901AF54C084F818EFA4174140688E60B3A6AE54C088324A22DC154140C47D61B336AE54C0F41F4B2250154140C4DD60B32AAD54C0E46517EFE8124140F8562D80A7AB54C0282EE4BBDD114140AC6461B3D6AA54C0D00FE5BBA910414086CA60B31EAA54C0D8647E55330F41401C4660B3A0A954C01035B088EA0D41405A7093E6EDA854C060E5E4BB590A4140289394E667A854C0C89C4B2290084140EFB593E6E5A654C0A8DE7C5537074140A7EDFA4C5CA654C014514A22D0054140264AC819B5A554C0E04E4B223C0241408EE82D80FDA454C05894492238FF4040F27E2E8083A454C0B82A17EFE0FB4040129BFA4CB8A354C068267F5573FA40405ADD94E6AFA254C0E4C04922D0F940402660FA4C6AA154C0E4C04922D0F94040F4DAFA4C62A054C00472E4BB11F840400103C719459F54C0082017EF5CF54040ABDB61B3C29D54C0EF28E5BB81F240409F9D60B3C69B54C017797D5547F0404076F22D80B59954C0B02E4B22B0EE4040CE4A2D803F9754C028AD18EFFCEB4040C49094E68B9454C0106AE5BB55E84040FD7160B3729154C04490E3BB91E340406682C719B38F54C0A051E3BB11E0404006662D80E78E54C00C93E4BB59DA4040CEE02D80DF8D54C007F87D55CFD740400E48FA4C548D54C08CA17D55F3D4404086F461B3688C54C074BE4B223CD14040CC3E61B3228B54C0F0564A22E8CE40401332FB4CA28954C04C3DE3BB2DCD40406483FB4C428854C06C94E3BB21CC4040B4192E80378554C08C497E559BCA4040D6E6F94CF48354C0C4A07E558FC94040AEC960B39E8254C090F3B088AEC7404026482E80EB7F54C018F9E3BBF9C1404022F8C7199B7E54C018CBE4BBE5BF4040BE45C819097C54C060AB4C22F0BC4040E45F94E6217B54C0FC48B188B2BA4040DCC3FA4C967B54C0B8CD4A22F4B74040FCBDFA4C427B54C0E8507E554BB74040B4EC60B3B67A54C0B02D7E5553B5404048DD93E6B97B54C0D86B18EF0CB540406005C719E57B54C020C87E5517B440403A5AFB4C1C7B54C0E791B188F6B040402A9394E6057C54C0A410B28826B040404E1AC819957B54C04FAB17EF3CAE4040F00CC819DD7854C0782BB088C6A84040C68E93E6537854C0449E4B22FCA740406CEDC719177854C0E844E4BB9DA84040F013C719C77754C0FF8CE5BB31A94040D8F393E6117754C08817E6BB09A9404038D12D80517654C068D44A228CA8404086D594E6DD7554C0B7134B2224A8404086D594E6DD7554C02C7517EF44A7404078B52D80BD7654C0F8B7492278A6404068DA93E6A57554C0B8B3B1880AA54040381761B3327554C04038B08892A340408D0062B3687554C0847AE5BB3DA24040A2AD2D804D7654C0949BB0883AA1404056E693E6537554C0EC807E555B9E40408E0761B3527454C01B66B188C29C40405495C7192B7354C088607D550F9C404080C094E6BB7154C0145C4A22E89B4040C2A32E804F7154C02060E5BBD99A4040687D94E6F17054C0A0954B22C09540409E592D809F7054C098EDE3BBF593404054BCFA4C586E54C0FC3A18EFC8904040949A94E6B56854C038DC4922E08C4040E4B5FA4C186654C03F53E5BB598A40403682C7194B6454C018454B2264874040A75B61B3526354C00C13B1885E864040F2B8C619ED6154C08887AF88FA854040B62261B3206154C0A4DD49221085404006C561B3546054C068C84B22E48240406AD693E6B95F54C0289FE4BB4980404036F9F94C805F54C08C2A18EF1C7E40405F6E2D80076054C0C00B7D55BB79404057FD60B3066054C0945EE5BB4177404080ECFA4C485F54C0132D7E552B764040CC22C719015C54C048C2E4BB8D6C40405F2BFA4C665B54C0D418E4BB016940401CC5C719355B54C0FCEF4A22046740405C7B94E6215B54C048904922206540406E8AFA4CCA5A54C074CC17EF286340407A90FA4C245A54C05C4217EF5C614040C23D61B3C25954C0B0A218EF585F4040E06394E6D15954C01789B1889E5D4040424BFA4C385A54C06379B188BE5C40400429C719615A54C05C4616EF2C5B4040634460B3A05A54C0A06AE4BBD9594040FEDAC719755A54C03F0B4C224059404046ABFB4C285A54C08408B288E6584040A6ABC719C95954C008224B2210584040E2012E80795954C088A2E4BB0D574040923BFA4C585954C06CD44B2230564040A4BC2D808D5954C0040FE6BBBD534040A81E94E6E55954C05C8C17EFC4514040D3BE94E6F75954C0406218EFE84F4040923BFA4C585954C034407E55CF4D40400E5B2E80895854C05C8E18EF744C4040CBE894E6615754C05883B0880E4B40401069C719115654C0C8FEE3BBF5494040A82194E6255454C0A028E6BB554940406000FB4C925354C070747E55D7484040BEC32D800B5354C074CE18EF24484040B60361B3925254C0302FB288564740404EAA2D809F5154C00C1118EF744540404D51C819495154C0840FE4BBF944404046E860B30A5154C010E5E4BB11454040AA5A2E80A34F54C04838E5BBCD434040ACF8C7194B4F54C0C336B18852434040B0092E800F4F54C0F76AE4BB31424040604CFB4CF04E54C0689018EFBC404040F80D95E69B4E54C0480719EF7C3F4040268161B3BE4D54C0DB477F55F33E40409A74C719D94C54C0E0FCE3BB053E40404871FA4C904C54C08840E4BBE13B4040ECD894E6A14C54C0A86BE3BBE137404011EB94E6AF4A54C0B45018EF642D4040A71794E6B94954C0936D7E55D72C40405075C719F14854C05428B288562B404082C4C7196F4854C088E916EF1C29404032FE93E64D4854C074B5B0886626404008FD2D806F4854C0071D7F55E3244040C2C293E6ED4854C060924B2228234040043BC819234954C09C854A22F4214040CC45C7193F4954C0C0B017EF84204040043BC819234954C03B297E552F1D404038EC93E6454954C0CFD6B0886E1C4040957294E6DF4954C0081BE4BB391A4040FA1A61B3024A54C0E8BC16EFD0184040E4F22D80D74954C07765E3BBF917404086742D80B34854C0F8EA4A22E4134040E23861B3B84854C0F0DC7E557F13404096DB94E6D54854C0A4E116EFF8124040A4162E80E14854C01C6B16EF4412404086742D80B34854C000DF17EF581140405EF794E6694854C0B0D2E4BBC1104040BF5FC719BD4754C0D002B388161040403A542E80634754C0B030E4BB990F40403E7D94E6894554C008C6B088B60B4040309AFA4CFC4454C0E48FB188260B40406872FB4C484154C0C49C17EFAC0B40409C5E94E6E13F54C0E48FB188260B40402A3BC8194F3D54C048AF7E550F094040D0F160B3DC3C54C05C64E3BB210840406D902D80733C54C06BB016EF5C0640408C1F61B3783B54C0903FE5BB15054040C2FA93E64D3A54C0B0BDB288560440406AB9C719053954C00FE34B22280440405EF91579FA3854C0E84B791C2E04404018837CD3EB3854C0C0107BE0E4034040DC0A7CD3413854C0C4107BE064034040C2607CD35F3754C0C4107BE064034040071C7CD3473654C038B6D035D6024040AAF97BD37B3554C0B87A248B5F004040FAFF267EA63654C0E07E49166FFB3F404206D228D13954C0F0019F6B54F33F40FE4AD228693A54C0DF14A06BB4F43F408EC1D128D93A54C01198F5C019F73F40954F7CD3193B54C04772F3C059F93F40BE607CD31F3B54C0C8914A164FFA3F40A8B67CD3FD3B54C0F0AAF6C0F9F93F4032EA7CD36F3C54C030D09F6B1CF83F406889277EB63C54C0D8339E6B0CF63F408CC1D128193D54C0D027A16B14F53F40AE44277EBE3D54C0409EA06BE4F23F40D2C77CD3A33D54C077F548163FEE3F40E5E3D128C53C54C0A80EF5C0E9E93F40BE607CD31F3B54C0786CA16BACE83F405422277E523D54C010D09F6B1CE13F40BE607CD3BF3E54C0C0FBF3C089DD3F404E947CD3B13F54C0B0914A164FDD3F4040BB267ECE4054C070AA9D6BDCDF3F404206D228B14354C0B7659D6BC4E13F40061C7CD3C74454C0E07E49166FE33F40FFD87CD3294554C0A0FBF3C089E53F4042BB267E8E4554C078AA9D6B5CE83F40904F7CD3194654C02F1B4B167FEA3F402E9FD128ED4654C0CF27A16B94EA3F404006D228914754C078AA9D6B5CE83F40061C7CD3274754C0509EA06BE4E53F40924F7CD3D94554C0E06B48168FE23F40041C7CD3C74554C090A44B162FE03F40765AD128554854C0579EA06BE4DD3F40FAFF267E264954C078AA9D6BDCDA3F40A028D2289D4554C038EF9D6BF4D83F40A6B67CD33D4554C0DF6B48160FD83F400A1C7CD3E74354C0CF14A06BB4D33F40D4C77CD3E34254C0C1469F6BECD33F40352D7CD38D4254C0CF14A06BB4D33F401A837CD32B4354C0A0659D6B44D03F40F2717CD3E54354C0B0659D6BC4C93F408AC1D128D94554C030D09F6B1CC13F40CC7CD128C14654C058084A161FBE3F40AE44277E9E4754C000029F6BD4BC3F4078A57CD3F74A54C0B127A16B94BC3F4078A57CD3174D54C0C0914A16CFBD3F40DC0A7CD3A14E54C0AF659D6B44C13F40F0717CD3454F54C03072F3C059C33F40623E7CD3335054C08FA44B162FC53F402EEA7CD30F5154C058BD9E6BBCC53F40A6B67CD37D5154C0F8AAF6C0F9C33F409DDD267E3A5154C0CF7E49166FC03F40F1717CD3655054C0E0E8F2C0A9BE3F4042BB267E6E4E54C000029F6BD4BC3F4032EA7CD38F4C54C0D014A06BB4B73F40ABF97BD3BB4C54C0086C48160FB33F40362D7CD34D4F54C05FF54816BFA93F408A0750C31F5054C0902D771FADA53F4098C4C23E915054C087809034D1A13F40C4AB277E425354C050084A161F923F402D3AF5885E5454C0E081AA13C8903F408A17D599305554C058328C1E6C8D3F40FC2E91DD555554C097851F925D8B3F408A0C20197E5454C06700CF14BF853F40D6CC8AD6015554C057BFC68199803F401A2791ECED5454C05832CD5D937F3F40E111D320ED5454C010A3A2F64A7E3F408ADCE803EC5454C0703F7D317F7C3F40E07BBD30365554C06FD19CAB9C773F40AC2169B1605754C0B015505C19703F4072E763204A5754C067A5E5D5736A3F40588C07AF4B5654C030EFDACE8C633F40C7C66369745554C04F7D9A86ED5D3F40ECF09491D75454C0D0450C6153593F4016185D04845554C0199C8A0DC3573F405222277E725B54C010029F6B545A3F40944F7CD3D95C54C0C7FBF3C0895C3F40D2C77CD3235E54C028EF9D6B745F3F4075A57CD3B75E54C08059A06BCC5F3F40D4C77CD3835F54C051084A161F5E3F40D2C77CD3E35D54C0A0FBF3C009593F4018837CD34B5B54C058BD9E6B3C553F405622277E725854C04FAA9D6BDC523F402EEA7CD30F5654C0E1339E6B0C523F40C2AB277E025554C0EF14A06BB4503F40AE44277E3E5254C081789E6BA4493F40EE717CD3455154C050AA9D6B5C463F40DA0A7CD3215154C04FBD9E6B3C423F40623E7CD3935154C08059A06B4C3C3F4076A57CD3775254C0F76B48168F383F40332D7CD3AD5354C0271B4B16FF3A3F406789277EF65554C051F548163F2E3F40EE717CD3855754C0B7914A164F273F40663E7CD3B35854C05F21F6C049243F404306D228315A54C06F6CA16BAC243F40C2607CD3BF5A54C07F789E6B24263F4000D97CD3C95A54C037D09F6B1C293F4078A57CD3975A54C0E9339E6B0C353F405622277E125B54C02085F4C039383F40715AD128755C54C0381B4B167F373F40AAF97BD31B5D54C050BD9E6BBC343F4078A57CD3375D54C077F54816BF303F406889277EB65C54C0A8789E6BA4263F409CDD267E9A5C54C0381B4B167F213F40F94AD228E95C54C0D0AAF6C0F91D3F402EEA7CD32F5F54C0E014A06B34223F40ACF97BD3BB5F54C0A8914A164F203F40FAFF267E865F54C0F097F5C0191D3F405022277EB25D54C0C0659D6B441A3F4088C1D128395C54C018029F6BD4143F4000D97CD3895B54C0A059A06BCC123F40663E7CD3935B54C06FAA9D6BDC173F404A947CD3315B54C0B8914A16CF1A3F4060FB7CD3D55954C0E0339E6B0C1F3F404C947CD3F15954C0C0659D6B44183F40E4E3D128255B54C0800EF5C069063F4000D97CD3895B54C0800EF5C069063F409CDD267E5A5C54C02FEF9D6B740B3F40FA4AD228A95D54C051BD9E6B3C113F409C28D2283D5F54C0EFAAF6C0F9153F40A6B67CD3DD6054C0579EA06BE4173F405CFB7CD3F55F54C00F98F5C019133F40C2AB277E625D54C0609EA06BE4093F40944F7CD3D95C54C02FD09F6B9C053F40AEF97BD33B5D54C0BF469F6B6C003F409E28D2283D5E54C0B8469F6BECFD3E40C2AB277E426154C09F469F6BECFB3E40C2AB277E426154C0788B9F6B04FA3E40643E7CD3F35F54C060AA9D6BDCF73E40603E7CD3B35D54C0A0469F6BECF73E40944F7CD3D95C54C0886CA16BACF63E406489277E965D54C068AA9D6BDCF23E402A9FD1288D5F54C0A0789E6B24EB3E40643E7CD3F35F54C00F029F6BD4E73E40F2717CD3056054C09F0EF5C069E63E40603E7CD3536054C077AA9D6BDCE23E40C6AB277E626054C0DF14A06BB4E13E40342D7CD32D6054C03185F4C039DF3E4078A57CD3D75F54C048BD9E6BBCDD3E4032EA7CD38F5F54C0608B9F6B04DC3E40D4C77CD3835F54C0A859A06BCCD83E40964F7CD3196054C0A859A06BCCD93E40C1607CD3BF6054C017EF9D6B74DA3E403A2D7CD36D6154C030BD9E6BBCDA3E40C4AB277E226254C0CF339E6B8CDA3E40C4AB277E226254C0A859A06BCCD83E407AA57CD3376154C0301B4B167FD73E40643E7CD3F36054C0101B4B16FFD43E406A89277EF66054C07721F6C0C9D13E40A6B67CD3DD6054C009029F6B54CE3E40372D7CD38D6054C0F0AAF6C0F9CB3E400A67277ECA5F54C0C0FBF3C089C83E40D4C77CD3835F54C0B027A16B94C53E400E67277EAA5F54C0A759A06BCCBF3E40705AD128156054C0C07E49166FB93E40CAEE267E006054C0E0C9F4C051B63E40EA9D0876006054C038F0187750B63E40249494E6756054C05735CA77B3B63E40E63E94E69D6154C0E0479344D8B73E40902B2E80B16354C09F3EFAAAA6B53E40C42BFA4C4C6454C0511561119DB53E403601C719F36654C0801ACB77ABB73E408CE0C719976754C020E7F9AAA6B83E40FC87FA4C766854C06F5231DE99BA3E40EEEB60B3EA6854C008815F11A5BA3E403439C819956954C0371A954438BA3E40E223FB4C446A54C0C73530DE79BA3E40B0AAFA4C5C6D54C09F76FCAAB6BD3E40D12A94E64D6E54C060922BDE29BF3E40804BFA4CF26E54C0171530DE89C03E40A0D393E6596F54C0A04F2CDED9C13E40B84AC719FD6F54C0B0BE954468C33E40B6AD2E80E17054C0E1212EDE39C43E404C192E80777154C030AFC8776BC43E40F61FC819097254C067ED621125C43E400C222E80DF7754C00F3B63116DCC3E406E5894E6BD7854C02890944420CE3E406086C7193D7954C0C88FCA777BCF3E40429E93E62D7A54C057DB2CDE89D13E406B6CC719BF7A54C0D0BF30DEF9D13E40105094E63B7B54C0CF1D954418D23E40236761B3A27B54C020846211FDD13E4038A360B3867C54C060F3954430D23E4019EFFA4C047D54C09877CA7713D23E40F069C719917D54C00053C97783D13E40334CC719E17D54C0D76DC8778BD03E40E0262E800F7E54C0585F2EDE89CF3E4086DEC719297E54C0AF5C2FDEE9CD3E40F03495E6277E54C0FF5B32DE61CD3E40A404FB4C387E54C02906F9AAA6CB3E40F9712E804F7E54C00F00C8776BCA3E40037994E6817E54C070EDFEAA46C93E4016A3C719C97E54C07F12CA777BC83E40C21A2E805B7F54C0F015FCAA16C83E40F18F61B3E27F54C067EA964450C83E4044B660B38C8054C07700924410C93E4013DAC719DF8054C038516111BDC83E4018E12D80118154C0EFEE2EDEC9C73E40622D94E62F8154C0D05AC77723C53E40542F94E64B8154C080E56211B5C33E40C81BFB4C7C8154C06F9DC67773C23E40683E61B33C8254C0A0F19444D8BF3E4096512E806B8254C01F486211DDBE3E40F47F2D808B8254C01005FDAAC6BD3E409737C719A58254C070EC964498BC3E4060A2C719B18254C02FF8FEAA16BA3E400051FB4C7C8254C06FA32EDEC9B33E407A6894E6838254C0B0992CDE41B23E4001C4C719998254C041FC9444A8B03E40DE3C94E6098354C03F2DFEAACEAA3E402CE0FA4C168354C0185E641165A93E40D8C2C619078354C0D05B2FDE69A63E408094C719E78254C098B6974460A43E409290C719AF8254C04749FDAA06A23E40727BFA4C648254C098C92DDEB99F3E406E4E61B3288154C077F0CA77B3993E4023BC60B3E08054C0CFC06111BD973E408004C719C78054C0E060FBAA86963E403E822D80B38054C088015F11F5933E402AF093E6B98054C020C4631105913E4084B52D80978154C01F03FCAA06803E4054C794E6E18254C07F6E954408703E403387FA4C0C8354C0DF939644B06C3E409E36C819158354C070F6FEAA166B3E401C8294E6F58254C0F8876211BD633E40FA752D80F98254C04F8563111D623E4010DD94E61B8354C050682FDE19603E40EABFC7195B8354C06029F9AA265F3E4098D7C719B18354C0088FC977835E3E40064A2D80738554C06768C677DB5C3E4088D32E80BB8554C060862DDED95C3E40246860B30C8654C0EF3DC777F35C3E401D6361B33E8754C070F05F113D5E3E40B20294E6AD8754C040172DDE895E3E40D29F61B3A28A54C080B7C677535D3E405C5B60B3408B54C0809E9644805D3E40464EFA4CB48B54C018BDFAAA065E3E405E4BFB4C088C54C0CFD3FDAACE5E3E4006372D80478C54C0BF0C9744B85F3E40CAB394E6A38C54C0509E9344F0613E40D29893E6998D54C098C39644686B3E40BE82C719BF8D54C06084C977B36D3E404C2CFA4CC08D54C0C8D79744006F3E408C3BC719B78D54C06917CB777B703E40741394E68B8D54C0E8A163117D733E40602895E63B8D54C01814C97733773E40B6C0FA4C2A8D54C0F0B9C97793783E40D15294E6238D54C0B0DCFBAAEE793E409AB493E62D8D54C01849FAAA0E7B3E40E921C719458D54C0CFC6C777437C3E405881FA4C928D54C01FF464117D7E3E40DA01FB4CD88D54C0E8BA954420803E40A2882E805B8F54C047335F11F5863E406CFC94E6B58F54C0601A621105893E402DB794E6C98F54C04F3ACB771B8A3E4020CCFA4CC68F54C0F00C9744208B3E4025CAFA4CAA8F54C0376FC977138C3E40F89360B3668F54C0305F9344C08D3E40027894E6378F54C0B7A3FDAA668F3E408AB0FA4C388F54C0A196FCAA26903E40A27F2D80598F54C03F985F118D903E404643FA4CFE9154C05FAA2BDE29913E409E2DC819559454C0BFEC9344B8913E408C9D61B3549754C070B6F9AA6E923E40304F2E80F19A54C0CF3D964448933E4086FE93E61D9F54C03088FEAA46943E4062082E80CFA354C07830CB7763953E4011F9FA4CF8A854C0895463119D963E40342D94E68BAE54C010309544F0973E40FED12D807FB454C0211D964458993E40E8DB93E6C5BA54C0DF20FBAAD69A3E40D69E60B352C154C0D8ADCB77639C3E40FA3EC71919C854C0472DFCAAFE9D3E40028A2D800DCF54C007956211A59F3E40629BC71923D654C0E043C97753A13E40CA40FB4C4EDD54C0187B934408A33E4034362E8081E454C00F8F6111BDA43E400E792D80B1EB54C02785C87773A63E4060E3C719D1F254C027F8601125A83E401C8DC719D5F954C0C81E6411CDA93E40822094E6AF0055C05003FCAA6EAB3E40CCCA61B3560755C089FAC87703AD3E40805994E6BB0D55C06063954488AE3E40BE17C719D31355C091979644F8AF3E40E291FA4C901955C087BAC87753B13E4006662D80E71E55C0AFC6964498B23E402CDFFA4CCC2355C0387A9544C0B33E4020C2C719312855C020946111CDB43E405C7D2D800B2C55C0DFCCFAAAB6B53E4040BB93E64D2F55C0C81FCC777BB63E40B24061B3EC3155C0F0D762111DB73E4030732E80DB3355C0D96231DE91B73E4024D6FA4C0C3555C0E0479344D8B73E400CFFC719753555C070FF2CDEF1B73E4076B9C7197D3755C0582B31DE69B83E401CB760B30C3855C070632EDE19B83E405E3DC819E93A55C02F79641195C23E4040CF61B3DC3B55C050B863116DD33E4010FB2D80F13B55C079A0C6773BDE3E40AC642D806B3C55C06FF7621145E43E405C742D804B3D55C0708F62114DEA3E4094D4FA4CD63D55C0F8F4FCAA36EC3E40F12E2D80593E55C0D059CA77EBF33E4043E4FA4CB63E55C0E00FC877B3F63E408AE0C619193F55C0B074651115F83E40FCF060B3364055C0A1609444D0FA3E40DC2C94E67F4055C0D08B2FDEF1FB3E40B8822E808F4055C0A708CA772BFF3E40137294E66B4055C03F95FBAA06003F40AEFFFA4C3E4055C05079964420013F40840695E6D53F55C0D7162EDEB9023F402E1D94E69F3F55C080EBFBAAD6043F40447BFA4CC03F55C0BFC6631185073F405FA22E805B4055C02066FDAA360A3F40664A94E6294155C038AEC6773B163F40E4502E80B54255C0C8856211FD203F40B437C819754455C07814C67743293F400E7994E6BD4555C0B01D5F11752B3F40BABCC719774655C010ACC877C32E3F40926261B38E4655C0488CFBAACE323F406212FB4C384655C0888A31DEF93B3F4048F32D805B4655C0AFFBFAAA763E3F40C87C94E6EF4655C0276264117D433F40D1602D800D4755C04843CA7783453F4080892E80DB4655C069D1944420483F40FD102E800B4655C047A69544204C3F400E7994E6BD4555C0F8A29644684E3F40D05560B35A4555C01F98934408623F4057C294E6E74455C0D8E79544686B3F40A2F2C7198F4355C05F73FDAA86713F40F757FB4C304455C0DF9F2EDED9783F405858C719D14355C04027C877237E3F4038C7C7191B4355C080836511FD823F40C244C719B94255C0BFA3C8770B893F40604C60B3DA4255C098419344888C3F401AC4C6196D4355C050189644A0913F40A2F2C7198F4355C02FEEC9779B933F401C0A61B3964355C090CA9444989A3F40A42F61B3B64355C08029C877D39D3F405EA7C719494455C088BB9644A0A23F400F81FB4C7C4655C050AE2EDEF1AC3F40FA1C95E6014755C050EB5F113DB13F4028302E80C54855C0D858FBAABECD3F40847094E6354955C06F28FBAAEED23F40546E2D80CB4855C09FF52EDE61D83F40A89EC719BB4855C00870CA77FBD93F4018D2C719A54855C0383A2DDE39DB3F40CEE6C619534855C0D756974498DE3F40F8C4FA4CD04755C0A06B924428E73F407056FA4C924655C0400A954400F13F40C822C719C54455C0701D60110DFB3F40841395E6814455C010D7FBAA3EFC3F40BC0995E6F54355C068807D5507004040AE6CFA4CDE4355C0E09F18EF80004040C068FA4CA64355C080C3B088AE03404093C9FA4C204455C07C797F558B06404044E9FA4CEC4355C0E8FEB188760940405860C719474355C008C6B088B60B404016BB60B31E4355C04CE04A22600D40407AF060B3244355C0C8CEE4BB89104040FEB5FA4C084355C0C8BEE4BB9D114040140A95E6014255C0841417EFD01540400D0B94E6914155C0F8684B22FC164040F232FB4C224155C0287C7D5577174040262095E6474055C0806E7F55AF174040B4D9C719353F55C050AA17EF44184040F4A194E6293E55C0C0014B221C194040480561B3663D55C020C9E4BB151A40401CCF2D806B3E55C05CE27D55331B4040E080C719313E55C0B03DB188421C404076B6C7193D3D55C05F6F7D55AB1C4040C4ED60B3163C55C06FE8E4BBD51B4040E090FB4C883B55C0F83B18EF741C40406E9B2E80093B55C0242D7E55671D4040FAAEC719D93A55C0F09DAF88AE1E40405C462E80373B55C0DC29492248204040CE9BFA4CAA3A55C094357F55572040401A2494E6173A55C0788B7E55B3204040F2D12D80A53955C0684F4B22642140408A5F94E6773955C0CC27B0886E224040AA2EC719993955C0D7367D555F2340403A9A61B3E23955C008D5E2BBA12340405CA62D802B3A55C0A4AAE3BBB92340401802C8198F3A55C000A316EF2C254040AABDC6192D3B55C088EEE4BB09264040A171FA4C3A3E55C088C6492208294040325AC8197B3F55C00836B0881E2B4040F6D793E6B33F55C01CC1B188762D40406835FB4C503E55C030204A2204304040581D94E6A53E55C0185AE4BB7931404094CCFA4C603E55C0B830B088B63240401C892E80F53D55C0F4F3E4BB25344040804261B3DC3D55C0A8CC17EFCC354040B8532E80EF3D55C0142EB2887E374040088D93E6793E55C057107E5563394040D01261B3243F55C02BA017EF343B40402E1D94E69F3F55C098994B22343D4040708EC719EF3F55C0385BE4BB5141404066CD60B3324055C05C9F4A22F44240402AFC2D80EF4055C010E5E4BB11454040BA02FB4C584555C060137D55C34E40401A03C719F94455C0C8927E5573504040CA6061B3784555C05883B18876514040F82CFA4C3A4655C0F09E16EF50524040B68894E69D4655C0BC8DB0888653404051D7C619794655C0D8F5E4BBC9554040899894E6834655C050A57E5567574040B58094E6274755C0EC564922085A40405EF194E6874755C0C098B1887E5E404009962D800D4855C058BA7D55FB5F40402EB460B3A64855C0D860B1884A61404078ED60B3E44855C040734B2284624040CE3FC7195D4855C0971419EFBC634040D21BFB4CB84855C0CC71E5BB99644040723661B3024A55C098D216EFF4664040050CC719674A55C06C957D55C76740408A5694E6B74A55C0B0C87D55AB6840405C6FFA4CEC4A55C020D717EFAC694040403661B3FC4A55C0F813B188CE6A4040D249FA4CCC4A55C050BC4B227C6E40408AB061B3E24C55C0989BE3BBB5774040ACE7FA4CB64C55C0B80116EFE078404018BCFA4C3C4D55C0C0797D55E77D4040583E94E64F4D55C0E80719EFA47E4040861B2E80894D55C0E7E718EFCC8040405A0061B3E44D55C088A34A22488440404AB4C619614E55C01042B188FE88404068DBFA4CFC4E55C0D00BB388D68E40400CE494E6A94F55C0684E4B22B8954040F4A961B3765055C0A8E117EF8C9D404044B894E6295155C074AEB0883AA64040A811C8191D5255C0100F7E55ABAF4040AD4FC7191D5355C0607B4B22C4B94040E584C7191D5455C09C2F16EF6CC44040924D2E80435555C098F17D558FCF40400C1F94E6695655C0340F7E5513DB40403072FB4C685755C0EC1E17EF84E5404064B061B3B65855C04C3D7D55DBF24040B65D94E6E95955C0FC4F19EFF0FE4040924A2E80035B55C09C127E559B0A4140E2F760B3365C55C07C637E55031741408EC0C7195D5D55C0D8B3B088CE2241400A65FB4C905E55C080427D55532E414028EEFA4CD05F55C08804E5BB75394140D3B661B3F66055C028187E551F444140B2D02D80036255C008257D55374E4140B8E1FA4C106355C0B4854A22A8574140223B2E80036455C0E0B1B1885660414039252E80C36455C0A074E3BB29684140B45794E6696555C0287618EF0C6F4140BCC961B3F66555C0686F7F55E374414018B1C7195D6655C09C1FE4BB99794140BC6861B3766655C0F8ECE4BB357B4140B0DD2D80AF6655C0FCAE7D555F7D4140A98F2E80C36655C0BC6C7E551B7E41400EAC60B3DE5F55C070FD4A22E87D4140FCFF2D80D55755C070FD4A22E87D4140B35CFA4CCC4F55C0BC6C7E551B7E41401A7861B3C24755C0F8DBB1884E7E4140529CC719B93F55C0A4934B22687E41403AF094E6AF3755C0404BE5BB817E4140C05560B3A62F55C0404BE5BB817E41402571C7199D2755C0404BE5BB817E4140885DFB4CF02455C0404BE5BB817E41403E432E80692055C0404BE5BB817E4140188160B3661A55C0404BE5BB817E4140A8A960B3C61455C03F054B22587E4140C8DCFA4CF00F55C0FC9E7D55737E41402A6F61B3180B55C02427B2888E7E4140947294E6410655C0D0C0E4BBA97E414084AE2D806B0155C0805A17EFC47E41401EA961B394FC54C048D6E2BBE17E41408EAC94E6BDF754C070ED4A22FC7E4140388060B3E6F254C010A5E4BB157F4140D97A94E60FEE54C0480FB288327F4140427EC71939E954C0F819B1884E7F4140A4102E8061E454C0AF4217EF687F4140944CC7198BDF54C06C6B7D55837F4140FE4FFA4CB4DA54C098D54A22A07F41401812C819DDD554C0506F7D55BB7F4140D65660B306D154C070D94A22D87F4140EA182E802FCC54C038737D55F37F4140D1E3FA4C58C754C048FBB1880E8041405F3D2E8051C754C0D485B288E67F4140465494E669C754C0E89917EF5C7E4140,-31.8%,-493,"1,055",474,581,Georgia,true
20,0106000020E610000022000000010300000001000000090000008EC1D128F9B456C057BD9E6BBC0A3D405CB0D12813B556C00F98F5C0190A3D402EEA7CD38FB556C0E05F4B16970A3D40969A277EFCB556C001B7F3C0710B3D40745AD12815B656C0982DF3C0C10C3D403678277ED0B556C0D7E8F2C0A90D3D408AC1D12859B556C08FC34916070D3D4074A57CD317B556C078D64A16E70B3D408EC1D128F9B456C057BD9E6BBC0A3D40010300000001000000090000006CCC267E74B256C0B7659D6BC40B3D40D4C77CD323B356C0609EA06B640A3D40DA55277E44B356C0A10EF5C0690A3D405122277E32B356C068E94B16470B3D402B9FD1282DB356C0283A4916570C3D40F6FF267EE6B256C0708B9F6B040D3D407C33277E78B256C0B7914A16CF0D3D40AAB67CD33DB256C07740F4C0A10D3D406CCC267E74B256C0B7659D6BC40B3D40010300000001000000050000001A837CD34BB856C030084A161F0D3D404406D22891BA56C030084A161F0D3D40F0717CD365BC56C0E06B48168F0F3D40362D7CD3CDB956C097789E6BA40E3D401A837CD34BB856C030084A161F0D3D40010300000001000000140000006889277E36A956C0C827A16B14123D40CD7CD12801AA56C0A8A44B162F103D403FBB267E0EAB56C0D7E8F2C0A90E3D406689277EF6AF56C008E3A06B7C0A3D408CC1D128F9B056C008E3A06B7C0A3D4088C1D12819B156C0D0339E6B0C0C3D40AAF97BD35BAF56C0A0FBF3C0890D3D400C67277E0AAF56C070F54816BF0E3D40623E7CD3B3AD56C070F54816BF103D40653E7CD353AD56C070F54816BF103D40EB717CD325AD56C0B8914A16CF0F3D408EC1D12899AC56C0E0E8F2C0290F3D400A1C7CD3C7AB56C0D727A16B940F3D40382D7CD34DAB56C0B0A44B16AF103D40A8F97BD31BAB56C03F9EA06B64113D403A2D7CD30DAA56C028D09F6B1C113D40AEF97BD3BBA956C0E014A06B34113D40F6FF267E86A956C0AF659D6BC4113D40924F7CD319A956C0786CA16BAC123D406889277E36A956C0C827A16B14123D400103000000010000000A000000B044277E7E9A56C0C0469F6B6C0D3D40725AD128759A56C0E07E49166F0C3D40D4C77CD3E39A56C0E0AAF6C0790C3D40ACF97BD3BB9D56C09859A06BCC0E3D400867277ECAA056C0E0E8F2C029133D40623E7CD3B3A056C0F86B48168F143D405622277EF29C56C0AF914A16CF113D40382D7CD36D9B56C0606CA16BAC0F3D406989277EB69A56C0E814A06B340E3D40B044277E7E9A56C0C0469F6B6C0D3D40010300000001000000080000000E67277E2A9256C027D09F6B1C143D40382D7CD32D9656C06FAA9D6BDC0E3D40D4C77CD3639456C027D09F6B1C143D40D4C77CD3E39356C00198F5C019153D409E28D2285D9356C02FBD9E6BBC153D400967277ECA9256C0E0339E6B0C163D400E67277E2A9256C0808B9F6B04163D400E67277E2A9256C027D09F6B1C143D400103000000010000000D000000D27CD128219656C0282E4C165F1E3D409ADD267E7A9956C0D07E49166F1A3D40A6B67CD39D9956C059E94B16471B3D40D2C77CD3439956C02866F6C0E11B3D40FAFF267E469856C0878B9F6B841C3D40CE7CD128019756C0808B9F6B841E3D40643E7CD3D39656C090789E6B241F3D401C837CD3CB9656C029EF9D6B74203D40C2AB277EA29656C0C0DCF5C0B1213D40BE607CD33F9656C05053F5C001223D404649D128CF9556C00F98F5C019213D40623E7CD3B39556C0DF14A06BB41F3D40D27CD128219656C0282E4C165F1E3D40010300000001000000090000002C9FD128CD9C56C091A44B162F3C3D406889277EF69C56C03072F3C059393D40061C7CD3079D56C0B9469F6BEC3C3D402EEA7CD38F9C56C098789E6BA4423D402EEA7CD3CF9B56C0F014A06BB4433D40D6C77CD3C39B56C0C0914A164F413D402A9FD1282D9C56C0A00EF5C0693F3D4074A57CD3979C56C010E3A06BFC3D3D402C9FD128CD9C56C091A44B162F3C3D400103000000010000000C000000E7E3D128858156C0679EA06B64373D4062FB7CD3F58156C0679EA06B64373D40362D7CD38D8156C0D0339E6B0C3D3D40AEF97BD31B8056C0AF659D6BC43F3D40CE7CD128817E56C0AF659D6BC4413D40D27CD128A17D56C0FF2D4C165F453D40F8FF267E267D56C0FF2D4C165F453D40D27CD128A17D56C050084A169F433D40F8FF267E267D56C0102E4C16DF413D408CC1D128797E56C058BD9E6BBC3E3D4004D97CD3A98056C040BD9E6BBC3A3D40E7E3D128858156C0679EA06B64373D4001030000000100000008000000F8FF267E867A56C0C0469F6BEC483D408AC1D128797B56C0B0914A16CF463D4075A57CD3177C56C0E8AAF6C0F9463D40D0C77CD3C37B56C04772F3C0D9483D40DC0A7CD3617B56C0C1659D6BC4493D403EBB267E0E7B56C0E96B48160F4A3D404406D228717A56C08059A06B4C4A3D40F8FF267E867A56C0C0469F6BEC483D400103000000010000001100000041BB267E8E7856C03072F3C059533D40C8EE267E207856C05F21F6C0C9523D404606D228F17756C069E94B1647543D409EDD267EBA7756C00F3A491657533D402411277E8C7756C09F469F6BEC513D40A228D2289D7756C0A80EF5C069513D405122277E127856C017E3A06BFC503D403778277E307856C07F8B9F6B84503D4018837CD32B7856C010EF9D6B744F3D40D4C77CD3037856C04053F5C0014E3D40091C7CD3C77856C06F40F4C021503D40FC4AD228E97956C0C07E4916EF503D40299FD128CD7956C0D127A16B14523D401A837CD34B7956C0DF339E6B8C533D404206D228117956C010B7F3C0F1543D402EEA7CD3EF7856C0980EF5C0E9543D4041BB267E8E7856C03072F3C059533D400103000000010000000C0000002FEA7CD3AF4B56C040084A161F793D40DC0A7CD3014D56C00798F5C019783D405422277E324E56C02085F4C039783D40E4E3D128054C56C0E7AAF6C0F97A3D405322277E124B56C0B8659D6B447D3D40A8B67CD3BD4A56C038EF9D6BF4803D404206D228714A56C098789E6B24813D4076A57CD3574A56C0C0914A16CF803D40633E7CD3534A56C0D8E8F2C029803D40D0C77CD3434A56C070AA9D6B5C7F3D40D3C77CD3A34A56C010E3A06B7C7B3D402FEA7CD3AF4B56C040084A161F793D400103000000010000002E0000005322277EB28656C0800EF5C0E9823D40DD0A7CD3218656C0C727A16B94823D40ACF97BD33B8556C0409EA06BE4823D40FA4AD228E98356C0D8E8F2C029813D40372D7CD36D8356C057084A161F803D40C2AB277E228356C097789E6B247F3D40CC7CD128A18256C0B8914A164F7E3D402C9FD128ED8156C0876CA16BAC7D3D403EBB267E4E8156C0AF27A16B947C3D4042BB267EEE8056C0708B9F6B847A3D40041C7CD3278156C0D77E49166F793D404606D228D18156C0CF14A06BB4793D402E9FD128CD8156C0B1914A16CF783D40041C7CD3278156C00898F5C019763D406F5AD128958056C0A1789E6B24753D40AE44277E1E8056C0D0E8F2C0A9753D40F6FF267EE67F56C0C827A16B14763D40623E7CD3D37F56C09FA44B162F773D40944F7CD3B97F56C0CFAAF6C0F9763D401E837CD3AB7F56C01098F5C099753D402E9FD128AD7F56C04F9EA06BE4743D404206D228917F56C060AA9D6B5C753D40745AD128757F56C0D7E8F2C0A9743D4076A57CD3777F56C04F72F3C0D9723D40ACF97BD3BB7F56C0102E4C16DF713D403F06D228118056C0F097F5C019723D40DA0A7CD3018156C038D09F6B9C713D409E28D2285D8156C0B0659D6BC4723D4075A57CD3978156C00FEF9D6BF4743D40D0C77CD3038256C01198F5C099763D40C0AB277E828256C0679EA06BE4763D406589277ED68256C047084A161F763D404F22277E328356C047084A161F763D404006D228718356C0D0E8F2C0A9763D404006D228B18356C05872F3C059773D408EC1D128F98356C0E1339E6B0C793D402A9FD128ED8356C0806CA16B2C7A3D40D6C77CD3C38356C0182E4C165F7A3D40AAF97BD31B8456C0B0FBF3C0897A3D400A1C7CD3078556C07F8B9F6B047A3D40C6AB277EE28556C02085F4C039793D40D2C77CD3838656C02FEF9D6B747A3D40A6B67CD39D8756C0A0FBF3C0097F3D401C837CD3AB8756C08F0EF5C069813D40D2C77CD3438756C060F54816BF823D405322277EB28656C0800EF5C0E9823D4001030000000100000008000000924F7CD3D94556C04F084A161F863D403A2D7CD34D4656C050AA9D6B5C853D40FAFF267EA64356C0679EA06BE48F3D40DE0A7CD3814356C06821F6C049903D404A947CD3314356C090789E6BA4903D40725AD128754356C040BD9E6B3C8F3D40DA0A7CD3614556C0BFFBF3C089873D40924F7CD3D94556C04F084A161F863D4001030000000100000005000000AE44277EBE3F56C0E0339E6B8C9E3D40CA39D228E33F56C051AA9D6B5C9E3D40D4C77CD3034056C0980EF5C0E99E3D40A26BD128DB3F56C030BD9E6B3C9F3D40AE44277EBE3F56C0E0339E6B8C9E3D40010300000001000000050000009E28D2287D3F56C0BF27A16B949F3D40A9F97BD39B3F56C0383A4916D79E3D40A028D2289D3F56C0311B4B16FF9E3D40B6D2D128BF3F56C0AFDCF5C0319F3D409E28D2287D3F56C0BF27A16B949F3D4001030000000100000006000000CF7CD128013E56C0E0AAF6C079A33D40AAF97BD39B3E56C0F714A06BB4A13D4048947CD3B13E56C0708B9F6B04A23D405EFB7CD3153E56C07921F6C0C9A33D4097DD267EBA3D56C0BF339E6B8CA43D40CF7CD128013E56C0E0AAF6C079A33D4001030000000100000021000000735AD12855F356C010EF9D6B747D3D400A67277ECAF556C067AA9D6BDC7B3D4088C1D12879F956C050AA9D6B5C843D40C2607CD31FFA56C0A70EF5C069853D40051C7CD3C7FA56C0686CA16BAC873D402CEA7CD34F0157C00F98F5C099913D406889277E560257C0688B9F6B04953D40D4C77CD3430257C02F084A169F983D4004D97CD3C90057C030D09F6B1C9D3D404B947CD391FF56C0C9469F6B6C9E3D404606D22851FE56C05872F3C0D99E3D40B244277EBEFC56C0BF27A16B94A03D40C0AB277E62FC56C0606CA16BACA13D40ACF97BD3BBFB56C05072F3C0D9A43D4085C1D12879FB56C0D8E8F2C0A9A53D404E947CD3B1FA56C0B0469F6BECA53D40CE7CD12821F756C030084A161FA33D40A8B67CD31DF656C010029F6BD4A03D409EDD267E7AF456C0776CA16B2C9B3D403EBB267E8EF256C03085F4C039983D40924F7CD379F256C0876CA16BAC973D401A837CD38BF056C0F814A06B34963D4086C1D128F9EE56C0C0659D6BC4953D407AA57CD317EE56C0BF469F6BEC943D4047947CD3B1ED56C0202E4C16DF923D40FB4AD22849EE56C00798F5C0198F3D40A6B67CD39DF056C09FFBF3C0898A3D409ADD267E7AF156C0D77E4916EF873D404E947CD3D1F156C0DFE8F2C0A9833D40765AD128D5F156C098789E6B24803D408AC1D128F9F156C09859A06B4C7E3D400C67277E6AF256C0AF27A16B947D3D40735AD12855F356C010EF9D6B747D3D400103000000010000001300000098DD267E5A6056C0D9E8F2C029B13D402511277EAC6056C02F084A169FB03D401C837CD3AB6156C01798F5C019B13D402CEA7CD3EF6156C0086C48168FB13D40CE7CD128E16156C0AF469F6B6CB23D40041C7CD3E76156C08021F6C0C9B23D40C2AB277E026256C06FF548163FB33D40AD44277E1E6256C0D0E8F2C029B43D40008ED128076256C0401B4B167FB53D40BAD2D128BF6156C09F914A16CFB63D40A6B67CD31D6256C0806CA16BACB83D4075A57CD3D76156C04F72F3C0D9B83D40AAB67CD37D6156C06F6CA16B2CB83D40643E7CD3736156C0D0E8F2C029B53D40954F7CD3596156C018B7F3C0F1B33D4040BB267E0E6156C0B0659D6B44B33D40ACF97BD3BB6056C01F3A4916D7B23D40A228D2287D6056C01798F5C019B23D4098DD267E5A6056C0D9E8F2C029B13D4001030000000100000005000000944F7CD3393B56C01F2E4C16DFAE3D4060FB7CD3153C56C06FAA9D6B5CAC3D404206D228F13756C03F72F3C059BF3D4040BB267EEE3856C0B9A44B16AFB93D40944F7CD3393B56C01F2E4C16DFAE3D40010300000001000000120000009CDD267EDA5B56C0D014A06BB4C53D40041C7CD3A75B56C028EF9D6BF4C13D408EC1D128595B56C038EF9D6B74BE3D402C9FD1282D5C56C038D09F6B9CBF3D40C4AB277EA25C56C03F1B4B16FFC13D40623E7CD3F35C56C078AA9D6B5CC43D40944F7CD3595D56C0D97E49166FC53D40D90A7CD3E15D56C0DF14A06B34C43D40C6AB277E825E56C0489EA06B64BE3D40A9F97BD35B5F56C0A0FBF3C089BC3D40B044277E9E5F56C0172E4C165FC73D40F0717CD3655F56C0F014A06B34CB3D404D947CD3715E56C0786CA16B2CCE3D400A1C7CD3A75D56C0878B9F6B84CC3D40944F7CD3595D56C030084A169FCB3D40DA0A7CD3215D56C0886CA16BACCA3D40B044277E3E5C56C05FAA9D6BDCC83D409CDD267EDA5B56C0D014A06BB4C53D40010300000001000000090000007AA57CD3775556C09F469F6BECCF3D409CDD267E7A5356C0786CA16B2CCE3D400C67277ECA5256C047084A169FCE3D40F84AD228295256C048084A169FCF3D409E28D228BD5156C03F9EA06BE4CF3D4047947CD3B15156C0786CA16B2CCE3D409ADD267E9A5256C0D97E49166FC53D404E947CD3915556C0101B4B167FCE3D407AA57CD3775556C09F469F6BECCF3D4001030000000100000008000000964F7CD3B93E56C060E94B16C7CD3D409E28D228FD3E56C05FE94B16C7CA3D404406D228113F56C09859A06B4CCB3D4012F5D128EB3E56C05FF54816BFCF3D40D2C77CD3A33E56C0B7659D6BC4D13D40AAF97BD39B3E56C0802DF3C0C1D03D4067CC267EB43E56C0103A491657CF3D40964F7CD3B93E56C060E94B16C7CD3D4001030000000100000004000000B044277E7E3756C0DF14A06B34DB3D40A46BD1285B3756C03085F4C0B9D83D404106D228B13756C0788B9F6B84DC3D40B044277E7E3756C0DF14A06B34DB3D4001030000000100000007000000F9FF267E063A56C021D09F6B1CDE3D409EDD267E1A3B56C0A9B0481627DC3D402A9FD1284D3B56C0F8C9F4C051DC3D40E6E3D128A53A56C07F789E6B24DF3D40DC55277E443A56C0F16B48168FDF3D40F9FF267E063A56C01F2E4C16DFDE3D40F9FF267E063A56C021D09F6B1CDE3D40010300000001000000050000001A837CD36B3856C0886CA16BACE13D40CE39D228833856C09F2DF3C0C1DF3D40C5EE267E803856C04072F3C0D9E33D40D27CD128613856C0AF469F6B6CE33D401A837CD36B3856C0886CA16BACE13D40010300000001000000090000000C67277E8A3956C080D64A16E7E03D40CE7CD128013A56C040084A161FE03D4011AA267E083A56C0A02DF3C0C1E03D40964F7CD3B93856C0076C48168FE53D40CE7CD128813856C0B0659D6B44E53D40C6EE267EC03856C060AA9D6BDCE23D4060FB7CD3F53856C0B027A16B94E23D40F8FF267E263956C0618B9F6B04E23D400C67277E8A3956C080D64A16E7E03D400103000000010000000D0000009EDD267E3A5256C0A00EF5C069EC3D4032EA7CD3CF5256C0C0FBF3C089EB3D40FE4AD228E95256C0F814A06BB4EC3D40AAF97BD3DB5156C0B1469F6BECEF3D40725AD128B55056C0201B4B167FF13D40C2607CD3FF4E56C09059A06BCCF23D40071C7CD3474F56C0EFE2A06BFCF03D40F84AD228494F56C0AFA44B16AFEF3D405622277E124F56C01F1B4B167FEE3D40EC717CD3654F56C08F0EF5C0E9ED3D406689277E565056C08F0EF5C0E9ED3D400B67277E8A5156C0A8789E6B24ED3D409EDD267E3A5256C0A00EF5C069EC3D400103000000010000000B000000FE8DD128875056C0A0789E6B24F23D401A837CD32B5156C0B8B04816A7F13D401E837CD30B5156C0F014A06BB4F23D4000D97CD3494F56C0B0FBF3C089F73D403A2D7CD3ED4E56C00098F5C019F93D40FE8DD128A74E56C0184D4A1637F93D40081C7CD3874E56C04772F3C0D9F73D4040BB267ECE4E56C0609EA06BE4F63D400CAA267EA84F56C048274816F7F43D40DE0A7CD3415056C0D027A16B94F23D40FE8DD128875056C0A0789E6B24F23D400103000000010000000C000000E6E3D128A55456C07F59A06BCCEA3D40A9F97BD3FB5456C0E7AAF6C079EA3D4060FB7CD3555456C0AF27A16B14ED3D40372D7CD3CD5356C06FF54816BFEF3D409CDD267E7A5356C07F6CA16B2CF23D403A2D7CD3CD5256C08059A06B4CF63D401C837CD3CB5156C0B0469F6B6CFB3D4078A57CD3775156C0900EF5C069FB3D4060FB7CD3F55156C057BD9E6B3CF73D403EBB267EEE5256C0E814A06B34F13D406689277E765356C0AFA44B16AFEE3D40E6E3D128A55456C07F59A06BCCEA3D400103000000010000001900000078A57CD3173556C0E87E49166FCF3D404206D228B13656C0A00EF5C0E9C43D40A6B67CD39D3656C08059A06B4CC63D40CE7CD128A13656C030BD9E6BBCC73D40C0607CD3BF3656C0F014A06B34C93D40C0607CD3FF3656C0886CA16BACCA3D40A6B67CD31D3556C08F0EF5C0E9D73D40ACF97BD3BB3456C017029F6B54DC3D404C947CD3B13456C01F85F4C0B9E93D40ACF97BD3BB3456C09959A06BCCED3D406889277E563456C0609EA06B64EF3D40DA0A7CD3413556C077AA9D6B5CF63D40E8E3D128853556C0EFAAF6C079FA3D405CFB7CD3353556C058AA9D6B5CFD3D40EE717CD3A53556C07021F6C049FF3D40F0717CD3453656C0DFAAF6C079083E40C4AB277EE23656C0A059A06B4C0C3E405EFB7CD3D53756C07F8B9F6B040F3E403A2D7CD36D3656C0F0E2A06BFC0B3E40D2C77CD3C33556C0608B9F6B84063E40DA0A7CD3413556C0D0AAF6C079003E406889277E563456C07F21F6C0C9FB3D40F8FF267EE63356C0A759A06B4CEA3D401A837CD38B3456C0E7E8F2C029D53D4078A57CD3173556C0E87E49166FCF3D40010300000001000000060000004C947CD3315B56C0381B4B167F243E40964F7CD3995B56C0A1789E6B24223E40AD44277E1E5C56C00FEF9D6BF4223E406989277EB65B56C0A059A06B4C253E400A67277E4A5B56C0F0E2A06BFC253E404C947CD3315B56C0381B4B167F243E40010300000001000000380000005422277E324E56C0E9E8F2C0A9123E40AEF97BD3DB4D56C0B9A44B162F103E402A9FD128CD4D56C07F8B9F6B040F3E404A947CD3514D56C0806CA16B2C103E404606D228F14C56C0182E4C165F113E40F8FF267EA64C56C02FBD9E6BBC123E405622277E724C56C0910EF5C069143E40392D7CD30D4C56C0910EF5C069143E40AE44277EFE4B56C0B9A44B162F103E40EB717CD3454C56C0D027A16B940C3E40C0607CD3DF4C56C098789E6BA40A3E402A9FD128CD4D56C0788B9F6B840B3E406489277E364E56C098789E6BA4083E40EE717CD3A54E56C0E814A06B34093E40289FD1288D4F56C0A0469F6B6C0D3E40B044277EBE4F56C050084A169F0E3E403A2D7CD3ED4F56C0589EA06B64103E404A947CD3315056C008E3A06BFC113E4002D97CD3A95056C0E9E8F2C0A9123E409CDD267E1A5156C0C027A16B14123E4048947CD3715156C007029F6BD4103E40F7FF267EA65156C0D027A16B940F3E4047947CD3B15156C07F8B9F6B040F3E400867277E2A5256C040BD9E6B3C0F3E405622277E725256C0202E4C16DF0F3E40C1AB277EA25256C00F98F5C099103E407AA57CD3D75256C09F0EF5C0E9103E400A1C7CD3475356C0182E4C165F103E40EE717CD3A55356C0806CA16B2C0F3E40C6AB277EE25356C0CFAAF6C0F90D3E40735AD128F55356C0A0469F6B6C0D3E40D27CD128415556C0B7FBF3C0890C3E406989277EB65556C018E3A06B7C0D3E40944F7CD3195656C09F0EF5C0E9103E4076A57CD3575556C08159A06B4C113E40924F7CD3795456C0C0E8F2C029123E40F2717CD3C55356C0EFAAF6C079133E409CDD267E7A5356C07721F6C049153E403A2D7CD30D5356C0171B4B167F153E40AEF97BD33B5256C0171B4B167F153E40705AD128B55156C0800EF5C0E9163E4017837CD32B5256C0A70EF5C0691B3E404006D228315156C0FF6B48168F1C3E40FE4AD228495056C0D014A06B341E3E402C9FD128AD4E56C0479EA06B64223E403EBB267E6E4D56C050084A169F273E404A947CD3914C56C058BD9E6B3C2A3E405322277E924B56C080789E6B242B3E405322277E924B56C0599EA06B64293E404606D228714C56C050F54816BF273E40DA0A7CD3414D56C019E3A06B7C253E404E947CD3114F56C0589EA06BE41E3E40B044277EFE4F56C02FD09F6B1C1A3E40A6B67CD31D4F56C0C17E4916EF173E40A9B67CD3FD4D56C0EF14A06B34163E405422277E324E56C0E9E8F2C0A9123E4001030000000100000038050000566C61B3DEBF56C04047B28856194040CFDDC71911C256C0E8CAB288E2124040A840FB4C84C556C050FE17EF18134040F84C2E801BC656C0D4EF7D551712404002AD94E657C656C0E807E3BBC51040408435FA4C60C656C09049E5BB810F404098C793E659C656C068EC18EFA40E4040847AC71969C456C0E0864B22D80A40401A9EC7196DC456C0A0117E552B064040982894E6D9C556C0D875B188CE01404068072E8023C856C05FB06111D5FD3F405239C81923CA56C0AFF9FAAAB6FB3F40E2FDC719C3CA56C0A871611155FA3F4068D52D8043CB56C0D8D432DE11F83F402A912E80E3CB56C0902F32DEC9F23F40E23CC8194FCC56C0FF366011A5F03F406E1E61B33ECF56C06762F9AAF6E43F40F88360B37AD056C0007B6211B5E13F4016C661B3B4D156C00848C77723E03F40DEA660B366D456C090DEFDAA16DE3F4079342E8081D556C0FF00CA77ABDB3F4056A5FA4C7CD656C0394230DE39D73F40F38AC71915D756C0501E2FDEC1D23F400C27C819E9D756C0B00B61113DC93F40BC9794E6DDD956C05F36FDAA06BD3F40F23EFB4C22DA56C0B8535F118DB83F40A05E60B33ADA56C0C741964480B33F40B62694E671DB56C0605D9644609D3F40FE582E807DDB56C0D0EF954440973F40104D2E80CFDB56C020A4944480943F40C22595E6E1DB56C098C06211BD923F40729993E65FE056C0E09EFDAAAE873F40F767FA4CDAE156C04926954428803F40908294E68FE156C058D5F9AA06753F408DC92D8049E156C0B12EFCAA1E733F4099CF2D80A3E056C0A03264112D703F4025C8F94CD4DF56C0B0F330DEC96A3F40624C2E80B7DF56C0EF4E964448693F40C09BFA4CD0DF56C097E82CDE41643F40AC7C2D80F3DF56C0C0696511FD613F4052D3C6198DE056C0C0A29544A85F3F40FAE2C6196DE156C06FA8CA771B4F3F40AA1D94E6D7E156C0E85B2DDE214B3F407C87FA4CA0E256C09F40C87753483F40C509FB4CFCE356C0B7A32DDE41473F40D446C71901E756C060E7FBAAAE473F40D2BBFA4C82E856C090FD62113D473F400A272E8077E956C04843CA7783453F40BEC060B392E956C0806F2FDE61413F40669A61B3E8E856C000059744383C3F40B49DC719E9E756C06F8DFDAACE373F40FF13FA4C06E756C06F339544F0353F405605FB4CB2E656C0D05763119D343F401819FB4CD0E656C0382B2FDEB9313F40EADA60B316E756C047DA9844F82E3F409CD694E63DE756C02036FBAAFE2D3F40B4FEC71969E756C017629644382B3F4093D7FA4C16E856C05002C777C3263F40C677FB4C28E856C049D8FDAA4E243F402EC661B368E756C0E7919444201D3F40CC96FA4C74E556C021A2F8AAF6143F40792061B30EE556C0FF809844600E3F40B6EE93E611EA56C05FDCFBAA0E003F403804C819B1E956C05FDCFBAA0E003F40CA1C94E6B9E656C05FDCFBAA0E003F40F8132E8071E556C05FDCFBAA0E003F40A25CC819CFE156C05FDCFBAA0E003F4094E7FA4C28DC56C05FDCFBAA0E003F409CCCC719D5D456C0983BC6770B003F407C8BFA4C2ACC56C0983BC6770B003F409C6BFA4C7EC256C05F592DDE09003F40DEE393E625B856C05F592DDE09003F40AAACFA4C78AD56C05F592DDE09003F40F43CFB4CCAA256C05F592DDE09003F4036B594E6719856C05F592DDE09003F40FE3EDA31D79656C05F592DDE09003F40102DC719C58E56C05F592DDE09003F40EFEBF94C1A8656C05F592DDE09003F40FDD0C619C77E56C05F592DDE09003F4014EB2E80217956C03F95FBAA06003F40D60C61B37E7556C03F95FBAA06003F407BCB94E6357456C03F95FBAA06003F40E605C819757156C03F95FBAA06003F401AB461B30E6F56C03F95FBAA06003F40DEB5FA4CDC6E56C061A7CA7733FC3E40EC1CC7194B6F56C0AF47FEAA4EF33E409462FA4C207056C068A3FDAA1EEA3E406E0AFB4C9C7156C0980CFBAAB6E03E40267861B39C7256C04002FAAAD6D13E40FC892D80337456C08FCE64114DCB3E40A190C719C57456C070C1C777EBC63E40F65EFB4C5C7456C0316BC7771BC23E401D09C819957556C021B6FFAADEB83E403A3A61B30E7656C05F90FCAA4EB33E4058B093E6257656C0970E9744B8AE3E403A4261B3847556C0D761C977E3AA3E409D3061B3887456C0301BC977F3A63E408F2095E6077456C0B8C1964488A23E401A0161B3D67456C0905DF9AA3E9D3E400464FA4C2A7356C027606211DD903E40D9A8C7192D7256C0A0802CDE598D3E40123395E6217056C08F4DFDAA968A3E40A23CC719176F56C05917FAAA0E883E40081861B33A6E56C09014CB771B803E405AE42D806D6C56C06F072EDEB97B3E407E5094E65D6B56C0885EC877F3743E408234C8192F6B56C090CE2EDE21733E4042022E80236B56C0A889C777F3703E40581095E63B6B56C0F8EF9744686C3E408234C8192F6B56C0106F62113D6A3E4084AF94E6C16A56C0A7CAFDAA2E663E40EA932D80EB6856C08F389344405C3E40E68AC7199D6856C06FD2C877EB573E405A5461B3B86856C03970FDAA664D3E40660961B37E6756C0274AC777F3453E40466594E69F6556C0A8A6FCAA4E363E400670C719276456C0582BFEAA66303E406AADC719A36356C0B8C4FAAA0E333E402E6761B3DE6256C03750C6770B343E405CF4F94C146256C05F64CA7733333E4016ABB3A7A96156C0587B6B955A313E4004D97CD3A96156C02F72F3C059313E40653E7CD3536256C0D8E8F2C0292E3E404006D228316456C04872F3C0D9293E40D0C77CD3236656C0A80EF5C0E9273E40924F7CD3396756C080789E6B242B3E4098DD267E9A6656C0616CA16B2C2B3E40633E7CD3336656C030084A169F2B3E40944F7CD3796556C01F2E4C16DF2C3E40E6E3D128256656C0FF2D4C16DF2F3E40FAFF267E066756C0E8339E6B8C2F3E40372D7CD30D6856C01F2E4C16DF2D3E401A837CD32B6956C01F2E4C16DF2C3E4004D97CD3496B56C04FBD9E6B3C2E3E40392D7CD34D6C56C08F0EF5C0692E3E406789277E566D56C01F2E4C16DF2C3E4002D97CD3C96D56C0DF7E4916EF2D3E40ABF97BD31B6F56C03872F3C0592F3E404406D228916F56C0102E4C165F303E40D90A7CD3E16F56C0F0E2A06B7C323E4076A57CD3D76F56C090789E6B24343E401A837CD3AB6F56C0589EA06BE4353E404406D228916F56C009029F6B54383E4075A57CD3177056C0B1659D6BC43C3E402C9FD1284D7156C060AA9D6B5C3D3E40C2607CD37F7356C06FAA9D6BDC3A3E40CD7CD128E17456C07F21F6C0493B3E401A837CD32B7756C0E0339E6B0C423E4032EA7CD38F7856C0C0659D6BC4433E40D4C77CD3437956C0F0AAF6C079433E407AA57CD3777A56C07F59A06B4C423E4004D97CD3297B56C0281B4B16FF413E40F4FF267E067E56C0C0659D6BC4433E40C0607CD39F7E56C0311B4B167F463E40A228D228FD7F56C0A8789E6B24503E40C2607CD33F8056C037D09F6B9C523E402FEA7CD3CF8056C05F8B9F6B84533E40AE44277EBE8356C058BD9E6B3C5C3E40E6E3D128258656C0886CA16BAC5F3E4040BB267E2E8956C0C827A16B94623E40C0607CD31F8C56C0D8339E6B0C643E40AAF97BD33B8E56C02F85F4C039633E405FFB7CD3B58F56C0886CA16BAC5F3E40362D7CD32D9156C06021F6C0495A3E4040BB267E8E9356C050F548163F4E3E404A947CD3319556C0E0E8F2C0A9463E401C837CD3EB9956C068AA9D6B5C383E401A837CD36B9B56C0102E4C165F303E405FFB7CD3B59B56C0B0A44B16AF243E40C0607CD37F9A56C06F21F6C0491B3E404A947CD3519856C0AF27A16B94143E40623E7CD3B39556C09F0EF5C0E9103E4004D97CD3099156C0589EA06B640F3E40FE4AD228C98E56C0886CA16B2C0A3E40F4FF267EC68A56C0C0659D6B44063E400E67277E4A8956C0F097F5C019063E402EEA7CD3AF8656C0D7AAF6C0F9083E40A3B67CD35D8256C0BF914A164F0A3E400867277E0A8156C07F0EF5C0690B3E40F2717CD3C57F56C0A0469F6B6C0D3E408CC1D128597B56C028EF9D6B74183E4049947CD3917956C0C0469F6B6C1F3E4089C1D128597856C090789E6BA4273E40AAB67CD3DD7656C0D814A06BB4263E409CDD267E5A7656C0E014A06B34253E40FA4AD228297656C0E07E49166F213E403EBB267ECE7556C06121F6C0C91E3E407AA57CD3F77456C0E17E49166F1C3E405422277EF27356C00898F5C0991A3E4032EA7CD30F7356C0EFE2A06B7C193E40ACF97BD37B7256C0B0914A164F193E404A947CD3517256C0689EA06B641A3E40E7E3D128257256C0FF6B48168F1C3E40A5B67CD3BD7056C00FEF9D6BF4223E4040BB267E2E7056C0806CA16B2C263E40362D7CD3CD6F56C0D87E49166F293E404406D228916F56C01F2E4C16DF2C3E40CE7CD128216F56C01F2E4C16DF2C3E40F4FF267EA66E56C0599EA06B64293E402EEA7CD34F6F56C02085F4C039263E40EE717CD3057056C0BF27A16B941F3E404006D228717056C0E7E8F2C0291D3E40D5C77CD3437056C0808B9F6B841C3E40E6E3D128057056C0172E4C16DF1B3E40E6E3D128C56F56C030EF9D6BF41A3E404406D228916F56C0EFE2A06B7C193E404206D228B16E56C01FD09F6B9C1F3E40F4FF267EA66E56C001E3A06B7C203E40C2AB277E426E56C098789E6BA4203E400A67277E4A6D56C010D09F6B1C203E404C947CD3F16C56C001E3A06B7C203E4032EA7CD30F6C56C058084A169F223E409E28D228BD6B56C03072F3C0D9233E407AA57CD3976B56C0679EA06BE4253E40BD607CD3BF6B56C017E3A06B7C273E4099DD267E1A6C56C0F0019F6BD4273E402D9FD1286D6C56C0E014A06B34273E4076A57CD3776C56C0679EA06BE4253E40745AD128B56C56C04FAA9D6BDC253E406489277E366D56C02FEF9D6B74263E404006D228916D56C050084A169F273E406789277E566D56C0599EA06B64293E407AA57CD3976B56C080789E6B242B3E406889277EB66A56C008E3A06BFC293E40944F7CD3996956C019E3A06B7C253E4042BB267EEE6856C0F0E2A06BFC233E4006D97CD3C96956C01FD09F6B9C1F3E40071C7CD3A76A56C0D027A16B141D3E405222277E526B56C0800EF5C0E9193E407AA57CD3976B56C0D0339E6B8C133E408AC1D128796D56C05F21F6C049113E40D2C77CD3036E56C020EF9D6BF40F3E40745AD128356E56C09F659D6B440D3E40AAB67CD3FD6D56C0B0914A16CF0A3E405422277EF26D56C0608B9F6B84083E40F4FF267EA66E56C0C0659D6B44063E40944F7CD3D96F56C0201B4B167F0A3E40C4AB277E827156C0C7469F6BEC0C3E409CDD267E3A7356C028D09F6B1C0D3E409E28D2289D7456C098789E6BA40A3E405222277E727556C058BD9E6BBC063E40FE4AD228C97556C0B7469F6BEC023E404206D228B17556C0C0914A16CFFE3D40B044277E3E7556C0A0FBF3C009FA3D409DDD267E9A7456C0C827A16B14F53D4004D97CD3E97356C0F9AAF6C079F23D406789277ED67256C0DFAAF6C079F13D40643E7CD3137156C09F59A06B4CF13D40633E7CD3137056C0409EA06B64F23D409E28D228DD6D56C0679EA06BE4F53D406789277E566D56C07021F6C0C9F43D40C2607CD37F6D56C0A0A44B162FF33D400C67277E6A6E56C010EF9D6BF4EE3D40F4FF267EA66E56C0D0339E6B0CEC3D40D6C77CD3236D56C060AA9D6BDCE53D4030EA7CD3EF6B56C0E07E4916EFE13D40061C7CD3876A56C040084A161FE03D402EEA7CD30F6956C0A8FBF3C009E03D40FC4AD228A96756C078F548163FE13D40382D7CD38D6656C0A0FBF3C009E43D4032EA7CD38F6556C040BD9E6BBCE83D406A89277ED66456C03F72F3C059EE3D402EEA7CD38F6456C0F1019F6BD4F33D403CBB267E8E6456C0BF339E6B0CFD3D405022277E326456C04FBD9E6B3C003E400E67277E4A6356C0B7469F6BEC023E4004D97CD3A96256C0A1914A16CF033E409EDD267E5A6156C030EF9D6BF4043E401E837CD3AB6056C0C0659D6B44063E405422277E326056C0102E4C16DF073E40362D7CD3ED5F56C0201B4B167F093E40765AD128B55F56C0A059A06B4C0B3E40A9F97BD35B5F56C0A0469F6B6C0D3E40BE607CD33F5F56C08F59A06BCC0E3E404206D228515F56C0E76B48160F123E40B044277E1E5F56C0D0339E6B8C133E40F84AD228A95E56C0EFAAF6C079143E402EEA7CD34F5E56C0BF339E6B0C143E4078A57CD3F75D56C0E9E8F2C0A9123E40C6AB277E425D56C0F814A06B34123E405622277ED25B56C07F8B9F6B04103E408EC1D128595B56C07F8B9F6B040F3E408EC1D128595B56C0A0469F6B6C0D3E405622277ED25B56C0A0469F6B6C0D3E405622277ED25B56C0788B9F6B840B3E408EC1D128995B56C00FEF9D6BF40A3E40F7FF267E865B56C0D07E4916EF0A3E409ADD267E7A5B56C0B0659D6BC40A3E408EC1D128595B56C06FF54816BF093E405322277EF25A56C06FF54816BF093E4030EA7CD38F5A56C07F6CA16B2C0B3E405522277E325956C0F7AAF6C0790E3E40944F7CD3B95856C07F8B9F6B040F3E4074A57CD3D75756C0101B4B16FF0D3E402A9FD1286D5756C031EF9D6B740C3E402EEA7CD38F5756C037EF9D6B740A3E40643E7CD3535856C0886CA16B2C083E405522277E325956C020EF9D6B74073E40D27CD128015B56C02F1B4B16FF073E405622277ED25B56C0C0659D6B44063E405122277E325C56C080789E6BA4033E405EFB7CD3155C56C0016C48168F013E406689277ED65B56C00798F5C099FF3D405622277ED25B56C058AA9D6B5CFD3D402E9FD1284D5C56C0E0E8F2C0A9FB3D4019837CD3EB5C56C07F21F6C0C9FA3D40944F7CD3195D56C020EF9D6BF4F93D40C2AB277E425C56C05F21F6C049F83D40643E7CD3735B56C008E3A06BFCF73D40EE717CD3A55956C00098F5C019F93D40944F7CD3B95856C05F21F6C049F83D4047947CD3B15756C0409EA06B64F33D4040BB267E6E5856C0201B4B167FEF3D40F6FF267EA65956C057084A169FEE3D40623E7CD3135A56C0689EA06BE4F23D405622277ED25B56C0609EA06B64EF3D405622277ED25B56C09959A06BCCED3D40FC4AD228E95A56C0E7AAF6C079E93D408CC1D128795A56C0689EA06B64E83D4030EA7CD38F5A56C01985F4C039E83D40643E7CD3735A56C0F8AAF6C0F9E73D408CC1D128795A56C0A059A06BCCE63D40623E7CD3135A56C0A059A06BCCE63D40745AD128B55956C040BD9E6BBCE83D409D28D228FD5856C020D09F6B9CEA3D40755AD128355856C0C0E8F2C0A9EB3D40F8FF267EA65756C0706CA16B2CEB3D4078A57CD3775756C027EF9D6B74E83D40603E7CD3F35756C0D1E8F2C029E63D40663E7CD3335956C0D7E8F2C029E33D40663E7CD3335956C078F548163FE13D40A6B67CD33D5856C06FF548163FE23D40A228D228DD5756C0606CA16B2CE33D40603E7CD3735756C0419EA06BE4E43D40061C7CD3075756C060AA9D6BDCE33D409ADD267E3A5556C078F548163FE13D403EBB267E8E5656C0B0FBF3C089DE3D40904F7CD3F95656C0A00EF5C0E9DD3D4076A57CD3975656C020D09F6B1CDD3D4019837CD36B5656C077AA9D6B5CDC3D402EEA7CD34F5656C0371B4B167FDB3D40944F7CD3195656C0A0469F6B6CDA3D400A1C7CD3E75656C0C727A16B14DA3D40EE717CD3855756C07121F6C0C9D83D40ADF97BD3FB5756C0C7FBF3C009D73D40643E7CD3535856C000029F6B54D53D404C947CD3D15756C0619EA06B64D23D4030EA7CD36F5756C07021F6C049CF3D404A947CD3F15656C0C8FBF3C089CC3D40944F7CD3195656C0886CA16BACCA3D40C0AB277EC25656C060AA9D6BDCCA3D40BE607CD33F5856C070F548163FCC3D40944F7CD3B95856C0B0659D6B44CC3D40DC0A7CD3415956C00FEF9D6B74CA3D40C0607CD3DF5956C030EF9D6B74C53D408CC1D128795A56C08FA44B16AFC33D40964F7CD3595A56C0980EF5C069C53D408CC1D128395A56C000E3A06BFCC83D40623E7CD3135A56C0886CA16BACCA3D40DC0A7CD3E15A56C067F54816BFCA3D4078A57CD3575B56C08F59A06B4CCC3D400867277E0A5C56C0182E4C16DFD03D404E947CD3915C56C058BD9E6BBCD23D40A8F97BD33B5D56C08821F6C049D43D40E5E3D128055E56C02885F4C039D53D40D80A7CD3E15E56C000029F6B54D53D408AC1D128995E56C0A0914A16CFD03D40362D7CD32D5F56C0E0339E6B8CCD3D40061C7CD3276056C0886CA16BACCA3D404006D228116156C05172F3C059C73D40B244277EBE6156C058F54816BFC23D40755AD128156256C0391B4B167FC13D409CDD267EDA6256C0E014A06B34C03D40904F7CD3796356C010EF9D6BF4BF3D40DA0A7CD3E16456C0CFE8F2C0A9C03D40944F7CD3796556C0E014A06B34C03D40AC44277E7E6656C030084A161FBC3D40E6E3D128A56656C04FAA9D6B5CB73D40745AD128356656C0C0339E6B0CB33D40944F7CD3796556C0B8914A164FB03D40603E7CD3336456C0F097F5C099AF3D408AC1D128B96256C0AFA44B162FB03D400B67277E6A6156C020EF9D6BF4AF3D401E837CD3AB6056C0C7914A16CFAC3D409EDD267E1A6156C080789E6B24AD3D400B67277E6A6156C0FF6B48160FAD3D4042BB267EAE6156C04872F3C0D9AC3D409ADD267EFA6156C0C7914A16CFAC3D40F7FF267E066156C0F0019F6BD4AA3D40D80A7CD3E15E56C0086C48160FA43D40D80A7CD3E15E56C009029F6B54A23D40AC44277EFE5F56C0B9A44B16AFA23D40C6AB277EE26056C06FAA9D6BDCA43D40EE717CD3A56156C0778B9F6B84A73D40CE7CD128616256C0A7914A164FA93D40A228D2285D6456C0AF914A16CFAA3D40DE0A7CD3216656C01F85F4C039AB3D401C837CD3EB6756C0D014A06BB4AC3D400C67277E0A6B56C0C827A16B94B33D404C947CD3F16C56C0DF14A06BB4B53D40C0AB277E626C56C0409EA06BE4B23D40603E7CD3B36A56C070AA9D6B5CAF3D408CC1D128D96956C0C7914A16CFAC3D40ACF97BD31B6A56C0EFAAF6C079AC3D4078A57CD3B76A56C01F85F4C039AB3D40F94AD228696956C0A7914A164FA93D40D90A7CD3616956C0C827A16B14A83D40F94AD228696956C0F86B48168FA73D403EBB267E4E6956C0A1469F6B6CA63D40FC4AD228A96756C0BF27A16B94A03D40FAFF267EE66856C06021F6C0C99E3D408AC1D128396E56C0B7914A16CFA33D404006D228717056C009029F6B54A23D40D4C77CD3E36E56C08059A06BCCA03D40D90A7CD3416E56C0BFFBF3C0899F3D4048947CD3D16D56C0D027A16B149D3D405222277E726E56C0776CA16B2C9D3D40F4FF267EA66E56C0D027A16B149D3D4000D97CD3496E56C0608B9F6B049A3D4076A57CD3776C56C0D87E49166F923D40C0AB277E226C56C0C07E49166F8F3D40C4AB277EC26B56C03885F4C0B9893D40E8E3D128656B56C0A7789E6B24873D40F6FF267EC66A56C0C027A16B94853D40EF717CD3056956C03F1B4B167F833D40F0717CD3856756C098789E6B24803D400E67277EEA6556C047BD9E6BBC803D40BE607CD3FF6456C070AA9D6B5C7F3D4004D97CD3496556C0AF27A16B947E3D40623E7CD3536556C09859A06B4C7E3D40944F7CD3796556C010EF9D6B747D3D40299FD1286D6456C0E76B48160F7C3D40FB4AD228A96256C0B7FBF3C089783D40D17CD128816156C02085F4C039783D40D17CD128816156C0F7AAF6C079763D40031C7CD3276256C0D7AAF6C0F9723D40E4E3D128656256C068AA9D6B5C6F3D40663E7CD3136256C0808B9F6B846D3D404006D228116156C0C7914A164F6F3D406489277E366156C0D7339E6B0C6B3D4075A57CD3D76156C050AA9D6B5C693D40FD4AD228896256C038EF9D6BF4683D409CDD267EDA6256C0F1E2A06B7C683D402D9FD1288D6256C000029F6BD4653D40A6B67CD3DD6156C0E8E8F2C0A9643D40C2AB277E026156C010E3A06B7C643D404206D228315D56C09859A06B4C673D40F0717CD3C55B56C07721F6C049673D408CC1D128795A56C000029F6BD4643D400A1C7CD3475A56C0A0FBF3C009643D4006D97CD3A95956C0EFAAF6C079643D40C2AB277E225956C09859A06B4C643D40944F7CD3B95856C057BD9E6B3C633D40643E7CD3535856C057BD9E6B3C633D404306D228D15756C0708B9F6B84643D40EAE3D128255756C020EF9D6BF4643D40FA4AD228695656C0708B9F6B84643D40352D7CD38D5556C0FFE2A06BFC633D404E947CD3915556C038084A169F623D40A028D228FD5556C030D09F6B9C613D40D0C77CD3835656C010029F6B54613D406889277E365756C010029F6B54613D40081C7CD3E75756C06F8B9F6B84603D4042BB267E4E5856C01885F4C0B95E3D40D27CD128615856C0A70EF5C0E95C3D406A89277E165856C00898F5C0195C3D40FC4AD228895756C0C0339E6B8C5B3D409CDD267E9A5656C0A0789E6B24593D40041C7CD3E75556C01898F5C099583D40DC0A7CD3615556C0102E4C16DF583D40342D7CD36D5456C0086C48160F5A3D406A89277E165356C06FF54816BF5A3D402CEA7CD38F5256C0A0469F6B6C5B3D40DC0A7CD3015256C0C0339E6B8C5B3D401B837CD34B5156C04072F3C0595A3D40FAFF267EE65056C0609EA06B64583D40725AD128B55056C0C0FBF3C089533D4060FB7CD3755056C028D09F6B9C513D40E4E3D128A54F56C03F9EA06BE4503D40F94AD228894E56C0EFE2A06B7C523D40DA0A7CD3814D56C00F029F6BD4553D402E9FD128ED4C56C04072F3C0595A3D40A028D2289D4C56C000E3A06B7C5A3D40EC717CD3854C56C02F084A161F5A3D40D4C77CD3834C56C0DF7E49166F593D405622277E724C56C01898F5C099583D40081C7CD3274C56C05F6CA16BAC583D40D4C77CD3034C56C0A8789E6B24573D40A6B67CD3FD4B56C0C027A16B94543D40392D7CD30D4C56C028D09F6B9C513D40E8E3D128654B56C0A0A44B16AF523D40D2C77CD3234B56C050AA9D6B5C533D402E9FD128CD4A56C02FEF9D6BF4503D40CB7CD128614A56C0509EA06B644F3D40DE0A7CD3014A56C0086C48168F4D3D40663E7CD3D34956C018EF9D6B744A3D404106D228314956C048BD9E6BBC4B3D40623E7CD3F34856C071AA9D6B5C4C3D408EC1D128594856C0F897F5C099493D40BE607CD31F4856C06F21F6C0C9463D40DE0A7CD3E14756C0CF27A16B94443D40745AD128354756C050084A169F433D406789277E964756C0489EA06B64413D408EC1D128194856C0B0469F6BEC3F3D406A89277EB64856C010EF9D6BF43E3D4041BB267E6E4956C01085F4C0393E3D4041BB267E6E4956C03F084A169F3C3D40E9E3D128C54656C09F469F6BEC393D400D67277E6A4656C0C07E4916EF363D40643E7CD3934556C0E0AAF6C0F9343D404406D228914456C0C0469F6BEC333D4060FB7CD3B54356C048BD9E6BBC333D40F9FF267EE64356C0BF659D6BC4343D40F2717CD3254456C0679EA06B64373D40D80A7CD3014356C0A0469F6BEC373D40603E7CD3134256C029EF9D6B74373D4040BB267E4E4156C030084A169F353D40F6FF267EA64056C07F789E6B24323D405CFB7CD3F54156C07F789E6B24323D405CFB7CD3F54156C058BD9E6B3C303D40C0607CD35F4156C008029F6BD42F3D40A028D2281D4156C058BD9E6B3C2F3D40F6FF267EA64056C038BD9E6BBC2C3D400A67277E0A4256C0FF97F5C0192E3D40A9B67CD37D4256C0D8339E6B8C2D3D4017837CD3CB4256C0EFE2A06BFC2A3D40EF717CD3454356C0EFE2A06BFC2A3D40D2C77CD3434356C01785F4C0B92C3D40765AD128554356C030BD9E6BBC2E3D40EF717CD3454356C058BD9E6B3C303D40299FD1282D4456C05072F3C0592F3D404C947CD3514556C030EF9D6B742C3D40755AD128354656C058AA9D6BDC283D40725AD128554656C058BD9E6BBC253D406689277EB64556C0D0339E6B0C263D40ACF97BD37B4156C058BD9E6BBC253D402D9FD1284D4356C0BF469F6BEC183D40F2717CD3254456C0808B9F6B04163D404A947CD3314456C0609EA06BE4193D40643E7CD3934456C0A059A06BCC1C3D4003D97CD3494556C0D0AAF6C0791E3D40725AD128554656C00898F5C0991E3D4030EA7CD3EF4556C04F9EA06B641C3D40914F7CD3994556C01F2E4C16DF193D40F8FF267E664556C0C027A16B14173D400A67277E6A4556C027D09F6B1C143D4000D97CD3294656C058BD9E6B3C163D40ACF97BD37B4656C06F8B9F6B84173D40E9E3D128C54656C06F8B9F6B84193D40A8F97BD31B4756C0E0339E6B0C163D40FC4AD228E94756C02FEF9D6B74123D40DC0A7CD3A14956C009029F6B540C3D404E947CD3D14956C0C8E8F2C0A9073D40382D7CD38D4856C0A7FBF3C009FF3C4041BB267E6E4956C0D0339E6B8CFD3C408CC1D128194A56C05072F3C059FF3C400B67277E0A4C56C08059A06BCC073D405622277E724C56C0BF27A16B940A3D400C67277ECA4C56C01898F5C0990D3D40C6AB277E624E56C0980EF5C069173D40BE607CD3DF4E56C06F8B9F6B84193D4000D97CD3894F56C0D9E8F2C0291B3D40944F7CD3D94F56C038D09F6B1C1B3D40AAF97BD3FB4F56C0F06B48168F183D40BD607CD3DF4F56C020D09F6B1C163D404A947CD3B14F56C0A0659D6B44143D40041C7CD3A74F56C030D09F6B9C123D40AAF97BD3FB4F56C037D09F6B9C103D40AF44277EFE5056C0E914A06B340F3D40944F7CD3795256C038EF9D6B740E3D4031EA7CD3CF5356C04F72F3C0D90C3D40E6E3D128655456C09F914A16CF083D401A837CD38B5456C0808B9F6B84053D403CBB267EEE5456C0D8E8F2C029023D4030EA7CD3EF5756C0C7339E6B8CF23C404106D228115956C01098F5C019EF3C408CC1D128795A56C0DFE8F2C0A9ED3C40C2607CD33F5A56C07821F6C0C9F53C40623E7CD3135A56C09F789E6B24F83C406689277EB65956C0D027A16B94F93C404A947CD3915856C007029F6BD4FC3C40D2C77CD3235856C0579EA06B64FF3C40DE0A7CD3C15656C06FF548163F053D4032EA7CD36F5656C077AA9D6BDC073D404A947CD3715656C08059A06BCC0A3D402E9FD1288D5656C04072F3C0590D3D4006D97CD3895656C06FAA9D6BDC0E3D408AC1D128F95556C0E0AAF6C079103D4002D97CD3895456C0778B9F6B84113D40735AD128F55356C0778B9F6B84123D407AA57CD3D75256C0B0659D6B441B3D40D80A7CD3615256C01098F5C0191E3D401C837CD3CB5156C02FEF9D6BF4233D402A9FD128AD5156C0F1E2A06BFC283D409ADD267E9A5256C068F548163F293D40ACF97BD3BB5256C0A00EF5C069273D40DB0A7CD3C15256C0A8789E6B24243D40362D7CD3ED5256C030BD9E6B3C213D409CDD267E7A5356C0401B4B167F203D40F6FF267EE65356C0A959A06B4C223D40FAFF267E065456C0BF339E6B8C253D40735AD128F55356C050AA9D6BDC2B3D40061C7CD3275456C0B7469F6B6C2E3D4077A57CD3975456C0D027A16B942E3D40081C7CD3075556C0C8469F6BEC2C3D409ADD267E3A5556C029D09F6B1C2A3D40CD7CD128215556C00FD09F6B1C273D40D2C77CD3C35456C0806CA16BAC213D400A67277ECA5456C00898F5C0991E3D40944F7CD3995556C00FE3A06B7C1A3D409CDD267E1A5756C0F0AAF6C079173D403A2D7CD38D5856C011E3A06B7C163D40663E7CD3335956C0F06B48168F183D4006D97CD3E95956C028EF9D6B741F3D4098DD267EDA5956C0282E4C165F213D40CC7CD128815956C007029F6B54243D40BC607CD3FF5956C0B0469F6BEC253D408EC1D128595B56C0D8E8F2C0A9273D40D80A7CD3E15E56C01085F4C0393E3D40643E7CD3535E56C0A759A06B4C3E3D40DA0A7CD3215D56C030084A161F403D40A9B67CD35D5E56C04072F3C059423D402EEA7CD3AF5F56C0C17E49166F423D40D5C77CD3636056C0C8FBF3C009403D40DC0A7CD3C15F56C02185F4C0B93A3D40E5E3D128856356C01898F5C0993F3D409E28D2283D6556C030084A161F403D402D9FD128ED6656C0C0339E6B8C413D40A128D2287D6756C028EF9D6BF4443D40954F7CD3D96756C0401B4B16FF483D40DCC70DC9AD6856C05F9EAF96114B3D401A97A8465E6A56C0A7081EC3094D3D4022D6872DD16A56C0DFE9FE6D734B3D40FC044AAFF26B56C0E10A52BEDA4B3D401E5BDECEDE6E56C0071639C55C4E3D40C1EE403FE17256C0E797A3090C503D403883B5805C7456C05981F0DBEF503D40BECBFA37C97256C0D0E64595FD533D40BBBE237E937156C047CD402819553D40267F8D3D7E7056C0D0768D89D9573D40AA799582FC6F56C08FA16B52165B3D40A62BB8829A6F56C020ADD304AE5E3D400C27FDABB16F56C078999E018C623D4098C0C7A2017056C070E80DE866643D405CFB7CD3D57056C000029F6BD4643D4019837CD32B7156C010D09F6B9C633D40D2C77CD3637156C01FD09F6B1C633D402CEA7CD38F7156C0EF6B48168F623D40BE607CD3BF7156C010029F6B54613D40FB4AD228097256C0B7659D6B44643D4089C1D128D97156C037D09F6B1C663D40BE607CD37F7156C0F097F5C099673D404406D228517156C050AA9D6B5C693D40D80A7CD3A17156C01F85F4C0B96B3D40A8B67CD35D7256C08F789E6B246B3D40A228D228BD7356C0F1E2A06B7C683D40CE7CD128217456C0786CA16B2C693D407AA57CD3777456C0A0659D6BC46A3D408AC1D128B97456C0C0FBF3C0896C3D40944F7CD3D97456C03985F4C0B96D3D40623E7CD3F37456C0D014A06B346E3D40ABF97BD31B7556C0F814A06BB46E3D40A028D2283D7556C0C127A16B946F3D40B044277E3E7556C02885F4C039713D406689277E167556C0608B9F6B84723D400767277ECA7456C0900EF5C0E9733D40C2607CD37F7456C0F0019F6BD4743D40AE44277E5E7456C02F85F4C0B9743D406889277E167456C03072F3C0D9773D40B244277E3E7456C0D77E49166F793D40D07CD128C17556C02FBD9E6BBC7A3D40A8F97BD33B7656C0301B4B167F7B3D40C5AB277E827656C0609EA06BE47A3D408BC1D128997656C05872F3C059773D403CBB267E0E7756C01798F5C099713D40C0607CD31F7856C0AF469F6BEC723D4078A57CD3177A56C041084A161F7A3D40D0C77CD3437C56C0679EA06BE4763D40081C7CD3277E56C09FA44B162F793D40E8E3D128258556C09FFBF3C089893D40A6B67CD35D8656C0E07E49166F8B3D402CEA7CD36F8756C0C8FBF3C0098C3D402D9FD1284D8856C0E07E49166F8B3D40EE717CD3858856C0708B9F6B048A3D40392D7CD3AD8756C017D09F6B1C883D40091C7CD3278856C0D014A06B34863D404106D228318956C0BF27A16B94893D40352D7CD3AD8A56C018029F6B54913D40F6FF267EA68B56C05072F3C059943D40F2717CD3058C56C02FBD9E6BBC913D40AAB67CD3FD8C56C0409EA06B648D3D40EE717CD3658D56C04F72F3C0D9893D40725AD128158C56C0B8A44B16AF893D40F6FF267EA68B56C04F72F3C0D9893D40F6FF267EA68B56C017D09F6B1C883D40FC4AD228A98C56C0FF97F5C099863D40342D7CD32D8D56C0706CA16B2C863D4017837CD3CB8D56C0D014A06B34863D40735AD128758D56C0FF2D4C16DF833D402EEA7CD32F8D56C0A0469F6BEC823D40F5FF267EE68C56C0AFA44B162F833D40FAFF267E868C56C027D09F6B9C843D40FE4AD228E98B56C0B8FBF3C009833D4040BB267E2E8956C0006C48160F7A3D400E67277E8A8856C031BD9E6BBC783D400C67277EEA8756C02085F4C039783D40623E7CD3138656C04F084A169F773D4076A57CD3778456C0B0659D6BC4753D40AEF97BD3FB8256C0201B4B167F723D40E7E3D128858156C03985F4C0B96D3D40DE0A7CD3818256C01085F4C0396C3D40061C7CD3078356C0E014A06BB46A3D40ADF97BD33B8356C0AF659D6B44683D40E5E3D128458356C0A0FBF3C009643D40D4C77CD3E38256C0CF14A06BB4623D408CC1D128998256C0589EA06B64613D40EAE3D128658256C030BD9E6BBC5F3D405322277E528256C0D0E8F2C0A95D3D40EAE3D128658256C05072F3C0D9563D4076A57CD3978256C09759A06BCC583D40934F7CD3D98256C0499EA06B645A3D4078A57CD3378356C0608B9F6B845B3D40AE44277EBE8356C00898F5C0195C3D40AAF97BD39B8356C008029F6B54573D400E67277E0A8356C0CF14A06B34533D402A9FD1282D8256C0D8339E6B0C503D40BD607CD31F8156C037D09F6B1C4E3D40BD607CD31F8156C071AA9D6B5C4C3D40EAE3D128658256C018EF9D6B744A3D40DE0A7CD3418356C048BD9E6BBC4E3D404106D228518456C0509EA06B644F3D40924F7CD3D98456C0606CA16B2C4D3D40E8E3D128258456C068AA9D6BDC483D40725AD128158656C0E8E8F2C0A9483D40EE717CD3658656C0F8E2A06BFC403D40A7B67CD35D8556C0E014A06BB4393D40E5E3D128458356C02185F4C0B93A3D40299FD128AD8356C09F789E6BA4363D40BFAB277E228556C01785F4C0B92C3D40AC44277E7E8556C0EFE2A06BFC2A3D4003D97CD3698656C0C77E49166F283D4000D97CD3498756C0970EF5C0E9243D40AC44277E5E8856C08059A06BCC213D402A9FD1286D8956C0401B4B167F203D40643E7CD3B38C56C0BFE8F2C029193D401A837CD3AB8E56C0B7A44B162F163D40B244277E9E8F56C0B7469F6B6C173D406889277E368F56C08921F6C0C9183D40944F7CD3198F56C07821F6C0491B3D40F2717CD3258F56C00898F5C0991E3D4076A57CD3578F56C05FF54816BF213D40AE44277EBE8F56C0D87E4916EF233D40A028D2281D9156C038EF9D6B74283D40A028D2285D9156C050AA9D6BDC2A3D408AC1D128199156C0F8AAF6C0792D3D40289FD128AD9056C0F814A06B34303D40765AD128759056C0C0469F6BEC323D40F0717CD3659056C038EF9D6BF4353D40A9F97BD31B9056C0E1339E6B8C393D40ED717CD3059056C03F084A169F3C3D404C947CD3119056C000029F6B543F3D40FC4AD228499056C0A1FBF3C089423D404606D228B19056C0F0E2A06BFC443D40725AD128559156C0FF2D4C165F453D4006D97CD3699156C0F8AAF6C079433D40C0607CD3DF9156C0C0914A164F3F3D40EE717CD3659256C0CF14A06B343C3D40D6C77CD3A39256C0BF469F6B6C3D3D40B244277E3E9356C0D07E4916EF413D40944F7CD3999556C0C0E8F2C0294B3D40623E7CD3B39556C037D09F6B1C4E3D40623E7CD3B39556C09FA44B16AF4F3D40A5B67CD37D9656C0FFE2A06BFC4E3D40041C7CD3079756C0DFE8F2C0A94D3D408AC1D128599756C0AF469F6B6C4B3D405622277E729756C007E3A06BFC473D402D9FD128AD9756C05772F3C059453D405422277E329956C01085F4C0393E3D405422277E329956C071AA9D6B5C4C3D404F22277E929956C0A0659D6BC44F3D40944F7CD3D99A56C08FA44B162F573D40623E7CD3339B56C01898F5C099583D40DE0A7CD3419B56C0F014A06BB4593D40362D7CD3CD9B56C037EF9D6B745B3D4040BB267E6E9C56C0E06B48168F5B3D40AEF97BD3BB9C56C03785F4C0B9573D40382D7CD3ED9C56C060F54816BF533D4030EA7CD36F9D56C0A80EF5C069503D400E67277EEA9E56C018EF9D6B744A3D40EF717CD3C59F56C00F2E4C165F4E3D40F4FF267E66A056C038EF9D6BF44D3D40C0607CD3FFA056C0BF659D6BC44B3D40DE0A7CD3C1A156C018EF9D6B744A3D4076A57CD3F7A356C0FFE2A06BFC4C3D4088C1D12899A456C037D09F6B1C4E3D40944F7CD3B9A356C09FA44B16AF4F3D40944F7CD3B9A356C028D09F6B9C513D402EEA7CD36FA456C00F98F5C019523D40BC607CD3FFA456C08859A06BCC513D409DDD267E5AA556C07F8B9F6B84503D408CC1D12879A556C037D09F6B1C4E3D40603E7CD313A656C0C07E4916EF4E3D40663E7CD393A656C048BD9E6BBC4E3D40BD607CD3DFA656C0B7914A164F4D3D409E28D228DDA656C018EF9D6B744A3D4040BB267E8EA656C090A44B16AF493D405222277E12A556C068AA9D6BDC483D40633E7CD333A556C07F6CA16B2C443D40F6FF267EE6A556C02885F4C039413D40FA4AD22849A656C0BF339E6B8C3E3D408CC1D12879A556C02185F4C0B93A3D408DC1D12819A656C02FEF9D6BF4373D408EC1D12899A656C07F0EF5C0E9383D4076A57CD317A756C07F789E6BA43B3D404A947CD3B1A756C01085F4C0393E3D40CC7CD12821A856C04872F3C0593C3D408EC1D12879A856C0806CA16BAC393D40DC0A7CD301A956C048BD9E6BBC333D40705AD128B5A856C0A7789E6BA4323D404C947CD391A856C07F789E6B24323D40D6C77CD303A956C0A059A06B4C283D40DC0A7CD301A956C02F1B4B16FF233D40F94AD22869A956C03F72F3C059273D40CE7CD128C1A956C0C0339E6B8C293D40944F7CD379AA56C0A0789E6B242A3D404406D22831AB56C068F548163F293D4049947CD351AB56C058084A169F273D409CDD267E3AAB56C0A759A06B4C253D4001D97CD349AB56C06F6CA16B2C233D40332D7CD32DAC56C0806CA16BAC213D40D6C77CD363AC56C0C7469F6B6C203D4004D97CD3A9AC56C0776CA16B2C1F3D403A2D7CD32DAD56C00898F5C0991E3D4006D97CD389AD56C0806CA16BAC1F3D40FE4AD22889AE56C0282E4C165F213D404406D22891AF56C0401B4B167F213D4003D97CD309B056C0A059A06BCC1D3D40C4AB277E82B056C07F6CA16BAC1D3D40DA0A7CD3C1B256C0B0914A164F203D40F84AD22889B356C0401B4B167F203D40D27CD12801B356C0C0FBF3C089233D4074A57CD3F7B156C0C8339E6B8C243D40EAE3D12845B156C0896CA16B2C263D40B244277EBEB156C0EFE2A06BFC2A3D40F6FF267EE6B256C030084A161F293D408AC1D128F9B356C0F86B48168F2A3D40061C7CD307B556C087789E6B242D3D40081C7CD327B656C08F789E6BA42E3D40CE7CD128C1B556C0F86B48168F2A3D40F5FF267E06B656C0C0659D6B44283D4076A57CD377B756C058BD9E6BBC253D401E837CD3ABB756C05F21F6C0C9243D4076A57CD3B7B756C041084A169F233D4006D97CD3E9B756C0C0E8F2C0A9223D405F3E7CD393B856C050F548163F223D40D6C77CD383BB56C03072F3C0D92B3D40D80A7CD321BD56C0CF339E6B8C2F3D40AE44277EDEBE56C0A8FBF3C009313D4042BB267EAEC056C08F789E6BA42E3D4078A57CD3B7C056C00FE3A06B7C313D40D07CD12881C056C0EF97F5C099333D40289FD1280DC056C0C87E4916EF343D40AE44277E5EBF56C0F0E2A06B7C353D40623E7CD3F3BF56C017029F6BD4373D40A8B67CD3FDC056C01885F4C039393D40AEF97BD3FBC156C0C7469F6B6C393D40372D7CD36DC256C0C8659D6B44383D40D1C77CD3A3C256C04F9EA06B64343D40765AD12835C356C0D07E49166F323D40372D7CD30DC456C01F2E4C16DF313D4078A57CD317C556C07F789E6B24323D405322277EB2C556C0102E4C165F333D4032EA7CD32FC756C0D027A16B14383D4040BB267EEEC756C090789E6B24393D40D27CD128A1CE56C0B827A16B143D3D40C2607CD33FD256C07121F6C0C9423D40A6B67CD3FDD456C010E3A06B7C4B3D409E28D228BDD556C05072F3C0D9563D406A89277E16D556C09F469F6BEC523D40904F7CD3F9D356C05FF54816BF513D40C1AB277EC2D256C05FF54816BF523D40382D7CD3CDD156C0C0659D6B44553D4032EA7CD30FD156C0B8914A16CF593D402A9FD1288DD056C0D0AAF6C0F95D3D40041C7CD3C7CF56C0A859A06BCC603D40E5E3D12845CE56C010029F6B54613D4004D97CD389CE56C0FF6B48160F5D3D40D07CD128C1CD56C0509EA06BE4573D40AF44277E3ECC56C05072F3C0D9543D4060FB7CD355CA56C05072F3C0D9563D40D07CD12861CA56C07721F6C0494E3D40C6AB277EA2CA56C0F0AAF6C0794A3D40C2607CD33FCB56C020D09F6B1C473D40613E7CD393CA56C0409EA06B64463D4078A57CD317CA56C0FF6B48160F453D4062FB7CD3D5C956C0481B4B16FF423D40AAF97BD3DBC956C030084A161F403D4087C1D12879C856C0509EA06BE4413D405422277ED2C756C0FF019F6B54433D40A028D2283DC756C0FF2D4C165F453D402E9FD1288DC756C01098F5C099463D4074A57CD3D7C756C03785F4C039483D40F8FF267E26C856C068AA9D6BDC483D40F8FF267E26C856C018EF9D6B744A3D40061C7CD307C756C0B7FBF3C009513D40061C7CD3C7C756C0E86B48168F563D405FFB7CD355CB56C01FD09F6B1C613D40944F7CD359CD56C09859A06B4C653D404C947CD311CE56C0C8FBF3C089673D40ADF97BD33BCE56C0272E4C165F693D40F1717CD325CE56C080789E6BA46D3D40E5E3D12845CE56C0C7914A164F6F3D4074A57CD397CE56C00F85F4C039703D403EBB267E6ECF56C0B027A16B14713D4062FB7CD3D5CF56C0F097F5C019723D40382D7CD3CDD056C0C827A16B14783D40AF44277E1ED156C0BF469F6BEC7E3D408F4F7CD3D9D056C0DF14A06BB4853D403A2D7CD30DD056C0E07E49166F8B3D40D2C77CD363CF56C0D727A16B948D3D4002D97CD3A9CE56C018029F6B548F3D405CFB7CD315CE56C0C8659D6BC4913D40B244277EDECD56C0BF469F6BEC953D40735AD12815CE56C0B8914A164F993D40A9B67CD39DCE56C0DFE8F2C0A99B3D4030EA7CD36FCF56C0A0469F6BEC9C3D40A4B67CD37DD056C0D027A16B149D3D40AAF97BD3DBCF56C05F6CA16B2C973D40663E7CD333D056C0AFFBF3C089933D400A67277E0AD256C02085F4C0398E3D4030EA7CD34FD256C07821F6C0C98B3D40745AD12835D256C0B027A16B14893D40643E7CD3F3D156C0D77E4916EF863D40382D7CD3CDD156C0D014A06B34863D405622277E12D256C0C0FBF3C089833D4076A57CD3D7D256C0E8339E6B8C7E3D409D28D2281DD356C067AA9D6BDC7B3D4004D97CD389D456C097789E6B247F3D40D4C77CD343D756C01098F5C019833D4017837CD3CBD856C027D09F6B9C843D40ACF97BD35BDA56C05772F3C0D9843D40D27CD12821DB56C0C8469F6B6C853D40765AD12875DB56C0A7789E6B24873D40FA4AD22829DB56C010029F6BD4893D401A837CD3ABDA56C0BF659D6B448C3D404C947CD391DA56C0D8339E6B8C8E3D40765AD12875DB56C03072F3C0D9903D405EFB7CD3F5DC56C0E814A06B348D3D404606D22891DF56C0A7789E6B248A3D405622277E32E256C0F714A06BB4883D401A837CD3CBE356C04F72F3C0D9893D40081C7CD3E7E256C0201B4B167F8C3D40D2C77CD3A3E256C06F6CA16BAC913D40D0C77CD3E3E256C0888B9F6B84973D4032EA7CD38FE356C051084A161F9C3D40D4C77CD3C3E356C0808B9F6B849E3D40FAFF267EC6E356C0F714A06BB4A13D40D6C77CD3E3E356C0E0AAF6C079A43D4004D97CD369E456C0D8E8F2C0A9A53D40964F7CD319E556C0896CA16B2CA53D40D0C77CD383E656C0EFAAF6C0F9A23D40CE7CD12841E756C009029F6B54A23D404606D228F1E856C0B9A44B16AFA23D40934F7CD339E956C0E0E8F2C029A53D40924F7CD3D9E856C0381B4B167FA93D404206D22891E856C0D07E49166FAF3D408AC1D12859E856C0C027A16B94BA3D40623E7CD3D3E856C0D8AAF6C0F9BD3D40964F7CD359EA56C0E014A06B34C03D404E947CD3D1EB56C09059A06BCCC03D404E947CD3D1F156C038D09F6B9CBF3D402A9FD128EDF256C0E8339E6B0CBE3D404206D22851F556C0CF14A06B34B93D404406D228F1F656C0D027A16B14B83D407AA57CD377F756C03885F4C0B9BA3D40E8E3D12885F756C0072E4C165FBE3D407AA57CD3B7F756C0E014A06B34C03D402CEA7CD32FF856C0409EA06B64C23D406A89277EF6F756C0F914A06B34C73D406789277E56F756C05F8B9F6B04CC3D40D07CD128A1F656C0786CA16B2CCE3D40EE717CD325F656C0F0E2A06B7CCC3D405222277E92F556C0A0789E6BA4C93D4062FB7CD315F556C0C1914A16CFC83D40D80A7CD3E1F456C050BD9E6B3CCD3D40FC4AD22809F556C02185F4C0B9D03D40A6B67CD37DF556C0C0659D6B44D33D40A4B67CD33DF656C09859A06BCCD43D406889277E36F956C0E17E49166FD63D40061C7CD307FA56C0A159A06B4CD63D40AE44277EBEFB56C0B7659D6BC4D13D409C28D2287DFC56C0619EA06B64D23D40061C7CD327FD56C0C0659D6B44D43D40CE7CD128E1FD56C000029F6B54D53D40D07CD12801FF56C011E3A06BFCD43D40BC607CD31FFF56C0A0914A16CFD33D40DE0A7CD301FF56C020D09F6B9CD13D400A1C7CD367FF56C0786CA16B2CCE3D40061C7CD3070057C0878B9F6B84CC3D40061C7CD3870557C0301B4B167FC53D40F2717CD3650657C08FA44B16AFC33D406A89277ED60757C0C77E49166FBE3D40A8B67CD39D0857C021EF9D6B74BC3D40FA4AD228890957C0A0FBF3C089BC3D40ACF97BD3BB0857C09859A06BCCBE3D4060FB7CD3950857C06FF54816BFC13D40372D7CD30D0957C019029F6B54C43D40DB0A7CD3210A57C0D97E49166FC53D40A6B67CD35D0A57C08FA44B16AFC43D40E4E3D128E50A57C0A0A44B162FC13D40B044277E3E0B57C0E014A06B34C03D40663E7CD3930B57C0381B4B167FC03D405F3E7CD3F30C57C08FA44B16AFC33D4088C1D128B90C57C0E0E8F2C029BF3D40904F7CD3390C57C08721F6C049B93D40A4B67CD39D0B57C02F85F4C039B43D40F8FF267E060B57C0C0339E6B0CB23D4000D97CD3890A57C02F084A169FB23D409E28D2289D0957C04F084A161FB53D408AC1D128190857C030D09F6B1CB63D40BE607CD37F0757C09F659D6BC4B63D406889277EF60657C0419EA06BE4B63D40F2717CD3650657C0DF14A06BB4B53D40F2717CD3450857C0B8914A164FB13D4040BB267E0E0957C0B8914A164FB03D40E6E3D128450757C048BD9E6B3CA33D40C2607CD3DF0657C017029F6BD49E3D40F2717CD3650657C017029F6BD49E3D400A1C7CD3670557C068AA9D6B5CA13D40964F7CD3D90357C0EF6B48160FA33D40AF44277E5E0257C0B027A16B14A33D407AA57CD3970157C0BF27A16B94A03D4002D97CD3890357C030D09F6B1C9F3D4030EA7CD34F0457C03FBD9E6BBC9D3D404206D228B10457C0776CA16B2C9B3D40CE7CD128610357C0B027A16B94993D407AA57CD3370457C00FE3A06B7C963D40904F7CD3F90557C0B8914A164F963D40EEEB7B65C20857C068F3409E3C963D40D6CD2A9E200B57C0C82B201A81933D4092C3792E6F0F57C0E0D47FE5A78B3D4064F34010B21157C020543681A9883D40E8967A9C1D1457C04057FD60CC883D404B70F5BFC31D57C03F12C0F8628F3D40FC81B541581F57C0B12C835820903D4036756BEDEB2057C0D91CE3E8FC903D40735AD128F52257C05972F3C059923D40EAD5AC38B72B57C0C0518D73A89A3D40BCC3F1D2E63257C07769D9FAECA43D402EF0B5FD913657C0787157B4DBAA3D40FC0D1A5A9A3A57C020AE261A67B13D4074A57CD3B74157C020D09F6B9CBB3D4020AD83790B4657C0A0073F0464C03D40C2308221C64C57C091713AF4D6C53D4022557FDD395057C0A0F1AB37BFC63D4034BD96B3BE5357C007739615E7C43D402B80D5961C5657C0D71DC85E15C33D403101BDD8AA5857C0BF2333E97FC43D405A1BFC8DEE5A57C018CF05C8ACC43D400A6F2872045D57C0C080B2913AC53D4062FB7CD3D55F57C0A00EF5C0E9C43D40A034B3ADBE6357C07F3CB3E55BC33D400C9C0A23036957C0AFCE1F8414C03D407AB5F938E06C57C0B89BA8381DBE3D406840D5FF516F57C000B0C940BCBC3D40120CF0D5157157C05037EEFAF0B93D40D403B078BF7257C09090F3B2B1B73D4096CF096C917457C0381B5D8C9EB53D40F6C1568F2F7557C0B7FA240A3CB33D4048F02454767657C0E13C2C2029B93D40DAD81A14447857C0114A315EF8BF3D40A4D04B55327957C040BD3AD172CA3D405E19D6E5D87857C00844F009A3CE3D4038F587E7DE7657C09FAE264AA0D13D4000DF50D2857457C0F09214ACFFD23D402015A8530B7257C03848AB8F44DB3D4001D97CD3697157C00798F5C099E73D40AABC320FA37057C0D7525E51E8F53D40F51C0F4B3D7157C091BC92E972FA3D40E4BE735A7D7257C0B0DC85462DFC3D40AED81B55197357C0F88CC1B650FC3D40F2B0FA4CF87257C0C1F9954480FD3D40034C2E80AB7157C00FD8621195053E409E2D61B3E66D57C02F7DFCAA6E143E40CFBA60B3646E57C040782EDE81173E402492FA4C4A6E57C04086FEAADE193E40515EC719776D57C03798C777EB1E3E40E8FC93E60D6D57C0308B6211CD243E40F7372D80196D57C0B8B29544E0283E40338693E6536D57C07719C9778B2C3E40515EC719776D57C0F03AFEAA46313E40BE7760B39A6D57C008316511FD323E40BA922D80396E57C08F0DC777BB363E40C2CFC619616E57C0088BCA774B393E40B27A61B3426E57C0BF7B30DE313C3E40051BC719A76D57C077E72EDE39413E40515EC719776D57C007A69544C8433E4050672D80C56D57C0207C2FDE89493E404E8B60B3B26E57C050EE9444404D3E40A252FA4CAC6F57C098B3954460503E400C7EFA4C207057C007FA954450543E406428C7195F7057C0F02B6411955F3E40FE5C2D80277057C008A4FAAA86643E40EAA660B3406F57C0106F62113D6A3E408DAC2D80B16D57C0A90C9644F8703E401C312E80356D57C0186360116D743E40FE8E2D80076D57C0C00764112D793E4054FC60B31E6D57C018ADFBAA367B3E409E2D61B3E66D57C07F656111DD823E408278FA4CD86D57C05027C77723833E409E2D61B3E66D57C070E1C8771B883E40B65594E6116E57C0305F964450893E40A162FA4C986E57C090EF9844788A3E40483D61B3C66E57C04FA7C677C38B3E406940C719C16E57C000B4FAAACE903E403E0AC819316E57C0083D63114D953E406A0AC819376D57C0C818C87783983E40C43F61B3F46B57C0F01EF9AABE993E40F4BA94E6D56B57C0685FC877739C3E40EE2595E6E76A57C08842C97723A93E40BC3694E65D6A57C081582DDE21AD3E40D07761B32E6857C067AFC9772BB33E4095FDC719916757C028932EDED1B63E4074F960B30A6757C058272FDE09C33E40B03B94E6B96457C04002FAAAD6D13E40967DC7195D6457C008FEC77723D63E404E8160B3466457C097B3C87763D83E40DCDA93E63F6457C0370830DE71DB3E409B24C719536457C0E8B1954450DE3E40F6F160B3A66457C047D264112DE33E40B03B94E6B96457C0C034CA7703E63E4010B82D80796457C0000A9544A8E83E4024E1FA4CE86357C0FF6C6311D5EA3E401EF3FA4CF06257C047CE6211CDED3E4004DC2D80896257C0A86DFCAA7EF03E4026C5C719716257C01F5DC977A3F13E401EF3FA4CF06257C0A8F0C777F3F43E4026B3C719696357C088689744D0F63E403A6B94E66B6457C07FABF9AA56FC3E4072CB61B3F66457C01F2EFBAA26023F40AE06FB4C086457C080EBFBAAD6043F400F212E806F6357C06812C97723053F409EF5C619B36157C04707CA77FB063F404E0C61B3306157C001A3FEAA2E083F40F66194E6F16057C0F00CC577C30A3F40E42F61B3346157C0B0FC30DE990C3F40B87D60B31A6257C05FC56311550F3F40C002FB4CD06357C040BF5F11DD183F40AA2AC719AD6357C080FEC877B31B3F4003D42D80136357C01F372CDE291F3F401EF3FA4CF06257C03FA9FDAAAE213F4039B0C619C16257C0308030DE192D3F40E84194E6196357C04F232FDE49313F40DCDA93E63F6457C0B04F30DE49323F40EC81FA4C7E6557C07FC5CA772B313F4028D060B3B86557C0BF6B954430313F4069CEC719EB6557C06741964448313F4012472D800D6657C0C01531DE81313F40B0B0C7193B6657C0E9286311FD313F403FF093E66D6657C0602E9744B0323F4018B9FA4C9A6657C04F6730DE99333F40687F2E80BB6657C010079444F0343F4080CA2E80FB6657C0307AC877C33B3F40C29CC719176757C0B032FEAA163D3F40BAFE2D806F6757C0003331DEF93E3F407AC42E80A16757C08FF0FBAA4E403F407690FB4CC86757C01093CA7713423F4086EE61B3E86757C0C0252DDE29443F407A4061B30C6857C0D095FCAA96453F4098D960B3386857C0E79B2DDED1463F40EAB960B36C6857C07F2D9644D8473F40B2982E80216957C02F159644704A3F40D04D61B3C46A57C000606411354F3F4062B0FA4C0C6B57C017E3C6776B503F40026A94E6416B57C0D869FAAAEE513F40920061B3626B57C0A0322DDEA9543F401F90C719516B57C02F5D5F1175563F40966AC719316B57C0E73DC877F3573F4044E1C719EB6A57C078F3C877335A3F40D7F460B3BA6A57C017C69444385B3F40228E60B3EC6957C0085232DEC95E3F405A2C61B3E26957C0DFE3F8AAA65F3F40DCD793E6FF6957C03F07944458603F401229FB4CE26A57C0786BC87763623F40BC1C94E6DF6B57C03755CA7713663F4051EA94E6816C57C07FF72CDE09693F40BAAC2D80B76C57C07747C977BB6A3F40E6BFFA4CE66C57C0976EC977EB6C3F401A4494E6156D57C05F6560110D713F40D6B094E63D6D57C020DB63112D733F403C732D80736D57C000086211B5743F4032BBC719B96D57C028DDF9AA76753F40BEC660B3126E57C06079974400763F4064F2C719D56E57C0C87ECB77B3763F40CAE02E80216F57C097C6C87743773F40E3222E805F6F57C0104FCB77FB773F406EF12D80916F57C05015FFAA16793F400C02C819B56F57C018CE9244407A3F4072AA94E6D76F57C00F0FCB774B7C3F4022072E80CB6F57C01F15FCAA867D3F40E108C719996F57C0D7052FDE897E3F408AD9C619ED6E57C0B8CDC5770B803F4010C22D80E56E57C048855F1125803F405678FA4CD26E57C0F023C9776B803F40533B61B3AA6E57C0C0342FDE29813F4020B7C7197B6E57C040ED64117D823F40428DFB4C826E57C02151FAAAD6833F409A6DFB4CB66E57C0D747CA77E3843F409FE72D80056F57C0701130DE99853F4088B7FA4C646F57C02877944428863F40E4B12D80F37057C077569744C8873F403667FB4C507157C06086CA7763883F40B3A8C7199F7157C0F78BFEAA16893F40929D61B32E7257C03F656411AD8A3F40F8D42D80E57357C087F22EDE31913F40463A61B3867457C0DFD05F1125943F409AB0FA4CEC7457C0C93865117D963F40C049FA4C187557C0C065631105983F401033FB4C4E7557C0C84EC9777B9A3F40515C94E6577557C0703CC7776B9C3F401033FB4C4E7557C09F1A64112D9E3F40F2E7FA4C0E7557C0FF95F9AAD6A03F40BC4094E6C97457C0DF0DC977B3A23F4088DFC719AF7457C0D8B3C97713A43F40D08C93E6997457C0CFB130DE39A63F400E8294E67D7457C0179332DE61AD3F4068CAFA4C647457C077056211BDAF3F40F2F9FA4C167457C0B04AFCAACEB33F4080532E800F7457C02FC6FDAA46B53F40DDD82D801D7457C0B7D760118DB63F4036602D80477457C0E0BC611185B73F40B2BD60B3787457C03F8561115DB83F405E6294E6B17457C0A8652BDE29B93F401A7894E6EB7457C06859C67723BB3F401ED8FA4C287557C0E0A2FBAA26BE3F40323FC719977557C0C0ABFAAA06C83F4009082E80C37557C0A70D631155CA3F4035372E80697757C070012EDEA1D23F40AED3FA4CDE7757C097489744E8D53F4054C82D801F7857C0D078FDAA66D83F40923961B36E7857C030F1C977CBDA3F40742EFB4CFE7857C03F96974430DE3F40630E94E6DD7957C0907730DE19E23F406EB5FA4C1C7B57C09859C6778BE63F404CAA94E6AB7B57C08F2D974420E83F40BD7E60B3C67D57C0302F6311C5EB3F4042792E800F7E57C06F882FDE69EC3F408B022E80557E57C067E0954430ED3F40B76EFB4C8E7E57C059192FDE19EE3F40EEAC61B3DC7F57C037AE2FDE69F63F4024A4C719298057C048D2C777A3F73F4084C061B3F48057C0EF882EDEC1F93F40A648FB4C5C8157C0BFB7FBAA7EFA3F40DD012E803D8257C000089544B8FC3F40542B2E80958257C07F1F954408FE3F40B2622E80B78257C0DF04964400FF3F40803EFB4CC48257C040C42FDE89FF3F40A9BB2E80C18257C01FBFE3BB41094040DEA02D80BD8257C050AA17EF44184040C8B593E6B98257C018D7B2884A274040698994E6B58257C004B67D554F364040D6D660B3B28257C040127E5553454040801B2E80AF8257C08CDF4A2258544040EAF72D80AB8257C0CCAC17EF5C634040060495E6A78257C07BD9B2886272404070E094E6A38257C05F47B18866814040DBDC60B3327757C000DC7D556B814040C2A0C619C16B57C01C41E5BB71814040988B94E64F6057C0C8B74A2278814040367F61B3DE5457C0C83A19EF7C8140402243C7196D4957C010E1E3BB818140403EFE2D80FB3D57C038B717EF8881404054B994E6893257C0D8BCB0888E814040C2B560B3182757C090C249229481404066A92D80A71B57C0904518EF98814040826494E6351057C0582D4A22A0814040205861B3C40457C07421E5BBA5814040061CC71953F956C010B6B188AA814040DA0695E6E1ED56C02CAA4C22B0814040C0CAFA4C70E256C0585017EFB4814040DE8561B3FED656C004E5E3BBB9814040CA49C7198DCB56C020BB17EFC08140403E3D2D80A7CA56C020DEE4BBD5814040E2FDC719C3CA56C06888B288A27D40409651FB4C68CA56C048FFB288627C4040D2A660B38CC956C02F4FB0886E7B4040D2B660B378C856C05F0116EFD47A40400A6761B376C756C0EC5CE4BB9D7A40407F7D94E6A5C656C0E4EA16EF107A40404ADE2D80D7C556C08CA94A22C87840407F1061B39AC456C0132D7E552B764040D67594E63BC556C0BCBE7D55F3734040B83D61B324C656C070214B22AC7140404664C7191DC756C0748BE5BBE56F40407C032E80EBC756C0D09116EF2C6F4040364561B388C856C0E8AF18EFE46D40400A682E8097C956C01FFB17EFBC674040A06061B310CA56C0C0777E55AB624040C297FA4CE4C956C060A117EFC0604040A2E32D8019C956C00C46E4BBB15F4040E024FB4CF0C556C0A7BF7E55CB5E40403CCD60B3CAC456C0B0F14A22405D40408E0E61B37EC456C0902A4C22005B4040A840FB4C84C556C088D87E554B5840406444FB4CB6C656C0148AB188C2574040D2B660B378C856C0BC5BB288A2574040A06061B310CA56C0C05AB18816574040E2FDC719C3CA56C017ADB0884655404020EAC719A5CA56C08408B1887E524040B23194E64DCA56C028B417EF0C504040A9BFC619C1C956C0FCCD4B22F04D40408ADEC71903C956C0C8D27E55234C404096E4C7195DC856C084ABE3BB394B4040AC9061B3D4C656C028207D558F49404098C793E659C656C028534A2290484040B1E660B336C656C0F49CB1880E474040F6DBC61967C656C01C93AF88864540407165C819AFC656C0AF1D4B22184440406B2894E6D3C656C084CFE2BBE1424040CA5F94E6F5C656C0680016EFA03D40408D112E80BBC656C0489D18EF883B40404651FA4CF4C556C0F8CB17EFB439404036DF60B3D2C356C068C817EF883740406A122E80D9C156C0584CE3BB21364040CD22FA4C66C056C070F716EFC03340401CB494E6D5BF56C06F6EE4BBA92E404000D3FA4C64BF56C0645F17EFB82D4040EC5061B356BE56C0E7CAAF88062D4040F04D94E619BC56C00C8F17EF702C4040566761B3A8BA56C0EF7F4A22802B4040187A60B33ABA56C010C87D55832940407D45FA4C72BA56C030564B22B0274040BE4CC719F3BA56C01CC5B08846274040BE4CC719F3BA56C074B5B0886626404088462E80DBBD56C01407E5BB7D214040566C61B3DEBF56C04047B28856194040,2.0%,8,400,37,363,Louisiana,true
17,0106000020E610000001000000010300000001000000290200007C1161B30AA956C01CAAE3BB814145405CB660B3DEA956C0DC8E7E55B33E4540BC43FB4C16A956C087CF7F55E33C45409A7C61B322A756C0BCA2B088463B454006DC2D8027A656C07CF17D55DB394540C08E61B330A556C0ACF017EF0838454088B960B324A356C0B3C117EF68354540B0782D80A59D56C0783A7E551F30454085F0C719A99B56C0187417EF202D4540C495C719899A56C06C2BB088C6284540C495C719899A56C074B8E5BBA5294540747F94E65F9A56C04B677D555B2245400AD8C619CD9956C0B39A4A22681F4540331EFA4CB49756C07C0BE4BB851D4540C4D7C719559656C00CD4B088861A4540FABB60B3789556C0906FB288D619454020BE60B39A9456C0B89B4A228C194540E41AFB4C228F56C0A0F34A2298144540E8A62D80798E56C058AF7F55A313454083E22D80DF8C56C0B4824B22C0104540DF8B94E6458C56C0D434B1882610454084532E804B8B56C0DF194922D40F4540BEBCFA4CDC8A56C0D48D4A22E80E4540D22BC719C18A56C083487E55670D4540D9A594E6C38A56C0087916EF600B4540C22461B38E8A56C0A8E84922A00945400A66FA4CFA8856C0140CE4BBE9034540522E2E80378956C027C17E5563024540509094E68F8956C024AC17EFF8FC44409823FB4CB08A56C004E24B227CF844402E1C2E80298B56C08C84B0889AF04440D67B2D80118C56C0BC0DE5BBD9EA44409AC4C619E18C56C0A7D97E5523E84440621FC719018E56C034EAB188FEE644401AE62D800B8F56C02CE44A225CE64440F06AC819BB9156C0388517EF20E3444083E82E80A19256C050FD7D55BFE1444010ECC719859356C044924A22D0DF4440155EFA4C5E9456C0940FB2883EDD44407AA5C619019556C0A46BE5BB65DA44400CB860B3409556C0B849B0889ED7444002FAFA4C2C9656C0DCA2E4BB19D5444000872E800F9656C0ACCBAF8886D44440BEBEFA4CD29556C06CB317EFF4D344405F87FA4CB09556C08C31E5BB35D34440BC4B2E80B59556C080E216EF2CD0444022F4FA4CD89556C04F54B188D6CE444034E8FA4C2A9656C0831318EF7CCD4440FA762E80239756C07C634B22F0CB4440FE32C719F39956C0CCA37E5583C94440C495C719899A56C0E0FE7E55AFC844407E5B2D80079B56C073EBE3BBE9C644402A7D94E6379C56C0A8C8B1888EC54440863A95E6E79E56C0C83C18EFF4C34440B93761B342A556C0888EE4BB35C24440389F60B39AA656C050DEB28856C144407C1161B30AA956C04CFBE5BBF1BC4440AADEFA4C58AA56C0B42F7E5523BB4440F25961B316AD56C0C0A7E4BBC1B9444066D2C71975BF56C030F2E3BB81B744404011C819FBC156C08CE017EFF0B444405C532E8081C356C01B0BE4BB01B14440F455C819D5C456C0681C17EFF4AB444034F393E6D3C556C03CDF7C555FA6444098C793E659C656C0506CB188D6A04440349B94E655C656C0485B18EF349E444022A794E603C656C000027E55FF9A44401D9F2D8045C556C0682DE6BB4998444022C994E6F7C356C004AFE5BB259744403290FB4C0EC356C01C907D559B9644401CB494E6D5BF56C04BE3AF88C69244406BB694E6FDBD56C0E0904A22DC8E4440A0AB93E6E5BC56C0A42C7E55A789444044C42D807FBC56C0EFC27D55BF8344400EC5C719BDBC56C0E80C17EFB87D444056582E80DDBD56C08C67B1881E7944402E9AC71935C456C000C4E3BBE96D4440849EFA4C56C556C034FFB088666B44407598FA4CFCC556C0800B16EF6C6944405E4EFB4C48C656C0B4A7E5BB6567444006EA2D807FC656C0C08E7E55C361444052EFFA4CE4C656C02867B088F65E444068072E8023C856C0C84F7D55CF59444062482E80CBC956C0A0E97C5513564440486061B304CC56C0B8E2AF889E5344403281FA4C8CCE56C06C72B1884652444016FB93E61DD156C05C52E3BBDD514440841595E615D356C014D1E3BB0D514440E6562D80F3D556C0446C7C55134F44408E7AFB4C88D856C0E8354A22A04C44401EDEFA4CA8D956C074E5B088664A44408486C719CBD956C04C94492284494440B015C71965DA56C080E2E3BB2948444046B594E687DA56C044067F55E7464440FCEC60B34ADA56C0A8F27E55CF45444088CAFA4C90D856C0EC20B0885E43444000D0C719FBD756C05C407D55474144400677C719F1D756C0201417EF003F444028FF60B358D856C0A4CD16EF103B4440A937C71959D856C0F876B188E2384440249DFA4C00D856C0F4EF4A227C3544400C27C819E9D756C0BF60E4BB99334440C60FFB4C7CD856C0C8197F554B324440D83361B346DC56C034C449229430444036D42D80F3DC56C0EC8AB0889E314440798461B3CEDE56C028337D55BB324440D2262E8097DF56C0BF60E4BB9933444054852E80E9E156C01CC84A22343744407A4A61B378E256C01CFEE4BB71384440B06393E64DE256C018977F554B3944402FA5FA4C50E256C0609A16EF2C3A444080142E8083E256C0239EB188123B4440C619FB4CE8E256C0AF5A4C22F03B44400EE293E671E356C0B86C18EF8C3C4440D8822E80BBE456C000FFE2BB6D3D4440FC4761B34AE556C078934A22203E444077A594E67BE556C08C99B188C23E44407A1861B398E556C04445B0887A3F4440585294E6C5E556C084E016EF10404440A45761B32AE656C097BA4A2250404440E6F4C719DDE656C05C027E554740444080212E802FE756C0A44EE4BB65404440E80694E679E756C070517E55BF404440D06394E6BBE756C0E0F6B088824144403749FA4C06E856C0F880B1884E4344404EA760B326E856C0C4B7E3BBCD434440142E94E6A9E956C04C384B225C454440740CFB4C0AEB56C0C368B188E6454440E87494E6A5EB56C0C098E4BB8146444025B294E61BEC56C0141F4A226847444032DCC71963EC56C0587517EF6048444018BDFA4C86EC56C0CCF87D559B4944400AA52E808FEC56C01C84E4BB454B444056252D80D3EC56C018DC4A220C4C4440F9CCC61901EE56C08C5FB188464D4440220361B344EE56C0C0CA7F55EF4D444099F82D80C3EE56C08C5918EF344F4440FC4E61B376F556C01054E4BB814E44407CF094E669FC56C01016E5BB814D4440C6FBC719DD0257C0731D17EF544D44401007FB4C500957C044134B22284D44405A122E80C30F57C0B31A7D55FB4C4440A21D61B3361657C08810B188CE4C444090186DC0AE1D57C0343B21A86E4C444068FE93E62D2257C018B118EF344C4440E80E2E80252E57C03C637E559B4B4440661FC8191D3A57C06015E4BB014B4440F308FA4C144657C0F4B54B22684A4440CA9C94E68B4D57C0D725B2888A4A444067392E80035557C040A716EFAC4A444048A660B37A5C57C018A6B088CE4A4440EC42FA4CF26357C0600419EFF04A4440726761B3366B57C0CC367D559B4A4440106560B37A7257C0ABC8AF88464A44409689C719BF7957C0F0D717EFF0494440F0B62D80038157C0CCF87D559B4944409C1B94E6698857C05C88E4BB894944404880FA4CD08F57C0F48817EF78494440FAE460B3369757C084894A2268494440AC49C7199D9E57C08007B38856494440A27E61B3B6A557C0CCF87D559B49444066BCFA4CD0AC57C088677E55DF49444055F194E6E9B357C038D67E55234A44401A2F2E8003BB57C0F4B54B22684A4440812461B336C257C050CAE3BBC14A4440E41994E669C957C00CCD7D551B4B44407E06C8199DD057C0C8CF17EF744B4440E8FBFA4CD0D757C088D2B188CE4B44405AE5C6190DDE57C0B87017EF104C444034BD94E649E457C0F40E7D55534C4440A5A660B386EA57C0949BE4BB954C4440807E2E80C3F057C030284C22D84C44409660C719C5F057C030284C22D84C44401E0AFA4CC6F057C030284C22D84C4440E6AA2D80C7F057C030284C22D84C44402C84C719C9F057C030284C22D84C4440735D61B3CAF057C030284C22D84C4440823FFA4CCCF057C030284C22D84C4440CA1894E6CDF057C030284C22D84C444010F22D80CFF057C030284C22D84C44405ECBC719D1F057C030284C22D84C4440EC74FA4CD2F057C030284C22D84C4440761E2D80D3F057C030284C22D84C4440F3EEC719D5F057C030284C22D84C44403AC861B3D6F057C030284C22D84C44404FAAFA4CD8F057C030284C22D84C44405F8C93E6D9F057C030284C22D84C44405824C819DBF057C0409918EFD84C4440E6CDFA4CDCF057C04C0AE5BBD94C44402DA794E6DDF057C04C0AE5BBD94C44403C892D80DFF057C04C0AE5BBD94C4440022A61B3E0F057C0507BB188DA4C4440CACA94E6E1F057C0507BB188DA4C4440D8AC2D80E3F057C0507BB188DA4C44402086C719E5F057C0507BB188DA4C4440366860B3E6F057C0507BB188DA4C4440AE38FB4CE8F057C0507BB188DA4C44403CE22D80E9F057C0507BB188DA4C4440FC8261B3EAF057C0507BB188DA4C44401265FA4CECF057C0507BB188DA4C44405A3E94E6EDF057C0507BB188DA4C44401ADFC719EFF057C0507BB188DA4C4440AE88FA4CF0F057C0507BB188DA4C4440F66194E6F1F057C0507BB188DA4C444004442D80F3F057C0507BB188DA4C4440FBDB61B3F4F057C0507BB188DA4C44408A8594E6F5F057C0507BB188DA4C4440D25E2E80F7F057C0507BB188DA4C4440E240C719F9F057C0507BB188DA4C4440271A61B3FAF057C0507BB188DA4C444075F3FA4CFCF057C0507BB188DA4C4440049D2D80FDF057C0507BB188DA4C44404576C719FFF057C0507BB188DA4C44405A5860B300F157C0507BB188DA4C4440DA28FB4C02F157C0507BB188DA4C4440E80A94E603F157C0507BB188DA4C4440AFABC71905F157C0507BB188DA4C4440BE8D60B306F157C0507BB188DA4C4440B62595E607F157C0507BB188DA4C444044CFC71909F157C0507BB188DA4C44408CA861B30AF157C0507BB188DA4C4440A28AFA4C0CF157C0507BB188DA4C4440B26C93E60DF157C0507BB188DA4C4440A804C8190FF157C0507BB188DA4C4440BEE660B310F157C0507BB188DA4C444006C0FA4C12F157C0507BB188DA4C444014A293E613F157C0507BB188DA4C444094722E8015F157C0507BB188DA4C4440221C61B316F157C0507BB188DA4C44406AF5FA4C18F157C0507BB188DA4C444077D793E619F157C0507BB188DA4C4440F8A72E801BF157C0507BB188DA4C44400C8AC7191DF157C05BEC7D55DB4C4440CC2AFB4C1EF157C05BEC7D55DB4C44405CD42D801FF157C05BEC7D55DB4C444072B6C61921F157C0605D4A22DC4C4440AE38FB4CE8F057C0A34316EFF84E44403AC861B3D6F057C0CB8EE4BBC9514440A00F2E8079F157C044C217EF90544440C6482E80B1F257C0481B7F55E3554440988894E60FF657C010667F5517584440CCB42E80C1F657C057BD17EF345A4440B85F2E80EFF657C050E1AF886E5B444030D92D804FF757C0CCA9AF88465C4440086E61B3A2F757C048CA4B224C5D444042262E80ABF757C0B83CB1880E5F44400031C8197BF757C0689BB188666044407636FA4C32F757C01CD6E3BB1D614440C65C2D8047F657C0570AE5BB8D62444087ADFA4CF8F457C068F9B188A6654440ADF6FA4C1CF557C004FBAF88BA664440849494E6BDF557C0A71417EF74684440AADD94E6E1F557C0945F7C55FB6944408A9294E6A1F557C0F437E5BBFD6C4440926461B322F557C050DA7D555B6F4440D361C719C9F457C0886AE5BBC971444087ADFA4CF8F457C034114C22FC7444406802FB4CC4F557C09C0B4B2220784440AADD94E6E1F557C0303117EFD47944408318C7199FF557C09B5FE4BB857C4440F0BE93E6A5F557C0F48FE5BBBD7D4440EC4CC81915F657C0B4BE7C55137F44400AE92D8035F757C05FF24A2294804440BC0794E6BDF757C0A84818EF8C814440969CC71911F857C0D8AB4B220C834440705CC819EFF757C03CE917EF1C84444042AA60B38CF757C0548F7D55CF8444408B9460B352F757C0141E4C227C85444042262E80ABF757C00768B0887686444078C493E6EDF757C0C873B0881E874440AC2E61B30AF857C0080AB1889E87444041C52D802BF857C0E4534B2200884440F1832D8077F857C04B39B1884A884440F1832D8077F857C06314E6BB15894440E4E62D8013F857C0707D17EFEC894440F6FD93E631F757C03CB518EF888D444010862D8099F757C0485C4922608F4440B696C719BDF757C02C5417EF74934440969CC71911F857C0A78FE5BB659544402D4B94E693F657C0F0A87E558396444068EAFA4C62F757C0282E7E558B974440825BFA4C40FA57C0E891E4BBF9984440246BFA4C20FB57C0C48E4A22949A44408EF9FA4C30FB57C05F817F55AF9C4440089361B3B0FA57C01CFB49221CA244407EAB94E6FBF957C0946CE4BBB9A244404EC42E809BF857C06C3F19EF08A544407C85FA4CAAF757C03CF2492288A74440DA0BFB4C44F857C0CCB74A22B4A84440E2BCC61961F957C0F87317EFF4A844400F932D8045FC57C00C667E5573AA444048212E804FFD57C060877C5553AB444081A3FB4CCEFB57C02359B1887EB344401E6EFB4CC8FB57C08CE017EFF0B44440ACFC60B32AFB57C0705C7F552FBA4440562E2D8093FB57C02038B18882BB444076BFC719FDFB57C0B06417EFD4BB444046C0C61987FC57C05C59E5BBC9BB4440686CFA4C24FF57C0302D17EFACBC44406E372D80070058C0D89C18EF7CBD44405D81C719690058C05B0B7E5507BF44400DC494E6490058C0446BE4BB3DC04440A6D52D80FDFF57C0D8F0B188E2C14440DAE7F94CA0FF57C0CF8916EF54C3444029D9FA4C4CFF57C0C83C18EFF4C3444013D494E635FF57C0ECBBB0885AC44440702EC719B9FF57C0885AE4BB39C544405883C719850058C02CF917EF18C64440FE1FFB4C480158C0B4D77E557FC644408CC12D80D30158C0C03FE5BB31C644401EF1F94C1A0358C0E75CB088F6C444407E1695E6E70358C000ED4922D4C44440C28F94E6410558C0072C4A2260C64440C4B261B3560558C0C8C54A220CC94440621BFB4CF80458C0243DB18892CB4440F735FA4CFA0458C0DC26E5BBB1CC4440A64EFB4CDC0558C08859B288A6CD4440CAF060B3560658C0083EE5BBF5CF4440F0032E80850658C034887C55D3D24440B0D193E6790658C07C55B08846D84440CAA061B34E0658C0B4AB7D553FD94440A09EFA4CE40558C0EC307D5547DA444052E0C619390558C00CDD49229CDB44403AB893E60D0558C0CC66B28832DC444072D261B3220558C090837D55EBDC4440BAC5C719370558C0340EB188A6DE4440B64B95E6E70458C000B016EF14E14440F6A960B35A0458C0F4F317EF64E34440562FFB4C1C0458C09853E3BBE1E54440EB64C719BD0458C0145CE4BBD1E84440985C2E80830858C0ACC47E55DBEE4440481B2E80CF0858C0441D18EF90EF4440CD9A94E6D10958C0AC807E55F3F2444020D494E60F0A58C030C3B0881AF44440427EFA4C000A58C0EC674B229CF54440646F94E65D0958C02BEB16EF1CF84440FEA3FA4C260958C010CE4B2258F944403A9160B3E00958C0902719EF70FE4440C4602D80330C58C0A88F17EF4C014540143394E6DF0E58C0AC494B22B40345401CD2FA4CA81058C0B4684B2268074540042FFB4CEA1058C0A09B4B22400A4540D2E7FA4CE21058C0180CB388E20C4540E23C60B3001158C0548A18EF4C0F4540315494E6B51158C094047E557F1145408158C719D71258C098437E550B134540A6B5FA4CFC1458C0449AE3BB391545409E5F60B3E61558C0A4224B22381745401681FB4C7C1658C050A6E4BB551A45405C62FA4C401658C09CD7B088B21C4540297CFA4CB81558C090C315EFD41E454002F660B36C1558C0784DB1884E214540AE27C819891558C0A05B4B224424454023A1C719E91558C09FAC17EF6C264540E0FCC619991658C08CCC4A221C2845407AEBF94C801758C0F04A4B22402945402CCD61B3941758C06337E3BB512B4540AEE5C719BD1958C0C4187C553B2F4540A16294E66B1958C0371CE5BBA5344540711A2E808B1858C04C88B1884A3A4540B04D2E806F1958C013B07C55933F4540CD9994E6871A58C040BC4A22D8404540B07C2E800F1C58C0687918EFA441454088C494E6E31E58C0F0EF18EF58424540567D94E6DB1E58C058E37D55DF464540CE1961B3501F58C04FB1B1886A4845408C1CFB4CAA1F58C09C547D55C3484540494CC719F71F58C0283C4A227849454060012E80052058C0D0287D55434A454098962D80F91F58C088EFE3BB4D4B4540E09294E60F2058C074F4E4BB114C4540DCAE60B33E2058C044947E55CF4C45404C8A61B3AA2058C080D0E4BB014E4540904994E6E52058C0FC7D7C55874E4540FCDEFA4C282158C0B8A3E3BBF54E4540B217C819772158C07335B1884E4F4540261F61B3922258C03C3EB2884A50454089FD60B3AA2258C05058E3BBA95045401FC860B3A42258C044734B22FC504540AA732E80752258C0945CB1887E514540F191C619612258C093317F55A7514540769E94E6B12158C0CCE1B088865245404A32C719792158C0F03517EF14534540097CFA4C8C2158C0D0427D559B534540CBB2C719BF2158C00068B1881A54454051932E80412258C0449BB188FE544540544CFA4CD42258C014CFE4BBD155454001682D803F2658C058C97E55A35945403B6FFA4CC02658C00CE649225C5A45400F43C719572758C070D0B0886A5B4540A033FA4C5A2858C010FCE3BBC15D4540396060B3AC2858C0B0784B22185F45406E94FA4CD42858C0683FB2882260454014932D80A72858C0C8404B22E4614540988CFA4C642858C0ACA0B1881A634540D8FCC719DB2758C0D40C4B22E8644540F6112E80DD2658C038C94A220C674540B913C719AB2658C05C8E7D559B674540A86561B3822658C02C7C16EF44684540522E61B3602658C0B40419EFFC68454012FAC619392658C0781019EFA4694540008294E6052658C01C05B188326A4540E03694E6C52558C040364A22AC6A4540384261B3842558C00C1B7D55076B45405AAF2D804D2558C0549CB2883E6B454092D0FA4C4C2458C094664B22E46B454080FFC7190F2458C0EFB717EF186C454005F293E6E52358C010FBB288966C45406043FB4CCE2358C01C12E5BB496D454083ED60B3BE2358C013A3E4BBF96E4540C2E261B3A22358C0206C17EFC06F454032BD61B3822358C0344FB1884E704540B6EC61B3342358C0C750E5BBC97045407A95FA4CF82258C0B077B2881671454062C6C719D72258C0000117EFA8714540EE3261B3B02258C0642D18EFA8724540C2F261B38E2258C0949B7D5527764540002F61B3782258C0BC6916EF0477454078D32D80632258C0A490E3BB5177454085E12D80332158C0CCD14A22487945406C9F2E80F52058C09C23E5BB197A45404E4B2D80B32058C04045B188967B4540A4B860B3CA2058C0FF274B22187E4540E4E1F94CD42058C05700E6BB897E454070D361B3CE2058C018624A22E07E45408565FB4CC82058C08CF5B088067F4540BC0B61B3802058C0A46CE4BBA97F4540B61E62B3142058C010FDB0886A8145404AF3C619ED1F58C054A17D554F824540989F2E80FB1F58C0A43CE4BBE58245409712FB4C182058C00CC8E5BB49834540E442FA4C542058C09F464B22C083454020EA60B3982058C0E4A47D557B844540A89393E6992058C0EC5CE5BB3185454018FDC619792058C068BC7D55CB85454042F3FA4C581E58C02B11E5BBD9884540C572FA4C121E58C038B74A228C894540E68FC719D31D58C070EA4A22708A4540C04EC719251D58C050C016EF948F4540E15A2E80211D58C06CF2B0889A904540F2EEC719371D58C0BCF67E556F9145402EE42D80671D58C0780BE5BB65924540EAA02D80971D58C060EDE2BBAD934540B2AA2D80231E58C07048E4BB41994540D09C2D80591E58C0D4BE7F55A39A4540628CFA4C841E58C0D0D04B22409B45400E812D80C51E58C08384AF88BA9B4540F050FA4C241F58C0CFA5E3BB019C4540205361B38E1F58C024C317EF109C4540D4ED94E6352058C0F8584A22F49B454006A8C619A72058C0F8584A22F49B4540A611C8191D2258C04F02B388569C45401EA694E61B2358C0F061B088429C4540CA532E80A32358C054617D55539C45404AB1C619212458C09C82B1889A9C45408745C719852458C0501DE5BB419D4540F40E61B3A02458C0E804B288F69D454040C52D808D2458C0C8E6E5BBA59E4540A20B94E6572458C0884C4A22349F4540047FC719C92358C004BBE5BB25A04540909260B3982358C07C57B2889AA04540107DC719AD2358C01447E4BB11A14540A4F92C80072458C070B318EF98A145402410C7197F2458C094E917EF28A24540DC2E2D80072558C008424C228CA34540C2F593E6172558C050634A226CA44540C6D9C719E92458C09CFEB08802A54540CE5494E67B2458C05898E3BB1DA54540FA1E61B38C2358C090EDE5BBF1A445401EA694E61B2358C0F48CB18812A5454020442E80C32258C078D77E5563A5454007F92D80832258C0E37FB088D2A5454000B393E6592258C030584B2244A6454098F0FA4C242258C00F23E5BB69A94540B48294E61D2258C05F62B08802B0454086D12D80472258C09B73E4BB5DB1454007F92D80832258C0840F7E55E3B145406E8FFA4C9E2358C08457E4BBBDB3454034CF2D801F2458C0CBBE7C55C7B445405AAF2D804D2558C057DCE3BBB9B645400E772E809B2558C06C944B2270B74540DA9194E6EB2558C0A8D0B188A2B84540D95B61B3F62558C01C7F4A22B4B945408CB8FA4CEA2558C01C9217EFDCBA4540A05DFA4CC42558C0B03DB18842BC4540D815C719CD2558C09C884C2230BD45404CA92D80F32558C0E4094C2200BE4540B374C7192B2658C0D05C4C22B0BE4540528561B34E2658C0E8484C228CBF4540BACBC719192658C0FC334B22DCBF4540043BC719071D58C07FA94A2204C04540326EC719370858C07FA94A2204C0454026AAC61967F357C09CFCAF8806C04540CA3394E695DE57C0989DE5BB09C04540F66694E6C5C957C0A80EB2880AC04540249A94E6F5B457C0A87F7E550BC04540989D2D8025A057C03832B2880EC04540FCC72E80558B57C043A37E550FC0454070CBC719857657C048144B2210C045405E96FA4CB46157C073D87C5513C0454090C9FA4CE44C57C073D87C5513C04540F8B88C547A4657C08BF1B8D313C045408405FA4C143857C090BA15EF14C04540A9C72D80432357C08CCC17EF18C04540D6FA2D80730E57C0903DE4BB19C0454081F5C719A3F956C09CAEB0881AC04540F6F860B3D2E456C02C61E4BB1DC04540A2F3FA4C02D056C038437D551FC04540C6C02D8007D056C01BAA7D55F3BF45409E66C7191FD056C020B97C5553BE4540784094E60FD056C0449EAF88BABC45407CAAFA4CDECF56C004FA18EF3CBB45406AB6FA4C8CCF56C080BF4B22D8B9454074CD60B3AACE56C0A4547D553BB74540E811C71959CE56C0D85418EFF4B545408AC0FA4C24CE56C07F614B2298B445406DB42E80DBCD56C0DF10492214B145407EF7C7195DCD56C013417C55BBAF4540E5452E809DCC56C0B05B4C22D8AE4540B049C8191BC756C04C09B18886AB454046D5C71989C556C008B97C559FA8454022DCC6196DC556C00C4BB288DAA345400DD7C7199FC656C0103417EFE89F454052BDFA4C04CA56C0508C17EF009945407DC8C719BDCA56C0E8C7E4BB89944540806661B364CA56C04427E4BB918B4540087194E6E5C956C043027D553B874540DE2994E6DDC956C04C164A228882454094DD2D80BFC956C02884E4BBF9804540B4272D8073C956C0D86D4A22887F4540E3FB60B35EC956C028F8E4BBA579454060B193E60DC956C0D4E8E4BBD1764540560B2E805BC856C05456B188A6744540063A2D8087C656C00CB77C55477145406E0461B3E6C556C0E4BBAF887A6F4540A840FB4C84C556C0F018E4BB2D6D4540EE7AFA4C52C556C0D0B017EFC0674540218361B316C556C0786D49226065454046A6C719E9C256C0F4DE18EFFC5E45405EE0FA4C1CC256C050E87E55575D4540C46A94E6ABC056C0BCD37D55B35B454096B7FA4CDCBD56C068F1B188CE594540025CC719EDB256C0E8914B22A45645409B3E60B300B056C033A716EFF8544540D4C02D807FAE56C0E87417EFA0544540561394E6FDAC56C0A804E3BBE1534540166DC719FDAB56C0B78D4A22F8514540848DFA4CBEAA56C0809A4A22C44C4540A2F160B338AA56C088EFE3BB4D4B4540EDE2FA4C9CA856C0D37C4B22A84745403E3561B314A856C0AC3BE4BBB14545407869FB4C3CA856C0336118EF3C4445407C1161B30AA956C01CAAE3BB81414540,-17.9%,-37,170,16,154,Iowa,true
14,0106000020E610000001000000010300000001000000E60300004398C91A15035DC08C3378B70A7F4840094EFB4C16035DC0445FB0880E7048401E3094E617035DC05CFD16EF04614840AED9C61919035DC0749B7D55FB514840331B2E801B035DC08B39E4BBF14248407AF4C7191D035DC084F5B188E63348400A9EFA4C1E035DC0B775B188DE244840D1AFFA4C20035DC05F2516EFD4154840178994E621035DC0E8B17E55CB064840178994E621035DC0F84517EF78004840AA4C2E80E9025DC0DC884922ACFF47409B6994E65B025DC0D864B18872FE4740FBD260B3F2005DC0D00A492294FC47409355FA4C12FF5CC08852E4BB61F947406CFA2D8051FE5CC06C8249226CF747401C21C819BBFC5CC0C4564C227CF44740891F94E63FFC5CC003877F5523F34740768494E6F7FB5CC06F3FB1887EF24740F937C7198BFB5CC0A0C2E4BBD5F147407AC8C719BDFA5CC0DCD04B22F4F04740D64E61B30EFA5CC0338C7C55FBEF4740705594E657F95CC094D317EFBCEE474060A82D80BFF85CC0CF817D55EBED47404C4860B33AF75CC030B716EFA8EC474036C7C719B9F65CC0F0EC7D5503EC47404C2D2E804FF65CC04497E3BBF9EA4740A738FB4C0EF65CC0B80F18EF34EA47408770C719D7F45CC0730D4B2210E44740EE9C61B38EF45CC0CCB4B1885AE347404D7A60B31AF45CC033EB4B22A4E24740C2C560B366F25CC094BCE3BB39E147409DB02E80CFF15CC0C4CE4A2290E04740E05494E66BF15CC0C04AB18866DF47405EDF94E643F15CC09C6A16EF84DE47408C37FB4C10F15CC0544918EFA4DD4740AC28FA4CBAF05CC0BC614B22F0DC47402AA82D80DFEE5CC0C44D7D553BDB4740B87C2D806BEE5CC0D3BE7F55A3DA47400F4B61B302EE5CC0F492B18892D9474028112E80D5ED5CC05883B188B2D847403E4AC719C5ED5CC0F4FC4B22CCD747405672FA4CF0ED5CC0E85B7E559FD44740D0302E80A1ED5CC0A453B08892D3474041A960B3E0EB5CC0F04C7E55D7CF4740AC092E8071EB5CC004C5E4BB75CE4740C61FFA4C4CEB5CC088044A2260CD47403AB360B372EB5CC0C3E77E55A7CC4740FF7FC719D7EB5CC0EBD517EF5CCB4740B3EEC7191BEC5CC0E4634A22D0CA4740B2F72D8069EC5CC05C7418EF58CA47406980FA4CC0EC5CC0BB24E5BBF1C947409AADFA4C4AEE5CC0A85AB1889EC84740662161B3A4EE5CC024ED16EF38C84740EF122E80EBEE5CC0BC32E3BBC5C747408BDD2D80E5EE5CC07886B1881EC74740D6FB60B384EE5CC0B77AB18876C647402A94FA4CDEEC5CC0DC82B188F2C44740613AFB4C4AEC5CC03425B28826C447400D9893E6CDEB5CC0B0EAE4BBC1C2474015E62D806DEB5CC08C567D551BC04740CDBC94E663EB5CC0CFDAB188FEBF47400540C819BBEA5CC08F21E4BB69BF474029C6FA4CBEE95CC0E0F77C55C3BE47401B9361B328E95CC08CFD4B2230BE47407C0FFB4CE8E85CC01BA618EF58BD4740D246FB4C0AE95CC06C7CB188B2BC474064A994E651E95CC0109FB0882ABC4740625BFA4CB2E95CC0E04E4A22D4BB47400425FB4C1CEA5CC04045B18896BB4740CB0B2E8093EA5CC08488B18866BB4740466C93E64DED5CC0B7A37E550BBB4740B54794E6B9ED5CC08C87B088DABA47403A9261B30AEE5CC068BA18EF88BA4740E563C71937EE5CC0486F18EF48BA4740446594E663EE5CC06002B188D2B9474086B1FA4C82EE5CC074554C223CB94740E2DF94E655EE5CC00832B1888AB8474022BA2D80E7ED5CC0C8E44922E0B7474037B5C719D7EC5CC074154B2224B74740A94F61B352EA5CC04C72E4BB1DB64740C6D2FA4C84E55CC0541E4B22B8B14740C6102E80EFE45CC068A87D55F3B04740F1202E80E1E25CC0F4E415EFA0AD4740A13FC819D5E15CC0A01CB18882AB4740E91761B34AE15CC093037D55B7A9474084C793E6A5E05CC09C727D5507A8474087652D804DE05CC0BC36E5BB71A7474040ED93E6CBDF5CC07CAC4922ECA64740654694E6DBDE5CC0D8B7B1885EA6474047F960B3A2DB5CC093A77E558FA54740AA6794E6DDD55CC0F8537D555FA2474031A8FA4C54D55CC0F0F3B188D6A14740238F2D80D1D45CC057E917EF0CA147403D66FB4C1CD45CC0601BE4BB819F4740512DC7197FD35CC000F77D55AB9D4740D5B5C7193BD35CC05C3EE3BB059D474079C560B3D2D25CC0982118EF4C9C47407D86C7198FD25CC0ACDFE2BBAD9B474048022E805FD25CC0F7C77D550B9B4740142594E625D25CC03B87E4BBB1994740D06561B3EAD15CC0D0154A2214994740A1BCFA4C8AD15CC0644A4B2290984740C2AD94E6E7D05CC0606C17EF189847406FBB2D8063D05CC090414A229497474075E6FA4CEECF5CC0CF354A22EC964740593994E655CF5CC04C64E4BBC59547408ABEC719C9CE5CC05CDD4B22F0944740950AFB4C04CD5CC0E4F8E2BB3993474068FF2D804BCC5CC0BC077D5547924740096F61B38ACA5CC08BBCE4BBDD8E4740DFCDFA4CA0C95CC05449E3BBE18B47401218FB4CE8C35CC06C0618EF1C834740D8EC61B3C2C35CC0B8FA17EF74824740F9A72D8077C35CC03804E3BB21804740215B94E669C35CC030AD7D55E77F4740EDF9C7194FC35CC0103FB088927F4740799A94E601C35CC060EA16EF147F4740D4B6C71985C25CC0686CE4BB8D7E4740DD0361B398C15CC00C8FE3BB057E47407227FA4C54C05CC0739FB1888E7D4740B98461B3EABF5CC00C977E552F7D474065B5C7197BBF5CC0AC197F55977C47400DCCFA4CB0BD5CC0637A4A22387947401C3261B346BD5CC0B402E4BBA57847400D58C819BBBC5CC0B861E4BB097847403E3DFB4C22BB5CC06C6E17EFAC764740F9A8FA4CBEBA5CC0588B7D551F76474024CD2D80B1BA5CC0889DE4BB757547400273C719C9BA5CC0A82C7D55C774474075062E80EFBA5CC0683F17EF0C7447407079FA4C0CBB5CC0F899E4BB497347407743C71917BB5CC033CB18EF7C724740E1ACFA4CF6BA5CC050AAE4BB41704740EC872D80C5BA5CC0E851B088DE6E474085A2C7197BBA5CC0F0ECE3BB916D47401454FA4CF2B95CC0A02DE5BBC16B4740E95A94E689B95CC0A40917EF206B4740A2BF2D80F3B85CC02C87B188726A47407AF893E6FFB65CC0943E18EFA868474036F361B34EB65CC05CEDB088C66747404E2294E663B55CC074424A225066474061D894E6B5B45CC014CDAF887A654740E170FA4CAAB35CC0181BE5BBCD644740C996FA4CD6B15CC0703F7D55136447408F62FB4C62B15CC0EBD1E2BBAD634740BFC4C6190DB15CC047DD4A22206347406423FB4CD0B05CC0904A7C553B624740C8A6FA4CC2B05CC0589A4A225C61474002EEFA4CCAB05CC0FC24B0888660474080FB93E63FB15CC0DC654C22705D47402CB12D803DB15CC064D1E4BBBD5C47403D062E800FB15CC0E8EE7D551F5C47404D1594E6B7B05CC0D3BDE4BBA55B4740A96EFB4C16B05CC07CCBE2BB6D5B474005822D8097AF5CC0E00BE4BB915B474016E893E62DAF5CC0900E7E55EB5B4740985DC719C1AD5CC0D0207D556B5E47402670FA4CB8AC5CC0F0A97C55AB5F47406F8E2D8057AC5CC054A1E4BBF95F4740BF9294E6E3AB5CC0F40A7F55276047405C7F60B366AB5CC0D85718EF3460474005252E80E3AA5CC08488E3BB11604740DCD2C71971AA5CC04479B188CE5F4740A382FA4CD2A85CC0A0F3E3BB295E47409C8CFA4C64A85CC0ECB8B188725D4740DCFCC719DBA75CC0BCCA4A222C5C474085C5C719B9A75CC04C504A22405B4740B42694E6D3A75CC080217D55835A4740E26EFA4CB4A85CC03BCBE5BBF15847400711FB4CE2A85CC0502AE6BB5558474025372E80F1A85CC09C4E7E559B574740D5C9FA4CDAA85CC0CBEF18EFF0564740E26EFA4CB4A85CC0A778E5BB4D564740944F61B33CA85CC0C873E4BB895547401FC4FA4C8CA75CC0C8EC4B22B4544740675E94E601A65CC06F17E6BB5553474038BD2D8017A55CC050224A22C4524740C9BEFA4C4AA45CC0E83CE4BB795247408F6F2E8037A35CC020A7B188965247409BF960B372A25CC04BD44A22D8524740E3B6C719FDA05CC02097B188AA534740490E94E68BA05CC004D8E5BBBD53474099D3C61921A05CC058AF7F55A35347406DFEC719119F5CC0709017EF18534740B42F61B3909E5CC0B4F6E4BBFD5247401F372E80179E5CC050CCE5BB15534740A02995E6A19D5CC0A80BB08846534740BACB93E6D39C5CC0ECA616EFDC53474032FC2D80C99B5CC0088BB188F65447400AFAC6195F9B5CC0449AE3BB39554740E4F2C61907975CC0682C4922C8564740F8EE61B382965CC030974922D4564740F27C94E6F5955CC090627E55BF5647404E99C71979955CC0ACAC7D5573564740486D94E615955CC0F757E4BBF55547401B37FA4CD2945CC07C1E18EF1C5547402FAFC719B9945CC0A7EAE4BB495447409932C719AB945CC048754A227453474084A02D80B1945CC0B8AE7E55235147405BC294E6E7945CC030BD4A22944F4740F708C7194D955CC0AC1617EF444E4740F94E61B376955CC03F94B188964D474081AA94E68B955CC0384D16EFE04C4740C1B060B380955CC09C067F552F4C474086DEC71965955CC05C2AE4BB854B474053CDFA4C52955CC060F54A22D44A4740B05BFB4C62955CC0BC9CB1881E4A4740AC77C71991955CC024E416EF78494740A54CFA4C06965CC0C0F449225448474098A7FA4C2C965CC0FCFA4B22B047474011C894E635965CC00FA84B2200474740EC3F60B31A965CC0EB3018EF5C464740E241FB4CEA955CC03848E5BBC945474058C3FA4CC0955CC0DC3BB288324547409F79C719AD955CC0006B492294444740E7C52D80CB955CC04C53E4BBF1434740CEC92D8003965CC0E075E3BB69434740221DFA4C54965CC0F88B4A22F8424740A5C0C719AF965CC080A17E5597424740F83661B314975CC0505118EF404247408AB52D80D3985CC0B300E4BB4D414740B85E94E633995CC04F8C4A22044147408529FB4C7C995CC08F18E4BBA940474022C0C7199D995CC04F5F16EF14404740967E60B39A995CC0CCFB18EFF03F4740A94F2E808B995CC0741B19EFBC3F4740119694E655995CC038024A22383F4740682D94E66B985CC04BA5E2BBAD3D47400F60FA4C18985CC0348EB088FA3C47403CEE93E6D9975CC0542F4B22503C4740100795E6C1975CC0E70BB0889E3B47408F752E80B7975CC0082BB388E23A474025E92D80C3975CC0542C7E55133A4740A12394E6DF975CC03810E6BB4939474015B7FA4C06985CC02035B1887E3847408479FA4C84995CC0274119EF083447407BC194E6C9995CC0B4C517EF9032474052102E80F3995CC0A0A47E550331474076DD60B3F8995CC018134C22642F4740746A94E6DB995CC0C84AB188DE2D4740BC932D80E5995CC0B010B288162D4740D1A194E6FD995CC0289AB188622C4740BA9C93E6339A5CC0ABB74A22C42B4740F4E3FA4C849B5CC0A3F4B0880E294740F9EA60B3B69B5CC0C883492260284740E57B94E6D19B5CC0204917EFA8274740480A95E6E19B5CC0EFE5E3BB2926474020002E80019C5CC03C1C7E55732547404763FA4C389C5CC003E118EFCC244740F98160B3C09C5CC0931419EFBC23474047FA94E6F59C5CC08CA24B2230234740594FFA4C149D5CC0849CE4BB8D224740A67F94E6039D5CC06CF67E55DB214740BACB93E6D39C5CC010D3E3BB29214740B6C22D80859C5CC0B05D4922542047404DBAFA4C269C5CC01041E3BBED1E474051472E80099C5CC0A0BE7D553F1E474091FDFA4CF69B5CC0243C18EF901D474009CFF94CD49B5CC088567F55631B4740E23EFB4CAA9B5CC0D8457E55F719474094EB93E6A59B5CC0A44616EF38194740D56D2D80B99B5CC0D0B87E557F18474026572E80EF9B5CC0743B7F55E717474094AD60B33A9C5CC0F01BE4BB6D174740DA4161B39E9C5CC07742E3BB1D174740594FFA4C149D5CC0A0C1B188EA1647402762C719379F5CC0F0B2B28896164740A65594E6999F5CC0D0F6E5BB55164740FF5861B3E29F5CC030B87D55FF154740EDAA60B306A05CC0AC7FB288B215474011F460B32AA05CC04031E5BB29154740D2E493E633A05CC0E401E5BB7D1447402D86FA4C24A05CC0147316EFD0134740F68E94E6D79F5CC0985C17EF0C1347408E2C94E64D9D5CC08C98B288320F47400144C819099D5CC078A316EFA00E4740803F95E6E19C5CC098D3E4BBF50D47408F5761B3D89C5CC01CCEB088420D47403AB6FA4CE89C5CC077F24822880C4740040594E6119D5CC06B5EE5BBD90B474039E22D804B9D5CC0F4EC4A223C0B474009F494E6959E5CC01FD1B2887E08474094B993E6C59E5CC0183C18EFDC074740AA20FB4CE89E5CC0E8304B2224074740804AC719E19E5CC04C15E6BB49064740D1FE93E6B19E5CC04C77E5BB590547408586FA4C309E5CC090CAE5BB150447403C8A93E6199E5CC040A34A222C0347407E0C2D802D9E5CC034DA17EF64024740FFC961B34E9E5CC02CA57E55B3014740440461B31C9E5CC0F7F315EFE0004740FB71FB4C889D5CC0C066B18816004740595FFA4C009C5CC030994B2228FF464066CEFA4C509A5CC0640A7D557BFE4640EE312E80DB995CC0DBAEE4BB19FE46400DD52D8099995CC08C1BE3BB45FD4640C6A293E68D995CC0E42EB0887AFC46400EF8FA4CAE995CC094DCE2BBB9FB464066CEFA4C509A5CC034AC17EFE8F946407DF62D807B9A5CC044E84A2238F9464021AEC719959A5CC02BAE4B2270F846403F632E80A39A5CC04C2C19EFB0F7464021AEC719959A5CC0C414E3BBF9F646406EBB94E66F9A5CC0BC914A225CF64640810794E63F9A5CC0C00EB288BEF54640C537C719E7985CC06B0717EFACF246409F47C719CD985CC0889F4B22B4F146406E7C94E6E3985CC0384D7E55F3F04640AA23FB4C28995CC024DBB08866F046401CB0C719B19A5CC0D8EF7E5533EE464070CD60B30C9B5CC0009A7F55D7ED4640C29CFA4C7C9B5CC0B4784B2290ED464091FDFA4CF69B5CC0347418EF68ED46400C6660B3269E5CC0DBC24A2244ED4640830B2E809D9E5CC078117D551FED46403CAEC619079F5CC03C7317EFDCEC4640B4E92D80AF9F5CC06862B1881EEC4640EABDC619E79F5CC01CFBE2BBADEB4640E94295E607A05CC06C7B17EF58EB4640297594E65FA05CC0B302B0883AEA4640D7B8C71919A15CC0F0CAB28896E846406AE72D8087A15CC000A6E3BB69E74640183361B3B6A15CC0F4F318EFBCE64640053761B3EEA15CC0FC4017EF1CE64640F5CEFA4C3CA25CC0ABE6E4BB99E5464013962D80E7A25CC020AD18EFC0E44640AC7294E631A35CC028CFE4BB49E44640743695E647A35CC03B7CE4BB99E346406B49FB4C28A35CC084FB17EFB8E24640BA9260B39EA25CC0F3244C227CE14640D11B94E649A25CC033A67D55BBDF46409DF0FA4C24A25CC0AC524A221CDF464061CDC619C1A15CC0BCEE7E555BDE4640818061B31EA05CC01CA5E4BB05DC4640597EFA4CB49F5CC09066B28816DB4640667CFA4C989F5CC0200F7F553FDA4640F2DE93E6DF9F5CC0CB4F4A2208D946408638C719D99F5CC004E57F5563D84640D122C7199F9F5CC0146EB18812D74640E60D61B3A29F5CC0A3394B2250D6464076DA60B3B89F5CC0547B17EFA4D5464013EBFA4CDC9F5CC014C2492210D546407F0D95E601A05CC0543D18EFA4D446406FAF93E62DA05CC0FC874A2248D4464032012E80FFA05CC084824C22FCD24640184E2E8055A25CC0C83716EF60D14640CDB32D8097A25CC00401E4BBE1D04640C1B52D80B3A25CC028134B2238D04640390AFB4C96A25CC0FF73E4BB69CF464002E7C61933A25CC09C897D555BCE4640B7B6C719F7A15CC01F617C5593CD464092C6C719DDA15CC078157F55CBCC46409A5A61B3F2A15CC0F00F4B2218CC4640C2642D801FA25CC08F6F7E556BCB46409A7E94E6DFA25CC008DE4B22CCC94640D33661B3E8A25CC0676B4B2250C9464079C2C7199FA25CC06C1C4B22D8C84640F52FFB4CBCA15CC0D0B2B088AAC84640556594E679A05CC0E0944922ACC84640C8D1FA4C769D5CC060DE4B22D8C746403F0DFB4CD69C5CC05CD5E5BB89C746401600C719B99A5CC0F3D24B223CC54640B4C160B3649A5CC0B41418EF90C44640326D2E80359A5CC0005717EFD4C34640A3972D801D9A5CC084D4B18826C346406C24FA4CB2995CC0D016B1886AC2464014FEFA4C08995CC0D4D5B288BEC14640E826FA4CE0965CC03C9EE4BB05C04640DCE2FA4C86965CC084AC4B2224BF46403C5F94E645965CC0F0AA17EFA8BE4640767861B3CE955CC040567E552BBE4640177F94E617955CC03C4D18EFDCBD4640F0C9C619C1935CC058E916EFB4BD464058712D800B935CC01029E5BBE9BD46405D822E8083925CC018A317EF38BE4640CC6D94E627925CC074B7AF8892BE4640306494E6A1905CC0C8C4E3BBB5BF4640E5DA94E65B905CC058807D5507C0464001142E804B905CC078F6AF881EC04640A81061B302905CC0E4194B22D0C04640168294E6578F5CC09871B1888AC34640F78F94E6218F5CC0741E16EF20C446403CB0C719DD8E5CC06CAE4A22ACC446408CF1C719918E5CC0F43EB28826C54640F96B61B3348E5CC0FCC9AF8886C546404A3194E6C98D5CC028F74822C8C54640499294E6498D5CC0B8CC4922E0C54640D1D1F94C348C5CC0F0507E55C3C546406656FA4CB88B5CC0F0734B22D8C5464083362E80518B5CC0BC35B1881EC64640C579C719D9895CC04CE14A2284C746401D29C71951875CC0A808B08806C94640911D2E80F7865CC078EDE2BB61C946402988C719B5865CC0B495E5BBE5C946407C0661B390865CC05CAD4A2288CA46401D0594E663865CC070B3B1882ACB464014A52D8027865CC0340DB188BECB4640CFC22D80D7855CC0B81A4A2234CC4640724D2E80B5845CC028474B2234CD4640F5732D8065845CC0E8CB7C559FCD46402402C71927845CC0FCC018EF30CE4640437894E6F1835CC0C0BA16EFD4CE4640F45860B3C6835CC0E45417EF8CCF464074A4C7195B835CC04C8A7E55DBD046400E802D8019835CC07FC07D556BD146404365C719C9825CC05C394A22DCD146403618C7196D825CC0348F492238D2464095C893E605825CC01C454A2284D246407C6A61B350805CC070BAE4BB59D346404E34C7190D805CC0B72918EF8CD346403F8661B3E47F5CC0141BE3BBD1D3464059F52D80C97F5CC0EC57B2885AD44640AEB961B3CE7F5CC004BDE3BBF9D44640061E94E6E37F5CC0F07B4A2294D54640179FC71919805CC0A8FC16EF74D64640649B2E802F805CC0949D16EF10D74640896861B334805CC00C327E55C3D74640649B2E802F805CC03FAE17EF7CD84640D0C52D8017805CC0BC014B221CD946402A44C719F37F5CC0A4694C227CD94640594C2E80B77F5CC08C7E17EFC4D94640E15861B3547F5CC01B77E5BBF1D94640F9E994E6757E5CC098867C5587D9464037E694E6437D5CC044657E55A7D84640668D2D80F77A5CC0C08CB08852D6464074C6FA4C52795CC05011E5BB41D44640F768C71921795CC0A00A4B22B0D3464021732E8001795CC068CFE5BB09D346402DC12D80ED785CC0C8A07D559FD14640C40FFB4C7C785CC05C1E18EFF0D046402C5560B3BA775CC0008F16EF54D04640E2202E8069745CC0BC867E55AFCE464087BDFA4CE4735CC0547E4B2250CE46402242FB4C68735CC084C44A22CCCD4640552FFA4CDA725CC0144A4A22E0CC4640517F94E695725CC0C4EB17EF24CC4640C15994E675725CC0AC5117EF6CCB46401E6EC71983725CC040407E55BFCA464052F260B3B2725CC0F0334B2228CA4640CB58FA4C32735CC054204B2210C946408D8FC71965735CC030384B226CC846403D4EC719B1735CC028AB4B22F4C646404D052E80DB735CC077B4B1884EC54640B13A2E80E1735CC0ECA917EF84C44640E0BFC619A1735CC01C0A7E55C7C34640836594E61D735CC064814C2224C34640E10C94E61F715CC0D8867C55DFC1464089E694E675705CC0688F4A22F8C04640A4A360B346705CC02C6E4C2218C04640F2F6C7194B705CC0BC39B088EEBF4640A4A360B346705CC084AC4B2224BF4640BD722E801B705CC007AEB1880EBD46409BB6C61927705CC054617D5553BC4640A4A360B346705CC0C808E4BB9DBB4640E23761B3AA705CC018BCE5BB49BA4640D59261B3D0705CC020E616EF94B94640B9A9C719E9705CC0B0347F55D7B84640902C94E6EB705CC05071E5BB15B84640C5A7C719CD705CC01C1819EF70B746400DAC93E6A5705CC0BF8817EFD4B64640C2F761B388705CC0F4B3E4BB65B54640380695E641705CC0C0627D5583B4464092432E80756E5CC068174A2260B24640AFF793E6F76D5CC0306718EF80B146405656C819BB6D5CC0C00FE5BBA9B04640FA9194E6B56D5CC0AB5F18EF1CAF46408146C819D56D5CC01CAD4C22F0AB4640132D94E6FD6D5CC0283EE3BB61AA4640FE9AFA4C046E5CC0B898B0889EA94640D91BC719EB6D5CC040BEE4BB29A84640C2F393E6BF6D5CC0441DE5BB8DA7464053B72D80876D5CC050FE7C5503A74640553BFB4C1C6D5CC010D4E2BB6DA64640EC92C719B16B5CC0E8E2B288E2A44640D0612E80376B5CC02854E4BB35A4464059882D80E76A5CC04C54492288A3464051A494E6C96A5CC0403D17EFD4A24640FC002E80BD6A5CC0001B18EF68A146405E4994E6A36A5CC013BCB288BEA04640A98A94E6576A5CC08C567D551BA04640BDB260B33A695CC077BCB288CA9E46401D98FA4CF0675CC0305318EFA89C4640EB12FB4CE8665CC040B117EF809B46403A392E80FD655CC0C8C44922089A46408A0762B394655CC0908D4922EC984640AB3EFB4C68655CC094EC4922509846402967FA4C34655CC0903418EF009746400641C71925655CC0E86AB2884A96464051A794E609655CC038BE7C559F9546405DFC94E6DB645CC0CCCFB08806954640019961B356645CC09FBB7D55FF93464037E8C61921645CC038DE7C5577934640CACE2D80FD635CC010087F55D792464067992D80F7635CC0FCE6E5BB49914640986460B3E0635CC03CC9E3BB9D904640DA6AC71989635CC088744A2220904640523A61B3FE625CC0A05F7F55D78F4640585A61B3D6605CC0A0704A22E88F4640FC4F2E805B605CC080027D55938F4640BE6B2E80EF5F5CC090B818EF988E4640726661B38A5F5CC0E03EE6BB558C4640047AFA4C5A5F5CC0DC2BE3BBC58B46402FE3FA4C565D5CC040B8492294874640C781C719ED5C5CC03CB77E556F864640168E2E80EF5B5CC0D45B7D55CF824640C6C7FA4CCE5B5CC0AC737D552B8246407535FA4C865B5CC0789E7C551F8046405EE294E6835B5CC0E8287D55F77F4640E6E4C7198F5B5CC05CA1B188327F4640086D61B3F65B5CC0305F7F55177C4640676E2E80235C5CC02818E4BB617B46403116C819575C5CC0F34D4B22BC7A4640891094E69D5C5CC060AC18EF307A46408E22FB4CEE5C5CC0BBEB18EFC87946407564FA4C265E5CC05C05B288F27846405473FB4C7C5E5CC08C207F559778464075B5FA4CBA5E5CC0EC1E4B221C784640FD102E80CF5E5CC0E49BB2887E774640B3C4C719B15E5CC024A17D55E7764640700595E6755E5CC0908E7E555B764640CE6FC719E55D5CC08C0280556F754640B83E2E806B5D5CC0F4FF4A2268744640A6982D80055D5CC0BC457C5547734640594D61B32A5C5CC0A3D316EF906F4640C66EFA4CC45B5CC03FF64B22706E46407ED393E62D5B5CC0C04116EF546D46408966C7196B5A5CC02426B1887A6C4640A767FA4C6C575CC06C9217EF706A46407F9961B38E565CC070AB7D55AB6946400D4B94E605565CC0BC704B22F468464036DB2D80E3555CC0A4F917EF50684640C96894E6B5555CC023D8B08826664640AFAAC71959555CC05430B288A66546404AB3FA4CBE545CC0280319EF64654640F95EC81995535CC0A8074C228C654640F83AFA4CF4525CC0A01C17EFD465464041E660B376525CC05B427E554366464099AA2D8033515CC0203E7E55FF674640CE36C719D9505CC0C0EDB288566846407AC02D8073505CC02832E3BB9D684640984761B302505CC074A116EFD0684640F448C719E74E5CC038E94922C8684640D15F61B36A4D5CC034777C553B684640657894E6BB4B5CC0E8294B22F866464010A12E80414A5CC094997E5537654640C0EAFA4C0C495CC0B4274C2264634640A89FFA4CCC485CC0787F4922E06246408C422E80EF475CC00370E4BBB9604640D16261B3AA475CC0D4BB7C553B604640527794E6BD465CC024FEB188E65E4640887FFB4C82465CC0B832B388625E464032E6F94C54465CC08879E5BBCD5D464092DE60B332465CC080E44A222C5D46408A4AC7191D465CC03097E3BB815C464041AE61B3F6455CC0FC3D17EFDC5B4640F88E2D80CB455CC0B8B4B2884A5B46401EB5FB4C8E455CC0DC0617EFC05A4640E6C5FA4C04455CC0C4F74922D0594640F1502E80CB445CC03C5617EF44594640924F61B39E445CC05097B088AA584640776EC7192D445CC0FCB4E4BBC5564640268EC719F9435CC0583D7E55335646409D17C71945435CC0FC6318EF9C544640501BFB4CE2425CC03486492278534640C2ECF94CC0425CC0E35CE6BBD5524640470B94E6AD425CC04CA44B2230524640C79CFA4CB8425CC080157D5583514640099B61B3EA425CC02B1B4C22F050464029B02E8035435CC0A88AE4BB755046407A6561B3DE435CC0009EB188AA4F46404527C71925445CC0E05A16EF2C4F4640EB5A2E805D445CC09B427E559B4E4640B3BC2D8067445CC014EF4A22FC4D4640A42894E651445CC0C853E4BB654D46403E5DFA4C1A445CC0E8B74A22E04C4640099A60B35E425CC050C0E5BB154A4640FF9BFB4C2E425CC01C78E4BB814946402F672E8017425CC05BDDB088DA484640E11CC81915425CC0E402E5BB654746405CD2FA4CC4415CC0C01AE5BBC14646408FC8FA4C38415CC09C43B0882E464640C16FFA4C34405CC08409B18866454640CA0B94E6BF3F5CC040CE4B22C0444640473D94E68D3F5CC09804E6BB094446408F39FB4CA43F5CC0CC7517EF5C434640410161B33E405CC0687CE3BB5D41464061BD2D807F405CC03CA5E4BB3140464077A8C71983405CC0FFEF16EFD43F4640228B93E673405CC0D8ADB2884A3F464073CC2E80DB3F5CC050F9B288963D4640A49761B3C43F5CC04CE6AF88063D4640101B61B3B63F5CC0387717EF8C3B464045CAC719713F5CC0D8D64A22E03A4640A83DFB4CE23E5CC0FC1C4A225C3A4640765FFB4CD03D5CC0CC637C55C7394640667C61B3423D5CC034517D553B3946401306C819DD3C5CC01F6EE3BBAD384640CD5FFB4CDC3B5CC02BB1B0889A3646408874FA4C8A3B5CC07C7FE4BB31364640FCEC93E6113B5CC068EE4922C8354640871061B338385CC0D8657D5577344640C14CFB4CD6375CC01863E3BB1D34464051EDC71989375CC0405BE3BBAD3346407E45C7190D365CC0307E18EF983046404F4C61B3A4355CC0905D17EF403046402A872E8015355CC0C8F216EF34304640FF69FA4C0C345CC028B6B088F6304640EDCEFA4CC4335CC0A0BBE4BBA9314640021195E6B5335CC048854A2260324640AE062E80CF345CC07C1E18EF1C354640A8C9F94CF4345CC084127D55BB354640229A94E6F5345CC0385FB18876364640360961B3DA345CC0242FE3BB213746406C61C719A7345CC090A07D55BF37464013B7FA4C68345CC044A717EF5038464041F594E621345CC090907D55D3384640FA55FB4C76305CC0BCE77E552F3E46401FF7FA4C18305CC0FC8A4A22883E4640061DFB4C442E5CC05CBA4A22343F4640D0F9C619E12D5CC05C23B288723F464079FE94E6C12C5CC0FC24B08886404640162194E6392C5CC05CE87F55AF404640D28C2E80892B5CC08C1D7E55B34046408B59C7195D295CC0B8E94A22E03F4640FC7B94E685215CC0981AB188763E46408538C8191B215CC0F47C7E55233E4640C8A6FA4CC2205CC0549E17EFBC3D46406B79FA4C32205CC09B5E7F55EF3C4640170361B3CC1F5CC09CAC7E55DB3C4640553D94E6051E5CC07891B188363D4640CFE0FA4C181D5CC0C0084A222C3D464053ECC719DD1B5CC09C66E4BBB13C46401A8CFA4C521B5CC0241817EF283C464095CE60B3E41A5CC0A876E4BB9D3B46406748C719991A5CC09427E4BB253B4640302E94E6371A5CC0A06C7D55C33A46405AB3C719AB195CC0ECC17F55973A4640C9CBFA4CF6185CC0FF25B088AA3A4640FB72FA4CF2175CC04CB04B22303B4640AC3995E667175CC0384CE5BBB53B46409272C71909175CC0D081B188563C46409829C719EB155CC0D0127F55974046408B69FA4C72155CC0DC4F4B229C434640A5DFC7193D155CC0201AE4BB41444640065360B3FA145CC040CE4B22C04446401DDC93E6A5145CC0E48E4B22284546400B6360B3E6135CC0F894B288CA454640B7DAFA4CE4125CC004184B2268464640C563C71947115CC034D118EFFC464640E0202E80CB105CC0639EB0884E474640016B2D807F105CC0F8DC18EFA4474640C6C361B3EE0F5CC0308D4A228448464089D660B3800F5CC078AE7E55CB484640DDD8C719F10E5CC078AE7E55CB4846405E7C2E80030E5CC0003DE4BB2D484640050594E6110D5CC0F06A4B2218474640FDF4C719910C5CC0B4BAE3BBD1464640DE5AC719D90B5CC014034A22B84646400B8694E6690A5CC0182617EFCC46464057F360B338095CC0843F4B22A4464640C451C71965075CC04375B288FE454640DAAD61B3D4055CC0542A17EF10454640B5862D8039055CC0981F18EFF4444640724E2D801FFF5BC0848D4A229046464087A2C71919FE5BC0D8D04A2260464640B7B32D80E3FC5BC00481B288A6464640D84BC71937FC5BC0186CB188F6464640593E2E80C1FB5BC02C7A7D555B47464029EEC7196BFB5BC09423E6BBBD4746402A1995E6F5FA5BC05080E4BBFD474640F05FC71961FA5BC038D2E3BB21484640F516FB4CAEF75BC0340F18EFFC474640027EFB4C88F65BC02C7A7D555B474640D1E5FA4CECF55BC060D27E55DB464640B60461B37AF55BC090A7B18856464640F5CD2E80FBF45BC0D85117EF4C454640BB4094E6C9F45BC040CE4B22C0444640F548FB4C8EF45BC0E8D2E3BB39444640DD4BFA4C3AF45BC0B45FB088CE434640962C61B3C2F35BC04C2C4B2298434640EAD5C71929F35BC02479E4BBA5434640619DFA4CE0F15BC05C3B18EF884446403CD8C71951F15BC0788618EFC84446408058FA4C00F05BC0883D7F55F34446402AADC719E9EE5BC0D85117EF4C4546406D512D8085EE5BC0CC78E4BB99454640147860B3A6EB5BC090D5B0886A48464078392E80B7EA5BC0BCF17E559B484640F5D62E80BBE35BC03C1019EF88484640F275C719F3E25BC048894A224C484640182FC719F7E05BC06CE34922EC464640F783FB4C2EE05BC0F02C4C2218464640392861B3CADF5BC07C99E5BBF1454640AAB360B332DF5BC00C8816EFDC454640072F94E619DE5BC0980F18EF084646403E02C71979DD5BC048FB492248464640F2FCF94C14DD5BC05C1B18EFB0464640EA8B2D8013DD5BC044AB4C223C4746402DFB60B346DD5BC0B0057F55BF474640F96EC719A1DD5BC0A81FB0881E4846404DD560B31ADF5BC05BDDB088DA4846404B0194E67DDF5BC0F0277E552B4946405C2BC719C5DF5BC0C8004C228C494640D888FA4CF6DF5BC0D01A7D55EB494640284F2E8017E05BC08CAC4A22444A46406A9B94E635E05BC0144E7D55CF4A464008552E806BE05BC06C1218EF1C4C4640EE1294E679E05BC084B87D55CF4C464091A760B37EE05BC038767E558B4D464008552E806BE05BC054B07D55534E464081A0FA4C4CE05BC0784A7E550B4F4640019361B3D6DF5BC060134C22805046405561FA4CBADF5BC0A39CB0881251464046CD60B3A4DF5BC0606C7D556B524640D2E9FA4C76DF5BC0A09617EF005346405C10FA4C26DF5BC034757E5567534640452394E671DD5BC040844B2258544640C0D8C61921DD5BC0C48019EFBC544640DA84C719E1DC5BC0CC51B18846554640DE11FB4CC4DC5BC0900FB28802564640824DC719BFDC5BC08C5516EFC4564640C3D861B3D4DC5BC0501317EF8057464045DD94E6FBDC5BC0F419B18812584640FAE993E633DD5BC088BBE3BB9D58464092FC2D8073DD5BC000DB7E5517594640322794E6A9DD5BC018AC16EFA0594640B16AFB4CC8DD5BC04765E4BB355A464079592E80B5DD5BC07BBEB088DA5A46409316FA4C86DD5BC078D07C55775B46400BCCC719E9DC5BC058397F55635C464055BEC71925DC5BC054EB4922105D4640C98F61B3B6DB5BC03CEF4922485D46405AF12D80DDD95BC084A417EFA45D4640E3FB60B35ED95BC06B4816EFEC5D464025F9C61905D95BC0F4D87D55675E46409B8BC71953D85BC00CF2B188326046403C0E2D8007D85BC058B84A22A0604640E55AFA4C7AD75BC0AF52B088AA604640211261B3AAD65BC08CF6E4BB59604640DE1B2E8059D45BC0A09017EF805E4640B2332E80B5D35BC024EBE4BBBD5D46408D0CFA4C1AD35BC008A67D558F5B4640CE9EC71985D05BC024077F55A3554640F273FA4C00D05BC01034E5BB01544640DFD8FA4CB8CF5BC0EC0EB1888253464001CA94E615CF5BC084547D550F5346409FB660B398CE5BC0FBD517EF98524640A104FB4C38CE5BC0B03AB1880252464016BC2D8003CE5BC0B0904B221851464041E060B3F6CD5BC0403918EF405046409E9B93E6F9CD5BC038ACE2BB614F4640478760B3ECCD5BC0F4074C22E44D464029B82D80CBCD5BC034EA4922384D4640EE8C94E6A5CD5BC0E84EE3BBA14C4640BAFFF94C74CD5BC0CFFA7C55134C4640DEA9FA4C18CD5BC048DC18EF8C4B46406DBD2E809BCC5BC0FC517D55074B464021ED93E69FCB5BC097A0E5BB494A4640668893E6EDCA5BC0F4127D557B4946401AB794E615CA5BC0F0857D5503484640BB9194E6FBC85BC0D85117EF4C454640805B2E8023C75BC01C064C22F44146404FCD2D8019C65BC000B1E4BBD94046401B1A94E649C35BC044C7B088BA3F464013A9C71949C35BC0D06F4B22C02B4640CBCF2D8047C35BC06B77B088C2174640062FFA4C46C35BC07C4FB088C60346407D85C71945C35BC0F7867E55CBEF4540EEDB94E643C35BC0F8EDB188CEDB45402E3B61B342C35BC0A4D7AF88D2C7454099912E8041C35BC0200F7E55D7B34540A1F9F94C40C35BC02C76B188DA9F4540911761B33EC35BC03C4EB188DE8B4540046E2E803DC35BC0B814B388E27745403CCDFA4C3CC35BC054FEB088E6634540365C2E803BC35BC06065E4BBE94F4540B523C8193BC35BC07CAEB088EE3B4540BD8B93E639C35BC0EC74B288F2274540A8A9FA4C38C35BC088EDE3BBF51345401900C81937C35BC0A436B088FAFF4440A5812E802FCF5BC0A436B088FAFF444072D32D8027DB5BC0B4A77C55FBFF4440731C2E801FE75BC0946619EFFCFF444078652E8017F35BC0946619EFFCFF4440851FFB4C10FF5BC0946619EFFCFF44408568FB4C080B5CC0946619EFFCFF444059BAFA4C00175CC0946619EFFCFF44405E03FB4CF8225CC0A448B288FEFF4440E58461B3F02E5CC0C02A4B22000045406A06C819E93A5CC0C02A4B22000045403958C719E1465CC0C02A4B22000045403EA1C719D9525CC0C02A4B22000045403EEAC719D15E5CC0C02A4B22000045404333C819C96A5CC0C09B17EF000045401185C719C1765CC0DC7DB08802004540E5D6C619B9825CC0DC7DB0880200454061CD94E69D8E5CC0C09B17EF00004540367694E6839A5CC0C02A4B22000045400A1F94E669A65CC0A448B288FEFF444094862E804FB25CC0946619EFFCFF4440E2F6C71935BE5CC0B4A77C55FBFF44407C37FA4C1ACA5CC0A436B088FAFF4440C236C719FFD55CC0A436B088FAFF4440CED6C719E5E15CC098C5E3BBF9FF4440214761B3CAED5CC088E34A22F8FF4440ED7E94E6AFF95CC088E34A22F8FF4440317E61B394055DC07801B288F6FF4440D52F60B37A115DC008A2E3BBF5FF44405A97FA4C601D5DC0F83017EFF4FF44402CCF2D8045295DC0EC4E7E55F3FF4440F80661B32A355DC0D06CE5BBF1FF44404477FA4C10415DC0CCFB18EFF0FF4440E19AFA4C14415DC053C87F55230D4540E814C81917415DC0D0E74B22581A4540CC0861B31A415DC08478E4BB8D274540E1F3FA4C1E415DC00C27E4BBC1344540B076C71921415DC087D5E3BBF5414540C56161B324415DC090547E552B4F4540DA4CFB4C28415DC018037E555F5C454031082E802B415DC0A0B17D5593694540C5BA61B32E415DC038D14922C876454029E760B332415DC0BF0E7D55FB83454031612E8035415DC0B81C4B22309145400E55C71939415DC0B42A19EF649E4540234061B33C415DC030D918EF98AB454081FB93E63F415DC0DF69B188CEB845400EAEC71943415DC06718B18802C645406BDAC61947415DC0F4C6B08836D345406A72FB4C48415DC0447FE3BBF9D8454080C560B34A415DC0408BE5BB7DE44540A6C061B382415DC094F8E4BB29E645401E88FB4C82415DC0D89EAF882EE645401E88FB4C82415DC0587E17EF20E74540A65F61B302425DC0F068B18812EA4540E7F1FA4C02415DC0D4D27E5523EC4540475BC719993F5DC078C918EFC8ED4540A59161B3E23E5DC010DDE2BB79EF4540E36294E6253E5DC08C45E5BB59F245404B59FB4CE83D5DC0E41C17EF68F54540D751C719193D5DC050F64A2290F94540BA792E80A93C5DC044E37E55CFFE4540AF46FA4C603C5DC0F3524A2238004640167394E6173C5DC038A917EF30014640296F94E6DF3B5DC0B8A5AF882E024640126A2E80C93B5DC030927D55A70346409277C7193F3C5DC09CC04A2258064640E896C719FF3D5DC0BBC74A22B00A464005F32D80033E5DC0D8CB7D55CB0C4640047F60B35A3D5DC020E516EFE80D4640DCB0C7197D3C5DC078C516EF1C0E4640A6F794E69B3B5DC0CB4EB188160E4640EA9294E6E93A5DC01809E5BB890E46401568C719653A5DC080BB7D55D30F46406602C819233A5DC0F89549224811464090CDFA4C0C3A5DC0280B7F55CB124640428394E6093A5DC03727B2884214464086F3C619CD395DC01C7AB288F2144640D568FA4C5A395DC007DE7D55B315464057F1FA4C16395DC00888E3BB9D164640317D2D8067395DC0248F4B22CC174640A6D361B3AE3A5DC0F8714A22A0194640126A2E80C93B5DC07C667D55DB1A4640A77D93E62D3D5DC0A4BBE4BBF51B46406A802D80873D5DC0907FB188A61C464005F32D80033E5DC00C5218EF581E46409D89FA4C243E5DC03C927E55C31F46401C0195E61B3E5DC0988AB18836214640E79F2D804D3E5DC07BC74A22582246405C9E60B31A3F5DC0F36317EFCC224640287C94E68B405DC04F14E4BB65224640715FFA4CB4415DC07021E5BBA5214640DCFEC719D1425DC0B07E4C223C214640271FC71921445DC0B89018EFD82146402117C719AB445DC073A57E55CF22464050C02D800B455DC0A09F4A2210244640DD4794E683455DC05CD77D551B254640946F60B35A465DC07CC27C556B254640340E94E639475DC0A08B4A22EC244640D1F360B3D2475DC0B052B18802244640A0AD61B356485DC0A0FD4922E8224640852D94E6F9485DC0B89018EFD82146400A5861B3724B5DC088E9E4BB71244640FC7D94E67B4C5DC0C8037F551B2646407ACA61B3E84C5DC040F97C557B284640559B2D80D74C5DC028704B22CC29464092FA94E6894C5DC0AF30B0887A2B4640F403C719794C5DC0C46BB088CE2C46405B7660B3A64C5DC03C2D4C22702E464098DF93E67F4D5DC0B4A918EF0C3146409BA1FB4CC84D5DC0CC897D5587324640D3F060B3924D5DC06F56B0887A3546407A7161B3DE4C5DC0580F7E5503384640DEFE60B3624C5DC0B0A04B22503A46402043C7190B4D5DC018A4B088C23D46407008FA4CA04C5DC0881EB188AE3E46405A6494E6094C5DC06B11B0886E3F4640AAA594E6BD4B5DC04CF3E3BB1D4046408439C719854B5DC0407318EFBC414640A64D2E80F74A5DC030B416EF6842464007F594E6414A5DC0236A17EFB4424640BEE661B38E495DC058E2B088364346409E06C719AD485DC040CE4B22C0444640D9642D80D3475DC078E34922EC464640E5732E802F475DC0702CB188524946409FA294E6A3465DC0D46E16EF504E46408D8261B3EE455DC0E7A27C55075146400B62FB4C50445DC0403717EF905546402E0194E68D425DC044CBB1880E5C4640024FC719DF415DC040A24B22E85D4640474BC719AD405DC0C0827E55FF5F4640EF33FB4CCE3C5DC0D7D116EFA0634640421294E69D3B5DC0309AB188266546400A0962B3B43A5DC000A37C55BB664640F29661B34A375DC01BEC4922DC6E464064C8FA4CD0355DC037574B225C734640513E61B34C355DC0A07CB288BE7546404C09C8199B345DC058684A22B87B464069E960B380345DC0C0B47E55677E4640146BC719A5345DC0389F4A22C87E464098B594E6F5345DC06C874A226C7F464065D0FA4C46355DC068D74B2270804640105261B36A355DC0F022E4BBE5814640F15F61B334355DC048E77E55338346403991FA4CB4345DC0CF8016EF94844640C03561B3EA2D5DC018684A2260934640F644C719992C5DC0842818EF4C9846409155FA4C742B5DC00B564A222CA04640CDBC61B39C2A5DC0280C7E555BA24640C930C819FD295DC0A87BE4BB71A446408FA32D80CB295DC00F4A7E55C3A94640617694E689295DC03F607D557BAC4640894261B3B6285DC05468B088CEAE464039452D807F265DC04C16E4BB81B2464007E3FA4C8C255DC0785F7E55CBB6464011A994E681225DC08897B2884ABC4640FF5D94E641225DC0E0E4E3BB8DBD4640CFD7FA4CF6215DC0B0E34B2240C04640C18994E6C1205DC040447D558FC44640AC3C94E665205DC0D871E4BB6DC546406DCB94E6811E5DC058AE7D5583C846407F53C719A11D5DC000314C227CCA4640326A61B31E1D5DC0303EE5BBE5CC464097602D802D1D5DC038017F559BCF4640978E60B3AC1D5DC0D0417D553BD24640DEDB93E6EB1F5DC0F8A2E5BB71D8464005BC93E619215DC0F85FB088AEDD46405E282D80ED215DC038F57D5533E046405368C719BD225DC0BBBE7E5597E146402E0FC719AD235DC040954A22D4E2464091CCC7195D265DC010B8B28896E34640A93E2D80132A5DC0D7E0B088DAE64640BA0861B3662B5DC078C6492208E9464076BB60B3042C5DC010D1E3BBD1E94640AD9393E699305DC05076B18842EB4640AE0761B342315DC0104FE4BBE9EC4640F5A2C719D9315DC080B9E4BBE9EE4640370E2E80AB355DC01050B08876F446406123C7198B375DC090CB17EFA8FB46406F0661B318385DC0A83518EF9CFF4640616161B33E385DC06C1E4B2230004740216EC719BF395DC0A88318EFF0054740C830FA4C203D5DC0D0AFB1880E0C47404DD4C7197B3D5DC0906117EF680D47401D4561B3983B5DC0E0D418EF6410474045112E80C53A5DC0EC6A7E552B124740743D61B32E3A5DC0F30A4B22CC144740ADA52E802F3A5DC0D0F7B0887A17474025662E80913B5DC0006616EFF81A474059E2C7194B3C5DC010F6B0883E21474017DD61B32E3D5DC008D7B188F223474042A260B3523F5DC0B042B088FA28474024FA2D805B425DC0D06E7F557F2E47405D372E80D1425DC0FC9DE4BB71304740BDB3C71991425DC07C114B22C03247403272DA0D78425DC0E42032B14F364740B10E7FED8F425DC0DC4826623A3A474031AB23CDA7425DC090EA1C99404D4740B10E7FED8F425DC08F7E7AC783624740B10E7FED8F425DC020CFB1335678474031AB23CDA7425DC073F438E9BB8B474031AB23CDA7425DC0A7BBA778B7A0474031AB23CDA7425DC0A816BCE7CAB54740B047C8ACBF425DC0083C439D30C94740B047C8ACBF425DC04C3CFBEB5BDE4740B047C8ACBF425DC01F1E5CDF50F24740B047C8ACBF425DC090F5DFCF04074840AEA1999961425DC0472C369C281B4840D33CFB4C3C425DC0F83E18EFF02D484031512E8049425DC0709FE3BB39424840816561B356425DC05C5F7D558356484056412E8063425DC0441F17EFCC6A4840CBC1521171425DC0973378B70A7F48406B753B260B3C5DC0B81578B70A7F4840A9D848DAF92D5DC0B81578B70A7F4840E73B568EE81F5DC0B81578B70A7F484008B26442D7115DC0B81578B70A7F48404B1572F6C5035DC0B81578B70A7F48404398C91A15035DC08C3378B70A7F4840,7.2%,18,267,65,202,Idaho,true
15,0106000020E610000001000000010300000001000000140200001A3C61C178F355C07843C24CF33E45403CC1B5D06CF355C0B4EE4293CA3D45400676F616FBF355C06C6C37D7513145400E82199C3EF455C09C6E1CED9030454064B48AC68BF455C0B4E3EBF2EC2F4540249A5FA6C5F455C094B35FDEDE2E45406E83F62CE0F455C08404C654702D45402014CEE3A3F455C0C8935161C1234540549C44BC04F455C024AFB77FBE1E45407692064D00F355C01F2F00F3551A4540BEF8F8ABD5F055C02C81A1671E144540B4298D4581F055C0406B4073D6124540B0A3FB825FF055C0D00843347B114540170E859419F055C078335B050310454071A9A23F7FEF55C07490E400D80E4540CA44C0EAE4EE55C0E4ACF436DD0D45402CAF49FC9EEE55C0CB888BA7120D4540FECC36C345EE55C090D70C08650C4540F449929B00EC55C0F0DBD633E30A454010083C458FEB55C090911FFF0E0A454096C223483DEB55C0B887E18F0A0945406297366BB1EA55C0C4CE09979706454008A27C5F53EA55C07C62CEE837044540A257C52A7FE955C048833931EAF84440624087A595E755C0B07C1BD65BF244409731AAFE0EE655C0503E180DFAE844402FDBCF44F7E455C02F3D6EF5F1E4444039D460B358E155C0BF666B451FDD444039D460B358E155C0E48DE4BBD1DB44408877C71965E155C0DBFE482248C944400F7AFA4C70E155C0A46A18EFBCB6444057AC94E67BE155C0FCE7E5BB31A44440201795E687E155C0F4E77D55A79144407E9393E693E155C05BD617EF1C7F4440C3C52D809FE155C05465E3BB916C44404CC860B3AAE155C0AC537D55075A4440143361B3B6E155C074BF4C227C474440E19D61B3C2E155C060DD4B22F0344440F2D8FA4CCEE155C0C4CBE5BB65224440FF1394E6D9E155C0BCCB7D55DB0F4440C87E94E6E5E155C018494B2250FD43405EF293E6F1E155C01049E3BBC5EA43401DECC719FDE155C074377D553BD843402E2761B308E255C0401419EFB0C5434076CAC71915E255C03814B18826B34340CA142E8017E255C0ABD0E5BB49AE43409C8694E655E255C018ACE4BBB9AD4340AECDC71935E655C09CC6B088DEAA43406807FB4C5CE755C0ACC0E4BBF5A8434038F593E605E855C0DC6718EF5CA6434082C5C719B9E755C078884B2224A44340D2F3FA4C44E655C004F8B088D29F4340B04094E651E655C0F44EB088529A4340FB252D8073EA55C02B5AB2880A9443402A03C719ADEA55C0E8FE4B22248F4340473CFB4C50EA55C00862B188128E4340FC1361B3D6E955C05CD97F556F8D434050EA94E6E3E855C0905216EF848C43403094C719F1E655C07FF27C556B894340BC6161B34AE655C0A813E3BB218743407C0A95E6C1E555C0BC87B1885E824340B0C360B35AE555C048664A2234804340366E2D809FE455C08073B088C67E4340EA8260B3B8E255C0305C4B22307C43409C8694E655E255C0346B4A22907A43409C8694E655E255C0B4DDE4BB517543406C2E2E8089E255C0940E4B22E87343407A732E806FE355C0F86E4C22E4714340E035C719A5E355C0C40B19EF64704340C0A4C719EFE255C0C02B4B22AC6B434012EDC6198DE155C0C4477D55BB664340A29E94E6B7E055C048A0B088B6614340EFFC2D80BBE255C0741BB08852584340C99161B30EE355C058AD18EF645743403D3794E6D1E355C044D3E4BB255743406E7FFA4CB2E455C054B57D5527574340B0C360B35AE555C0A8694A22F85643401A4061B362E655C0232F7D5593554340E83F61B35CE755C0304F7D556B5343409AEDFA4CE4E755C01C61B188DE5043401E14FA4C94E755C088317E554F4E4340601261B3C6E755C0A74F4A22A04D43402ABAFA4CFAE755C05C487D551F4D434026A093E633E855C08CF27D55C34C4340BEB22D8073E855C0A8BF4B227C4C4340693C94E60DE855C0A8BF4B227C4C434082D894E6E1E855C000624C22B04B4340647D94E6B5E955C0AC65E3BB9D4A43401818C8195DEA55C034FCE3BB294943402A03C719ADEA55C0B4D217EF3C474340368EFA4C74EA55C044F74A223C4543403C9EFA4C60E955C0D8C87D558B424340EE5394E65DE955C08C83B1880A41434000C461B3CEE955C07825E4BBA13F4340F81CC71925EA55C0A41EE5BBBD3F4340AE0795E687EA55C0D8C5B0884E4043403602C8191DEB55C0E4967E553F404340D46BC71997EB55C01449E4BBA53F434016002D8047EC55C0BB0718EF5C3E4340D59860B3D2EC55C0084A17EFA03D43405C5FC719D7EE55C054E2B088FA3B43408B972D80CBF055C0001B17EF003B43408B972D80CBF055C0C84718EF0C3A43407D3861B3D2EF55C0FC4F18EF88384340A60EFA4C26F055C0CCFCE4BBF5354340740EFA4C20F155C0A457B2883E334340BA6DC8191BF255C0B45D4B225031434078DA2D808FF255C084EA17EFE4304340D2CBFA4CD0F355C0DF917E552F3043406E8EFA4C54F455C064AF17EF902F43400FCBC719DBF455C0386FB188262E4340FC302E806BF555C0549CB2883E2B4340B4DCC719D7F555C060914A22D8294340FC4BFB4C0AF655C0DC3C16EFAC284340629BC71923F655C0B899E5BB0D2743403A642E804FF655C06CF417EF9C25434077482E80BBF655C0F411B188FE2443405C0795E655F755C0086617EF8C2543406E31C8199DF755C0FCB918EFC8264340001894E6C5F755C0801F18EF04284340A09BFA4C06F855C034857C5593284340E049C7197DF855C074E2E3BB292843402CC260B3FEF855C068D316EF382743400EEB2D8067F955C08F487E552B264340C6B994E6E7F955C09C527C55C7234340502794E699FA55C06CE14A2274244340F3862E8035FB55C07FF118EFF02543402E98FB4C48FB55C04431B188BE264340383661B384FC55C0906B4B224026434064C560B31EFD55C070C7E3BBAD244340AA0061B378FD55C06B99E4BB992243403088C719F1FD55C028E24A228C204340CC1D95E681FE55C043A5B1886A1F43402AC8C6190DFF55C010A64922AC1E4340B08560B37AFF55C0BC137F55CB1D4340006F61B3B0FF55C0E027E4BB411C434078F060B386FF55C0DC9F4A22E01A43408E06C81915FF55C078854B22E4194340EBE3C619A1FE55C0D08616EF1419434084212E806BFE55C0D3FF7D553F1843402E4B2E80C9FD55C07C5EB088061743407FD9C71991FC55C0D0F74A22EC154340A8F593E6C5FB55C0E8BDB08876144340A86961B36EFC55C0F4FC7D552B12434000E760B306FD55C04FF6E3BB99114340213C2D806DFE55C064E97D55131143402260FB4C0EFF55C0F85416EF601043409720FB4C700056C0F4154C223C0E4340F4F760B3EA0156C0EF017E55870C4340898461B3E40056C0B86217EFB80B4340FCBDFA4CE0FE55C0E741B1880E0C43403088C719F1FD55C00B1F7F55B30A4340F6F32D80D5FE55C0704216EF6C094340663AFB4CE8FF55C027297D554F084340BC3E2E80090156C070E9E4BB81074340B62E2E801D0256C06C514B223407434056AA94E6E70256C02C27B1889E0643400295FB4C020256C0475C17EF78034340949694E6C90256C07CD5E3BBF50143406669FB4C880256C0B0D57E55AF0043401630FB4C4A0256C020847F5597FE4240BE1BC8193D0256C06813B388A2FC4240D206C7198D0256C060867D55C3FB4240FE9EC719290356C06FD4B28816FB4240A23394E62D0356C05C24E6BB89F94240949694E6C90256C010E97C55EBF64240042195E6A10256C07823B28826F5424098342E80710256C094407D55EBF342406A4D94E6A50256C084B47E55FFF24240B66D2E80A90356C0077BB28826F24240329793E64D0456C03FB0B0882AF24240264461B3280756C0402BE4BB05F342408A8060B3180656C04CBCB088DEF042406E56FA4CF40256C0F0D0B0881AEC4240D206C7198D0256C04CC0AF88AEEA4240283FC8193B0356C0F0C57E551BEA42408BE8FA4C360456C0C3CC7D55FFE942401069C719110656C09B7D18EF34EA4240A20194E64D0656C0D02C7F55EFE942409A90C7194D0656C0847F16EF54E942405E4261B3120656C0A8317C55BBE84240F4902E80A10556C04CCFE4BB75E842408204C719650456C0643CB1883EE84240889894E6E50256C010937E5543E74240A23394E62D0356C0A431E4BB91E54240BE8FFA4C320356C0AB25B18806E3424047ADFA4CDC0356C0107C4B2228E0424078682D80D90456C0E00216EF6CDE4240EA2BFA4C780856C0B8A7AF8886D94240DE51C819350956C0579AB188CAD7424038B560B3060A56C03FC0AF88FAD44240BE72FA4C740A56C0DFCA16EFECD1424028D3C719050A56C014C4492278CF42403EC560B3F20856C0E455E4BBF9CB4240DE86FA4C9E0856C03C8C7E5543CB4240523C61B3B80656C0C86EB2880AC84240E29C2E804F0556C0AC42E3BB85C242403EF760B3D20556C093827E55E3BE42408CAEFA4CE00756C030374B22C0BC424096D22D80A71356C0C86218EF5CB9424018F460B3661756C02B297E55F3B54240584C2E807B1856C0A4274A2278B54240F0FE94E65B1B56C06C1519EF88B542405A7BFA4CB01C56C084DC492238B542404A8961B3C21D56C020D9B28856B44240875A60B39A1E56C084D97C55FBB2424058E02D80451F56C020EAE5BB3DB14240D4D460B3802056C058FE17EFDCAB4240742294E6CB2056C0D0444922D4A64240B2C894E6372056C0ABC316EF2CA242403C0895E6D51E56C02C74B088EE9D4240F63D95E6E71C56C0FC3818EF70994240704261B3C61B56C0F462B188929542402E19C819BD1B56C083B8AF887A914240E4E894E6151D56C058B94A224C8C4240CEEE60B3FE1E56C0DC1CB08846894240BC432D805F2156C0B4D5E5BBA58842401E3561B3E82356C0E0114C22D8894240AAD1C719832856C0775517EFB48E4240CAD493E60B3A56C04C254B22309C4240A6D560B3263D56C0907B18EF289D42409E66C7191F4056C0603317EF949C4240F4A9FA4CCC4256C09892B288B29A42400A3F61B3024556C0748418EFBC974240BED994E6A94556C098DE17EF5C96424030D12D80D94756C0983E18EFE48F4240D4BFC719094A56C0443AB288E68B4240200C95E66F4B56C0D84617EFF8874240669F94E6474B56C00C96E4BB998442409EEB93E61D4A56C0D4D0E3BB798142401C0961B3EA4756C048C717EF647D42408274FB4C2E4956C0C44118EF507E424028CB94E6C74956C008D317EF0C7E42400656C819894A56C0CCCB4A228C7D4240EEA1C719534B56C0389FE4BB397D4240540C61B30A4C56C0B066E3BB857D4240E20F95E6A14C56C0F4917E55A77E424074192E80DF4C56C088FCE3BBF97F4240B8B593E6054D56C0A85AB1886281424018F4F94C5A4D56C0A0E24A22C482424048192E80D94D56C0C8B0E3BBA1834240C6272D80274F56C0ACB6E5BBF18442409C75C719C14F56C0F448B088D2854240C267C719F74F56C01C92B288F2864240F80E2E803B5056C080F817EF008A4240E81994E6A55056C0182EE4BBA18A4240D2FC2D802D5256C060C84922AC8A424062B92D80575356C0DC004B22608A424058CD94E6C35356C02B544B221C894240A6D960B3125356C0D050B08842864240EB61FA4C805256C040AE7C552B854240EC9F2D80EB5156C0A34418EF648442403AA494E6775156C0D02A4C22588342400C91C719495156C0C430E5BB6981424057ED94E69B5156C0931FB1880E804240803F60B35A5256C0A3014A221080424030D4FA4CF05456C073F1E4BBD1814240C06EFA4C265856C068FFE3BB0D864240F7FCFA4C305956C00FFFE3BB01884240F106FB4CC25856C0EC59B288B28B4240467594E6B15956C0BC134B22608F42408ECB2D803F5C56C06CC6E4BB1D954240F6CC61B3B45D56C044FEAF885299424028AA60B33A5E56C0A81AB188669B4240AF8161B36E5E56C0FC65E4BB899D4240868860B3525E56C0D8A37E55379F4240A82BC719595F56C024147D558FA0424052E261B3E25F56C09C3318EF08A14240D69760B3266156C018687E55CBA14240465094E67D6156C068C2B0884EA242403065FA4C7A6156C080F9E3BB41A74240C276C719995F56C08478E5BBE5AA4240F861FA4C5A5D56C0440A4B2268AE42408ECB2D803F5C56C0F4A917EFFCB242401C902D80DF5C56C04C3617EF5CB84240EA1661B3625E56C06B60E4BBC9BC4240820FFB4C246056C088107F55E7C04240465094E67D6156C0505E4C2258C54240928093E6B96156C020B718EFF0C74240142C61B38A6156C0D04116EF44CA42408970C719396156C0DB15B18872CC4240724894E60D6156C0CC1318EF98CE424012CCFA4C4E6156C0A8D44A22E4D042407CF7FA4CC26156C054007E553BD342401AB194E6F76156C0E0F2B28856D54240465094E67D6156C008F6E4BBE5D642402AFFFA4C2C6356C018B018EF4CD94240B8F42D80656956C0D8317E55E3DD4240A064FB4CD06A56C0B31EE4BB91E04240B83EFB4CA46C56C0B030B18896E742401EAAFA4C346E56C0C4DF4A2228EB42405CA1C719C96F56C004ACE5BBE5EC4240920E2E80B77356C064C8B08892EF4240CA8ABB453E7556C0B3E9E74039F142404470C719E17856C0CCEB16EF44F74240E0E493E60D7B56C00C44B088EEF942405AE32D80237D56C028657F55E3FA4240A4642D80F37D56C0A0C017EF44FB42407ED760B3528056C02C507E5533FB42405A512E804F8156C02C8E7D5533FC424066BC2D80D38456C05002E5BB010143405A9E2D80178756C0A86EE3BB2102434014A32E80D58856C07408E4BBCD044340224AFA4C608A56C0302017EF0008434054F3C719098C56C00B1F7F55B30A43404CB960B36A8E56C0002EB188EA0C434004A394E6898F56C05C49B188720E4340912AFB4C029056C0F85416EF60104340B62361B36A9056C0D0147E5587114340EA8FFA4C389256C0F82218EF7C14434083E82E80A19256C0236BE3BBA915434034E8FA4C2A9656C09CEA7C55831A43406E3FC719B39656C0BC444A22B41B434008E8FA4C249756C014274C22001D43403A022E80859756C0382A7E558F1E43404C462D80DF9756C028E24A228C2043403E2661B3729856C0F89EB0887626434058C960B3309856C0C866B088362B434018ED60B33A9756C070177E55432F4340A82194E6259456C004EB4B223C374340B40195E6E19056C0E483B2887E454340245E94E6A98D56C060D8B188AA4D43401EF4C619938C56C0DC417F55AF514340AA8C2E80838C56C0A8694A22F85643404C2A61B3D68C56C0FC9EE4BB1D5C4340259161B3AA8C56C0DC697E55435F434092BCFA4CD68B56C06486E4BBA9604340FEEE94E6E78A56C0839E17EFE8614340E72661B3B08956C09C1818EFC8644340BEB92D809F8856C0E4534B2200684340E2E760B3248856C03BF17D55476A434020E72D802F8956C0D01816EFAC6D4340BE872D80BF8B56C014184C22FC704340184161B30E9256C0F0CB4B22987643401A822D804B9556C0044DE6BB157843409A2FC719CD9656C0407A7F5557784340C68994E6FD9756C0D7DA7D55CF78434078E9FA4C2E9A56C08454B088127B4340E66C61B3689B56C0008916EFD47B4340756061B3A89E56C0D4D4E4BBBD7A4340101D94E6AFA256C00040E4BB6D7243407B6E2E8075A556C0C40B19EF647043405A91C71919A856C088A317EFF8714340AE9F61B314AA56C074C617EFE4754340F2DD93E6F7AC56C0947917EF687F4340D1C8C619ADAC56C07094E4BB01814340CA7AC719C1AC56C028BC17EF2083434040A4C71919AD56C0D401B2883E854340D0ECF94C9AAD56C0F89317EFCC8643405CCB60B300AE56C080D74A2280884340E64A60B3BAAD56C050E015EF148A4340A64C94E63BAD56C0480E4B22908B4340F2DD93E6F7AC56C0CC4818EFF48C43408AF02D8037AD56C06CD64A225C8E4340AE802E805DAE56C0E8097E55239143403A8CC719B7AE56C018907E55B792434082BE61B3C2AE56C0CCA9E5BB71944340485494E6A5AE56C0B8824B22FC9743403A8CC719B7AE56C0EBCB17EFB499434048F393E625AF56C01C6D4A22349C4340122261B3E2AF56C098A07D55FB9E4340BE89C71989B156C0D8B54922B8A34340AD842D8007B356C0D4C27D55CFA64340269E2D8073B456C0E4F5E2BBF9A84340013895E641C356C0F48718EFE8B943402E9AC71935C456C07002E3BB6DBB43407F1061B39AC456C0CC92AF882EBD4340F66F94E6E7C456C0FF9C4922ECBF4340AC7D94E6ABC556C0F30318EF50C24340725CC719ADC656C0644B4B223CC4434068762D80B9D656C0D4947C55FBDA4340E4C360B3FED756C070594A222CDE434076CEFA4CC8D856C0C4074C227CE243400E65C719E9D856C0D3D34B2280E5434002B7C6190DD956C09014E5BBD9E643408D9E2E8075D956C0142CE5BB29E843402C8EC71935DB56C0C4AE7D55BBEA43402C0AFA4CA0DB56C0D02116EF6CEC4340687C2E807BDC56C0F0257F55EFED43406C3595E6C1DC56C0FC117F55CBEE4340C149C819CFDC56C02C04E6BB49F04340DEA42D8047DC56C0879FE4BB09F44340AE5D2D803FDC56C0D0467E552BF74340608693E659DC56C070DC15EF54F84340144C94E68BDC56C0E00817EF54F94340F487C719D5DC56C034A17E553FFA4340727B94E637DD56C00887B28826FB4340088693E64DDE56C07791B18836FD4340AA24C7192DDF56C05BDD17EF48FF4340A0862D8085DF56C0849BB0883A0144400477FB4C36E156C008FA7D55631644403D0CFB4C2AE156C0844BB088521C44401ABA94E6B7E056C064564B2290214440DCD493E6BFDF56C05C8AE4BB1D2844407A8C61B344DE56C070A8B188D62D4440DEA42D8047DC56C034C4492294304440D83361B346DC56C034C4492294304440C60FFB4C7CD856C0C8197F554B3244400C27C819E9D756C0BF60E4BB99334440249DFA4C00D856C0F4EF4A227C354440A937C71959D856C0F876B188E238444028FF60B358D856C0A4CD16EF103B44400677C719F1D756C0201417EF003F444000D0C719FBD756C05C407D554741444088CAFA4C90D856C0EC20B0885E434440FCEC60B34ADA56C0A8F27E55CF45444046B594E687DA56C044067F55E7464440B015C71965DA56C080E2E3BB294844408486C719CBD956C04C944922844944401EDEFA4CA8D956C074E5B088664A44408E7AFB4C88D856C0E8354A22A04C4440E6562D80F3D556C0446C7C55134F4440841595E615D356C014D1E3BB0D51444016FB93E61DD156C05C52E3BBDD5144403281FA4C8CCE56C06C72B18846524440486061B304CC56C0B8E2AF889E53444062482E80CBC956C0A0E97C551356444068072E8023C856C0C84F7D55CF59444052EFFA4CE4C656C02867B088F65E444006EA2D807FC656C0C08E7E55C36144405E4EFB4C48C656C0B4A7E5BB656744407598FA4CFCC556C0800B16EF6C694440849EFA4C56C556C034FFB088666B44402E9AC71935C456C000C4E3BBE96D444056582E80DDBD56C08C67B1881E7944400EC5C719BDBC56C0E80C17EFB87D444044C42D807FBC56C0EFC27D55BF834440A0AB93E6E5BC56C0A42C7E55A78944406BB694E6FDBD56C0E0904A22DC8E44401CB494E6D5BF56C04BE3AF88C69244403290FB4C0EC356C01C907D559B96444022C994E6F7C356C004AFE5BB259744401D9F2D8045C556C0682DE6BB4998444022A794E603C656C000027E55FF9A4440349B94E655C656C0485B18EF349E444098C793E659C656C0506CB188D6A0444034F393E6D3C556C03CDF7C555FA64440F455C819D5C456C0681C17EFF4AB44405C532E8081C356C01B0BE4BB01B144404011C819FBC156C08CE017EFF0B4444066D2C71975BF56C030F2E3BB81B74440F25961B316AD56C0C0A7E4BBC1B94440AADEFA4C58AA56C0B42F7E5523BB44407C1161B30AA956C04CFBE5BBF1BC4440389F60B39AA656C050DEB28856C14440B93761B342A556C0888EE4BB35C24440863A95E6E79E56C0C83C18EFF4C344402A7D94E6379C56C0A8C8B1888EC544407E5B2D80079B56C073EBE3BBE9C64440C495C719899A56C0E0FE7E55AFC84440FE32C719F39956C0CCA37E5583C94440FA762E80239756C07C634B22F0CB444034E8FA4C2A9656C0831318EF7CCD444022F4FA4CD89556C04F54B188D6CE4440BC4B2E80B59556C080E216EF2CD044405F87FA4CB09556C08C31E5BB35D34440BEBEFA4CD29556C06CB317EFF4D3444000872E800F9656C0ACCBAF8886D4444002FAFA4C2C9656C0DCA2E4BB19D544400CB860B3409556C0B849B0889ED744407AA5C619019556C0A46BE5BB65DA4440155EFA4C5E9456C0940FB2883EDD444010ECC719859356C044924A22D0DF444083E82E80A19256C050FD7D55BFE14440F06AC819BB9156C0388517EF20E344401AE62D800B8F56C02CE44A225CE64440621FC719018E56C034EAB188FEE644409AC4C619E18C56C0A7D97E5523E84440D67B2D80118C56C0BC0DE5BBD9EA44402E1C2E80298B56C08C84B0889AF044409823FB4CB08A56C004E24B227CF84440509094E68F8956C024AC17EFF8FC4440522E2E80378956C027C17E55630245400A66FA4CFA8856C0140CE4BBE9034540C22461B38E8A56C0A8E84922A0094540D9A594E6C38A56C0087916EF600B4540D22BC719C18A56C083487E55670D4540BEBCFA4CDC8A56C0D48D4A22E80E454084532E804B8B56C0DF194922D40F4540DF8B94E6458C56C0D434B1882610454083E22D80DF8C56C0B4824B22C0104540E8A62D80798E56C058AF7F55A3134540E41AFB4C228F56C0A0F34A229814454020BE60B39A9456C0B89B4A228C194540FABB60B3789556C0906FB288D6194540C4D7C719559656C00CD4B088861A4540331EFA4CB49756C07C0BE4BB851D45400AD8C619CD9956C0B39A4A22681F4540747F94E65F9A56C04B677D555B224540C495C719899A56C074B8E5BBA5294540C495C719899A56C06C2BB088C628454085F0C719A99B56C0187417EF202D4540B0782D80A59D56C0783A7E551F30454088B960B324A356C0B3C117EF68354540C08E61B330A556C0ACF017EF0838454006DC2D8027A656C07CF17D55DB3945409A7C61B322A756C0BCA2B088463B4540BC43FB4C16A956C087CF7F55E33C45405CB660B3DEA956C0DC8E7E55B33E45407C1161B30AA956C01CAAE3BB81414540DD7C94E605A956C01CAAE3BB81414540425994E601A956C01CAAE3BB81414540A63594E6FDA856C01CAAE3BB8141454008A1C719F9A856C01CAAE3BB814145403415FA4CF4A856C01CAAE3BB81414540CFE8FA4CF0A856C01CAAE3BB81414540AC8C94E6EBA856C01CAAE3BB81414540DD00C719E7A856C01CAAE3BB81414540F29B61B3E2A856C01CAAE3BB814145409E48FA4CDEA856C01CAAE3BB8141454082EC93E6D9A856C01CAAE3BB814145409C872E80D5A856C01CAAE3BB81414540C0FB60B3D0A856C01CAAE3BB814145402AD860B3CCA856C01CAAE3BB81414540D6132D80C7A856C01CAAE3BB81414540EAAEC719C3A856C01CAAE3BB81414540742AC7196B9D56C080524B2258414540BCD52D80139256C0EC6B7F552F414540008194E6BB8656C0EC077E55074145408AFC93E6637B56C0F832B088DE4045404C6F94E60B7056C0684CE4BBB540454054B22D80B36456C0D86518EF8C40454016252E805B5956C0D41F7E5563404540D2972E80034E56C0C8D9E3BB3940454062132E80AB4256C034F317EF104045406EC793E6533756C0331E4A22E83F45405F3195E6FB2B56C0B0377E55BF3F45406A742E80A32056C00F51B288963F4540FAEF2D804B1556C01B7CE4BB6D3F45408CDCF94CF40956C01F18E3BB453F45407F46FB4C9CFE55C08C3117EF1C3F45401A3C61C178F355C07843C24CF33E4540,-22.6%,-277,949,236,713,Illinois,true
12,,-8.7%,-2,21,15,6,Guam,false
13,0106000020E61000002800000001030000000100000079000000B491789A687363C0A045540E512334405577FC7CC37263C018CA88BA781F344077CACFE5047263C090D6C402DF20344063F8F1C5DE7063C0B05E0D2A532034409C16BEE9B66F63C0E07E4916EF1C344049A8807E766D63C058D46D65161734401DBB684EA26A63C028B5BDEFF50B34403F5AD525E26663C0C09B90E5C3F9334085DB279B606563C07063B34463F23340685B1812B56363C070F28E3F90E53340749C51DCC96263C0102B51DA41DC3340069662C8C36263C0B7B318F82ED2334009E45A66D16263C070804DEFC5C433409629C45BBB6263C0208D217F37BA33400DA859FBD66163C0E8946BF880BA33401875BEE9976063C0C07E4916EFBE3340165ECC73AD5F63C010CEDF7F09BA3340A18E14E5405F63C020733682ACB43340AA86BF845C5F63C030A347AFADA933408EF5556BF15E63C0704DF167E1A23340A5982FA1655E63C0609D77B2879C33401B753EB3C95C63C020BCD2FA279133409CCFA389175B63C0E0374C0E818B3340378E9BF1685A63C09829047209873340B71A09CF0C5A63C05014D82CAF81334096CF6894265A63C0B7914A16CF7A3340501469948E5A63C08059A06BCC7633406E3ED8D6FD5B63C020C3A6C6B26933400E7B8AE4675D63C08017A236B6653340B8457C016F5F63C0F06220B1D8563340CFB56894CD6063C068AA9D6BDC533340943E836CDA6063C0A0145F94F050334001D8EAEC006263C068A3AF4BCD4E3340AE5F081DFA6263C0C0EA3A0845493340E6E24DB6E56463C0D0BEAE91EA443340E1C6E0A07E6663C0701D30AA6D41334018C8BC86D76763C060E6DE5EFA4333402BC5F7F39D6863C090BB147A24443340F1FF7AEA506963C050A2D92170423340D0D628EE0F6A63C040107587E33E3340B1D3F2DD0F6B63C0D83641CC8C3933408A2EA400A76B63C06F6B4B781D3433408DD14A1F4F6C63C0A0E7FFF7553333409E650106CE6C63C080E13B69953133408E41BEE9856D63C00FD09F6B1C2E334039AD6894FA6D63C008E3A06B7C2B3340BC52BEE99B6F63C0F8E2A06B7C2433409C16BEE9167063C070F548163F233340321FBEE9797163C0A0789E6B24193340C4031A37B87163C098072162FB1433408EC3FC1CAC7163C090DAE4AEAD0B3340E8EB72AA427263C0B8545A77DA063340FA312714447363C08012674554FF3240E544D1EFCA7363C01880B7829EF43240ED37CD47417463C0583ABA26B1F0324021B190F8D67463C0E025012315ED3240E63B1B99977563C0D887074BF7E73240007B8397DF7563C060F9F49141E9324054AF0195DA7563C030EF77A4D1EE3240230A9C88887663C050972836F7F2324097C53A3ED27763C010D86ED926F8324082617E76597963C050C4CCCC39FF324034E24CF0267A63C050242F1763033340BF8EAD047E7B63C0F07BF691180633402011D6A3197C63C080635C46710733406B94781D4A7C63C0D0E109801B0C3340BF497478837C63C0A8B71FBBCE103340A73C6DCCEC7C63C09078C911C8113340A99A1D32307D63C0E86D51D39F1833405ADE0512707D63C080B924557B233340B4E8AB7E117D63C050BD265F613033405471F643567C63C06057764F8B553340AA9C205E657C63C0E8E5F8A80C5C334032CA4B15D47C63C0C0E1A1E3FB6133407876E9F4367D63C088137885106A33403E7CCD63BE7D63C0A0611492397633405779D371F87D63C020A8C527377B33401A6C0F4D497E63C0073C684B5D7E3340F08B38BB9A7E63C0DFB67CF9A48333409B16BEE9867E63C050BD9E6B3C89334040B61C7DE67E63C0D002F3587F8E33407208AF6C157F63C05864C71667943340ECD7CF286E7F63C060403892909B33406495961AFC7F63C040457682D6A133403C83761C798063C0700719F1B2A43340C3C28C00298163C06035ECD1FDAA334012E5E6DCEC8163C0704C294531BB3340AE7DBEE99A8163C0E07E49166FC23340D5FCBDE93D8163C000E3A06B7CC83340545BBEE98E8063C0C027A16B14CD33408AFA6894E57F63C0301B4B167FD033402FD86894997F63C0A0FBF3C009D33340CA27BEE96C7F63C0409EA06BE4D733402CD86894F97E63C0A0A44B16AFDA3340EA63BEE9A17D63C0A00EF5C069DE3340C6E06894FC7C63C0C0469F6BECE63340AD7DBEE9AA7C63C04872F3C0D9E933403A527FE8F27B63C0087214CA89F333403AAD68943A7B63C05F6CA16BACF933401E509D11BC7A63C030FC65B3C7F93340BEBE0D99817A63C0D8869A2DC8013440868FE5E35E7A63C0202C4AC72405344075CE351D987A63C04FA1B547140A3440CCF17170207B63C0B055A0F5F40D3440F47B0BE63D7C63C0C8D0248BDD1A3440EE924E10B47C63C05017FEC71A263440A4A46894C77C63C048084A161F2F344027B6E9D2C67C63C060153A0079373440CA27BEE92C7C63C0688B9F6B844034400F70A272C07B63C09726019F5C43344052375B9C987A63C0586107177043344000C76894837863C06021F6C0C93F3440D2B568949D7763C09F0EF5C0693E3440E61C6994717763C090789E6B243D34408AFA6894557763C03085F4C0393B3440BB52BEE94B7763C047BD9E6BBC38344036EAE1FEC57663C0801DE7D336323440E5BF48148C7563C0378749EB812E3440B62D437CBD7463C040748B77022B34408FA66A502E7463C02F5B2233F1253440B491789A687363C0A045540E51233440010300000001000000110000007F237794179163C0E8D759392388344025C5BCFE6C9163C03F043F2B628334409F4B7959559263C04738E1E452833440FCD41F312F9363C040C4828674843440DA0743C4CD9363C0B84009F488833440AA6DA81DB09463C040C976C811823440543A3382BC9563C010CFE0DD34813440FA5CA1006B9663C01820F95A82863440B654DFD8079663C038C95048448A34406436F85D599563C007DD718DC68E3440050EBEE9739463C040BD9E6B3C9334405F2E9F687B9363C0608812CA4E973440A6CFA8D5A49263C0C0CF29C3969934404E9D9A0DFA9163C06F7CEB05179934405DE4B6942B9163C0B826774229923440298E09B2979163C08F5052F89D8A34407F237794179163C0E8D759392388344001030000000100000018000000F4727B563D9D63C0C06DC6E016BC34403E7FA4FFCA9E63C0B85724C37DBB34402D9A11B56F9F63C0B08CF6F468C23440DCA90E26969F63C0B8DB4C646AC834406ABE6894A09F63C0606CA16B2CCD3440F2F16894A29F63C090A44B162FD334405AE96894BF9F63C0C0E8F2C0A9D83440CE5679904BA063C048B49EF41ADB34408A907F3BA0A163C03FBD597114DF3440DC09E93505A263C01FE4FF60F0E3344049DC504FC4A163C0405FA09C4FE93440DE34297702A163C060E2AE3D37EC3440FF7E2179B19F63C020EB423771ED3440E63BBF28919C63C028F1FB2A05EA34408E41BEE9259B63C05027481677E0344089FA6894259B63C030EF9D6B74E0344094333E40A59A63C0B0D6F9AD59DC34407B06C7711F9A63C0A00EABEC79D73440812B7017C99963C0509124453AD3344062E8A097B69963C0389DB83804D034401E26AE51E99963C098BCBC8CA4CB3440E2F38CA8999A63C0D06BCEDD88C334401499E3890E9C63C020546E2B88BE3440F4727B563D9D63C0C06DC6E016BC34400103000000010000006900000097563300DE9263C05FAA0EE419073540A3CCA0B69A9263C0D7AA5278A5043540FE19AA04499263C0F00D1978360435409AB01803C89163C0008EF432220235406AB28F135B9163C0709BD923DE00354084A14467339163C0C004EA589BFD34407F174A14D49063C090C5F41AC1FC3440B6412964BB9063C0486382085BF93440C77B85CDBC9063C0974C469D52F63440430C03E24A9063C000DCCA9E46F3344086D3928C019063C0E03EA57D05F034406143FC98C68F63C098A2C4F8FAEB34401A6875DA698F63C030B9139186E73440824512ABD98E63C050660AF1D6E7344046AF6D547E8E63C0905F03A6FCEA34406C05BEE9E08D63C0C07E4916EFEA34409C16BEE9668D63C0E0339E6B8CEB34401875BEE9778C63C0800EF5C0E9EB3440C4E068941C8C63C0C0FBF3C089EC34408D41BEE9158B63C0A0789E6B24F23440826CBEE9948A63C0608B9F6B84F334401775BEE9178A63C010EF9D6BF4F33440BC52BEE98B8963C0509EA06BE4F3344089FA6894058963C0C0659D6B44F3344020036994988863C0D07E4916EFF134408D41BEE9758863C09859A06BCCF13440301FBEE9598863C0C027A16B94F13440F4F16894428863C0D0339E6B0CF13440D2B568942D8863C0B0FBF3C009F034408C41BEE9C58763C0B0FBF3C009F13440F1F16894428763C0BF27A16B94EE34407E1B275A198763C0C029C3379BEB34405DECD695E38663C0D89175962BEA3440E61C6994A18663C0D8E8F2C029E834406030BEE94F8663C040084A161FE53440F75F92F0BB8563C0A0412DF42BE23440B4DA9F98508563C0AFA5706019DF344094FE46B7458563C01FC01291DFDC3440B0B8824AE58463C0608B3C889EDC344032F5D5E3BB8463C0D8D22A9598DC34409CF5471D9F8463C0187EEB6FFBDD34403318CE5B338463C017064E0C82DB3440D11943F9058463C08083671713D83440FAEA6C26D18363C047E9D5BE08D63440310A3A3BB88263C0E7EC06FAD9D434400172E4DCA18163C070B5236ADCD03440D3FCBDE90D8063C0A00EF5C0E9CC3440D624587F587F63C0B06EE347E3C134408C3BE9A0827F63C0D8E53A0CB4B73440CEF081AB198063C048924DFE96AF3440C6880B40E38063C030B133F2EAAD344086A263AE8C8163C0B052B096A0A63440BEBA6BB5698263C090DAEB6892A634403B9C74E6248463C0E0C00375DD9F3440C0BB31444B8563C0B0B8F5770FA03440B4D3E2FBEE8563C0C899BE8391A034401A9919C6858663C0B838335A44A034406D1640421E8863C02F1FFD6EBB9A3440AEBB36D71D8963C040B61C0BB1963440DC8433D9AE8963C0303B412BC89434401F43B072748A63C08027B7DE509634406A8AE59BBF8A63C0C8AC7C2291963440854174C9478B63C0107D0265A9973440EA63BEE9B18B63C01085F4C0B99634404C94B67E0B8D63C080ECDE2C53963440C6835085EF8D63C0A8E8F774AA9C34403E0487DD088E63C08841835C489F344054180709748E63C050E7D0B7BFA234407619EB392E8E63C000D7E78881A43440601602022B8E63C0887E52131BA9344059D75A586A8E63C0D0C57A12F4B93440319B2A8CAB8E63C070C10FAB98BE3440337B74DEA78E63C0704CCB40CCC33440BDBC5BB4DB8E63C0D802D6B908C8344062799B5AFD8E63C0C0B9B5BCDAC834408C41BEE9358F63C018EF9D6B74CA34401C0D4C138B8F63C03800AC00F2CB3440FE24AA5C0D9063C0B0068833D3CB344060953A17829063C0B004842A43CA344026CCE37FAE9063C08F02F1BFB7C63440AD915CB2159163C07FC28BF82DC634409375CE688E9163C0D0F4226638C834401675EFD9019263C0F7EF23DAB5CA3440CA258514B49263C040657FC4A2CB3440847A4027649363C050E0BFCFF1CE344024438BF5D89363C038044D539DCE34405D8E30A2439463C02854807BE0D23440E7B68593069563C0D84BB04C00D93440EC126CC1EA9563C0B840BD65C3E13440497D90CDF49563C0A8D42BE160E734408C5A14B5459663C0DFD394FF71EA3440C06DB1FE269663C08085C86DA4EF34400C2214B9F29563C060CEB62BD8F63440663E19A9A89563C0402366AAEBFC344058C1D1B6539563C010B93453E1003540C073FD55EC9463C070FFFAA4370135409B16BEE9A69463C0C8469F6B6C033540F4F16894A29463C0C8469F6B6C053540F4D2FD64589463C00F94BC9DF10635400E25B2F30C9463C09899DA8CB2063540880EB0A5B39363C0686A943A70063540EA5EBBA26E9363C0603EDBF6FF063540B4EC397E529363C0A0ADE1A830083540601EA83C229363C0A0A403F75B08354097563300DE9263C05FAA0EE4190735400103000000010000003800000040F0F085F6A763C0F03DBE06C2383540EEA6412274A763C0F004800C18383540D3430883B3A663C028C432176738354031ECCFFC4CA663C0E87771488E3735403674C1B309A663C09861292D84343540D5FCBDE98DA563C0808B9F6B8434354070F944DB87A263C0C081C81D143135407C7AF606E6A063C0407A4FDB422F3540BC52BEE9AB9F63C0C8914A16CF2E354064D917F96A9F63C030A6E40CAD3135400A8F5D9F629F63C070763F5D13343540F0E4203C389F63C0606C3FD20D363540A5A46894E79E63C028D09F6B9C363540F15B2A257A9E63C0600272615B3235401F0B9307549E63C0784C8491872D3540990A77829B9D63C068B404B6D62B354076A8B498B49C63C0DF6079F5492A3540F41BE8FF179B63C06F7B7DBFAE2A35408FB2179A639A63C030468379672B3540203FC7B9F09963C0E0F7D819832C35404E3C55289C9963C0208DBD307C2D35404CC65B5B569963C0A091262A102D3540F27749ABC09863C07096E54E5D2D35405AE0A6CA4D9863C0202A886D4A2C35401875BEE9F79763C0C8659D6BC42B3540EE26F7EFA59763C07027D9103A2C3540EA928771769763C07097903F332B35404D9661A98C9763C0C0FD6440012A35407794A531559763C0200E3D692E293540CD520F57D29663C0D0A2686C4F293540ED02764C959663C01F811A3313283540EA63BEE9319763C0806CA16BAC1F3540D6FCBDE92D9863C010EF9D6B7418354001C76894639963C0B8469F6B6C133540A5A46894979A63C090789E6BA40F354000C76894D39B63C0D7E8F2C0A90D3540F738BEE9129D63C01098F5C0990E354056B7C324519E63C0E0783BD985103540D592741ECCA063C0700AE285721535409BEAE1E250A263C0B002F30C711935401AA070807DA463C0D00CD8D81C1835408ADB581EFEA563C0D8C807FB7E17354076F0644E1FA763C05F0A96183B1635401775BEE907A863C0A7789E6BA4163540CA27BEE9BCA863C06FAA9D6B5C163540CA27BEE95CA963C070F548163F183540321FBEE9B9A963C0D8339E6B0C1C3540C6E06894BCA963C00F029F6BD4203540C5E068947CA963C05072F3C0D9243540E963BEE921A963C010EF9D6BF427354098C49C778EA863C0FFDB77569C29354056ABA88709A863C0B031F016272E3540C04E096CE4A763C0B85312442333354020AC53064AA863C050ACBC0DFF363540CC5032F24FA863C03FB7C11ECD38354040F0F085F6A763C0F03DBE06C23835400103000000010000009500000099E832B699BC63C0909D108B2F993540594D4F6C66BC63C0B07D99B3B494354076563F270EBC63C090D75AEB4D933540B1226231F7BB63C0003A176AC09135400AC4F6B6E0BB63C0E093B396D38E354054DD6C71A2BB63C06064DFB54E8F35404648AEDF4FBB63C010F20D486C8E3540E963BEE911BB63C0A059A06B4C8C3540B36F6F30C4BA63C0B0DD1475B7883540E8135013C3BA63C04F4761EEC5843540AE0A48B9C3BA63C0EF2CBA9CE2823540DC167D1C05BB63C07037657BE8823540885BF54E2FBB63C0801849DE6081354040C72D371FBB63C0702EE3F2147D354011A8867C0EBB63C0305B7555547A3540C6A211B5F2BA63C010EDC04D0776354000B5E802A6BA63C0A0D17C5950753540EE020BB141BA63C09837641013743540D2FDDFE8F5B963C010157EAB207135409934AC60B6B963C0101BB4B0D76D3540263D274B3AB963C0E015EF7E976C3540CA5CF98F29B963C000E33BADB26A3540FC280BDBD6B863C0B08A0864CE6935403A3120B8A0B863C007CA15AEAC6B35409453375452B863C0C015D571E86E3540FA9F12C3CDB863C0DF3479285C713540F2C473B6C0B863C05084986246743540ABF6555E67B863C080ABC39271753540D2C80C269EB763C040E37413AE743540A0DDFDFE38B763C02843210C80753540E8F2ED2A22B763C0981E8C0D9A7335403CAD68949AB763C0E8339E6B0C703540F2F16894B2B763C0A00EF5C0696B354053FF3677A3B763C000B3C6A3CB673540FC3005151CB763C0302684CF556535409859BA9EB2B663C08863E5CA326235408E41BEE995B663C0E8AAF6C0F95F3540EBD445D2BAB663C000D52BC50B5D35405AED534E9EB663C05094665B1C5A3540C6A9FDD346B663C0B03C40251E563540B230135E95B563C0D01DFD76AC523540C410BB47EAB463C058FE1F5504503540FC916598B5B463C0A079184B724E3540040F1A9415B563C0B815B7A9384B3540AE3BE9ECE0B563C0D0BF59CECE453540064833CA2EB663C0B043061043433540525098CA87B663C0783B33967042354083D064A6A4B663C0B077186AFF433540EE480ACC9DB663C07023F3C366463540C5136C1CE4B663C020A17996264835401224AE4ABFB763C080D4B03D85463540CAA91B2A71B863C050EB6C2BEA453540C6DE8D3005B963C030CB120FBB433540FC24FC5A70B963C048A9A09D3141354086885B38F2B963C0908D4297124135402CB9CEE22CBA63C020FB1F5BF44135400E02246055BA63C040527E7834443540629ADC3495BA63C090D5165AFA463540BA2F9437A3BB63C0403FE334574A35401C1200142ABC63C0C0E7FC3F474C3540B3E3641A81BC63C04000865F16503540FB1F2092A3BC63C08F9A59208152354024C3BBD3A2BC63C0E029974CE954354000F77BE3DDBC63C09053525A1154354047F56F2749BD63C000F29BF203513540C45BDCB6F7BC63C0B06479D83D4E35408E9046DA4DBE63C030655D8D804D3540C868DA8147BE63C0BF9B2E98B34E354028B2330B18BE63C07848A7258B4F3540352C5E4358BE63C070EDE5FA1B5135405F7F88F6D9BE63C0C099E34CFB503540620FC6E5DEBE63C080BDE1D68E53354029F510B3F5BE63C0D77B790EA05535403E2C5665E3BE63C0985886B75557354094DA1A5DFABE63C04840851E0F5935400E7E4474A1BE63C000CB66C23A5A35408418D0874EBE63C008FA28FD665B3540502ED17CF5BD63C077F2AC95EA5C3540BCE86CADD1BD63C07802D843255F354030BD9BD934BE63C0B820569167613540B9F6C7D986BE63C050118639756235405E30BEE9BFBE63C0C8FBF3C089633540D1EC1E2CE5BE63C070EBE0817D62354045FF98C403BF63C0783469CF3C5F3540EE9B94124ABF63C0E8C0E4204A603540DA9B003F8ABF63C088BADC498C623540C8A6F4FDB8BF63C020E365551D643540D720C00DB4BF63C0806D4133AB603540FC183A7680BF63C070D3CF7DB45C3540A6AD0E09AABF63C030F74761DC5B3540263482205FC063C08062B29F6260354090550243A5C063C0C081BFCF206235409406BBB76BC063C0FF46F874FB5D3540322603C1E5BF63C0E061AAB2D25935406039FA7982BF63C038F96A51635735409EB5749536BF63C000E2E89779553540EE48DF4B61BF63C0A0537E968A5135406D3A5248F5BF63C0DF9C2CD1B34F3540F0DDC110B8C063C0B0F3E85ABC4E3540D6522B3FE5C163C048334B60C54C35401C1735957EC263C020AE38B64D4C35407C25699404C363C0D8E8F2C0294B3540331FBEE929C363C030084A169F4B3540525BBEE94EC363C00FD09F6B9C4C3540F8607E46B0C363C03F81FC6F1C4E3540225345BEF9C363C070E5A6A0B7563540E017CE9D4FC463C028C025989B5D3540285ED152BEC463C04F594EFB936135405CB7C1B609C563C0C090F80308653540E34F5838A2C563C070B2D5BF4D673540806C4222C9C563C03028DCB12C6E3540EF7E1BE3FCC563C060EC01A4CA71354016929DFB8EC663C0F08CC52F6F753540AD5933D4E6C663C0B0E65F772C773540FEFA788048C763C0A04956F7A87B3540AD4B70C44CC763C09087BDFFF8803540EED27D9B56C763C0B0BCF5CC58883540C927BEE98CC763C097789E6BA48A3540F09CED04EDC863C058FE4B8C44933540F95845A8B7C863C088B8EE711C943540C098381590C763C0B08CA3ACBE953540768D49BE33C663C0001CA22855963540C9529EB84DC563C06F4F2EACEC9535402293AEF4C5C463C027543F830E963540525BBEE95EC463C060AA9D6BDC9635406C2A5CD3DFC363C0C094AA36FD95354000C76894C3C363C030D09F6B1C993540652FBC419DC363C058C0C396999A3540323767C308C363C0977834F4209D35406AE217705CC263C0908E8E5F03A1354016823AEA1AC263C0F0B63101B5A2354096CF689426C263C0DF14A06B34A43540BC52BEE9EBC163C0BFFBF3C009A735404F1469949EC163C04872F3C0D9AB3540E71C699421C163C038EF9D6BF4AE35402C61975576C063C0601C226995B335400C275ED571BF63C0609BF9C1B8B53540CE168B6A07BF63C0A8FF1F0185B5354036C0483FCCBE63C01FCB41B27BB435404803518D9DBE63C0E088C38DECB235401675BEE967BE63C0A059A06BCCB0354058C6EF9BE2BD63C000F708B18AAD35403425ACCFDDBD63C060918A4DCBAA3540FD23120697BD63C020A94608BFA935401898DC2892BD63C0E0306ED082A73540E798CA0D4CBD63C0B8D7681842A535408844A81F72BD63C0B07D21A2A0A03540EE67BACF08BD63C01F5960B34F9C354099E832B699BC63C0909D108B2F9935400103000000010000001F00000098E00DFC570664C0A8AB7A9BACC83540099687D8C20664C0709DAFCEBBC73540175751F32D0764C000DD66D10BCA3540C6A93FF0880764C0008E9757F6CA35405F30BEE9EF0764C0D8AAF6C0F9D33540242565D4DA0764C06808C897D0D93540C51FC365800764C0E04E2353DCDF354096217E93400664C0F094A1C77BE93540540BC3B23F0564C0F03CE24B39EF3540360C3EB1F40364C0F8037DCECFF435400C4252A1C00364C08010286D3AF835400ECAC38E9B0364C000E3532653FB3540050EBEE9A30364C0EF6B48160F003640050EBEE9A30364C0B0EFF6C0110036408F94384E110364C0A7DCB559FC013640BE2F1149860264C090C9BB5AD60136409FE4D338EB0164C050BD11E5240036404A35D95DA50164C0B05E662EA9FB354018205486EA0164C0D727813A56F935408B1909B64F0264C0B0CF59B09EF53540B60B69948B0264C00898F5C019F035405EE968944F0264C06F6CA16B2CE935409A9E0256BA0264C0B83C04C0BEE43540DB30C2F5470364C03089367EE3E2354087DB7272C20364C0F89ADEACDEE03540442919E75C0464C0CF7FCE8677DF3540AAFC16C3130564C038C8595C0CDC3540B58354617E0564C0EF32320541D93540F4F4CE24BE0564C09FFCFD4661D53540C827BEE91C0664C0301B4B16FFCD354098E00DFC570664C0A8AB7A9BACC835400103000000010000006600000062BDF0016CEC63C08FD0B4EA913A3640F0F9B6CDF5EB63C000D7FEB7DA3836408EF217A373EB63C07095D5C5043936409B16BEE9D6EA63C0A0FBF3C089363640D1EFB86499EA63C0700E2F46AC323640F4F1689432EA63C0006C48168F2F36404AD5215DFAE963C020D2A9983B2F3640E44E3CA9D7E963C0E87B30CBCC2B36403D0AC7C1BFE963C000BEFB0E3E2936407C256994A4E963C0706CA16BAC263640020EBEE9A3E963C0D0E8F2C0A9263640501469945EE963C010E3A06B7C253640C827BEE95CE963C0F014A06BB42236408D65CD376EE963C0F8B644758D1B3640602CF185BBE963C0D006C72A7A1836404F6253BE32EA63C0B86DFC3DBC0E3640F4ADC95FA9EA63C0083A628DB00C36408AFA6894B5EA63C0608B9F6B84053640CA27BEE99CEA63C0B0FBF3C0090136407C25699494EA63C01098F5C019FC3540D2B568949DEA63C010029F6B54F73540466E572CB1EA63C090ABAD4043F5354092BBCFF121EB63C02FBB377F46F5354070C14EEE7DEB63C0605AD046F1F33540ED7DE96E40EB63C060D6C24809F2354022FD28B021EB63C0F05E3842CCEF35403631E20A51EB63C0F089C05B17EE35408C15D66FB1EB63C0101EB4124BEE354006D0DA603DEC63C0BFF1ACF3DBEA35407341F99278EC63C0F0BE39F6C8E73540DC361B77BFEC63C0AF89FD6DE8E535404A89E25D47ED63C09F9BC2665AE33540F2EA4E3D53ED63C04094E6B278E135407F555FD7ABED63C070080E6F23E1354029CF2802E1ED63C040140C21C6DF3540624AB47CFEED63C040574BA967DE354029DBECE76BEF63C0900FED1C30E2354030C33CE74BF063C0004CA16DE1E23540D49D81A0F2F063C010B3B206BAE2354003042B6829F263C0A895149C9DE435403530BB529FF263C0E0BCEE3DF4E4354003DA57FDE5F263C018E562C5D6E63540714B875B09F363C090CFF5CE7FE63540D48C343A15F363C098EFEF73C9E43540353047FC5BF363C0900F1F9E46E43540F59DD03285F363C060C70A0254E63540EFA66F5AEFF363C0275902D5B1E73540204B02AE4DF463C07F658760EBE93540738C498488F463C0406AD8BF50EC3540564B96CDABF463C090E739318AEE35407831D62FCFF463C0E83EBA3E97F03540C35690992DF563C08F6FDC3446F13540CEF755E450F563C0701E3CC453F33540523C2180A3F563C06097811486F4354095CF689446F663C06021F6C049F535403C0AFAB2C4F663C0D03474DCBEF635404143AB0529F763C000EAA8B948F83540BEE12166C8F763C0B0197F5423F93540A6D4F13A50F863C09014C32981FA3540BCA71B2397F863C038E01661C7FE3540847A55C2AEF863C0909B09F057013640A19412ADF5F863C088D6166E5E02364062AD4DD530F963C05F7CFBE2EE043640685E75E730F963C020521448860836406090FD2425F963C05085DB956E0B36405510C5421FF963C030142974AE0E36409E01A8212BF963C0A010E19CE71036402CD86894D9F863C0A059A06BCC113640C0BBC1EFFDF763C0D88742871D1936409B75CDB18AF763C0A0A291C0801D36405DE968947FF763C0481B4B16FF1F36404E1469947EF763C040BD9E6B3C223640E71C699471F763C0C0FBF3C0092436403AAD68943AF763C0C8659D6BC424364096CF689426F763C0708B9F6B84253640931A25D8EDF663C0A08630D752283640E4E509B436F663C0E77A904FDC293640045CADCC61F563C0184765EB622B3640C548A5C175F463C0688059CF802F3640F202F816E2F363C08F8AD84B463336407CC442BC24F363C0D0221A38FB35364092DF49DBDDF263C008FEBE6D90383640B3073B7473F263C0E0C4B8F2C439364016F3A0C41AF263C01FC0C200C43936402207FB95DFF163C0D069D693A53B36404BA918D58CF163C07093DD7B213B364025C58EC651F163C0C076519196393640340C514B34F163C030CA9DEDDF3736405871A445F3F063C080400AA6B337364082BC8BE888F063C050B50236AC3636409AEFA20D42F063C060F49EDC4C353640A01BFC25FBEF63C0B0F24B04773536406D1A0DA612F063C0A02BE2465A3736409C40DFE3FAEF63C070C1E42A3C393640CF8556FC66EF63C06042C7B3F03A36405CB2686FCDEE63C0C8244C743D3A3640B2F585F015EE63C0206B68A53E3A3640AAED7487B7ED63C0EF0BFF688638364006571D926AED63C0C01A85DDDD38364035AB2BBD0BED63C0D8671CAB933A36405EC84D81CAEC63C00754F660493C364062BDF0016CEC63C08FD0B4EA913A364001030000000100000009000000535BBEE93E3E64C0F814A06B340A3740806CBEE9543E64C030BD9E6BBC09374021036994483E64C010D09F6B9C0A37408E41BEE9453E64C0900EF5C0690B3740B70B69943B3E64C0FF019F6BD40B37401875BEE9173E64C0886CA16BAC0B3740BC52BEE91B3E64C050F54816BF0A37403AAD68942A3E64C08F0EF5C0690A3740535BBEE93E3E64C0F814A06B340A37400103000000010000000C0000009388133F863D64C058084A161F0E37407F6CBEE9A43D64C0E06B48160F0D37409F5D133FA73D64C0902DF3C0410D37402A91133FA93D64C0B0A44B162F0D3740816CBEE9B43D64C098789E6B240E37409A16BEE9C63D64C06053F5C0810F3740D2B568948D3D64C06053F5C0810F374096CF6894563D64C070F548163F0F37408AFA6894553D64C06F40F4C0210F3740F2F16894523D64C050084A161F0F3740B3C4133F4B3D64C050AA9D6B5C0E37409388133F863D64C058084A161F0E374001030000000100000006000000311FBEE9899664C0BF914A164F943740525BBEE95E9664C0F06B48160F923740EA63BEE9A19664C0C027A16B94923740BC52BEE9AB9664C0B027A16B149337403AAD68949A9664C020D09F6B9C933740311FBEE9899664C0BF914A164F943740010300000001000000050000000955133F84C564C06853F5C081A33740501469948EC564C03872F3C059A337409B16BEE996C564C048BD9E6BBCA337409916BEE986C564C037EF9D6BF4A337400955133F84C564C06853F5C081A33740010300000001000000080000006277133F60C564C010029F6B54BA37403AAD68945AC564C080C3491607BA3740BF99133F5CC564C0D0DCF5C031BA3740BB52BEE94BC564C06FAA9D6B5CB93740FC7F133F53C564C0B8659D6B44B93740806CBEE954C564C0D07E49166FB93740A3A4689457C564C06FD64A1667B937406277133F60C564C010029F6B54BA3740010300000001000000080000003AAD68945AC564C080D64A16E7BA3740F1F1689462C564C0074D4A16B7BA3740826CBEE964C564C0202E4C16DFBA374096CF689466C564C04072F3C0D9BA3740AD7DBEE96AC564C038D09F6B1CBB3740525BBEE95EC564C080C3491607BB3740EEAA133F62C564C020EF9D6BF4BA37403AAD68945AC564C080D64A16E7BA3740010300000001000000080000003566133F6AC564C0D07E49166FBB3740EEAA133F62C564C0303A491657BB3740C827BEE96CC564C0D0DCF5C031BB3740B80B69946BC564C070D64A1667BB3740DFD5133F71C564C0F0C9F4C051BB37405CE968946FC564C0076C48168FBB374096CF689466C564C0F8E2A06B7CBB37403566133F6AC564C0D07E49166FBB374001030000000100000009000000D6FCBDE97DC864C0A8789E6B24C43740CD6E133F7DC864C050274816F7C337402ED8689479C864C06F8B9F6B04C437409F5D133F77C864C0006C48168FC33740E2D5133F81C864C080D64A1667C337407D25699484C864C0DF339E6B8CC337408AFA689485C864C0C0FBF3C089C33740D3FCBDE98DC864C0B8469F6BECC33740D6FCBDE97DC864C0A8789E6B24C43740010300000001000000090000001DBC133FB8C664C0C87E49166FC837409D5D133FB7C664C068F548163FC83740050EBEE9B3C664C0A059A06B4CC83740E2D5133FB1C664C05072F3C0D9C73740B90B6994BBC664C0D0DCF5C0B1C73740545BBEE9BEC664C02F3A4916D7C737406030BEE9BFC664C010029F6BD4C737401CBC133FC8C664C0E814A06B34C837401DBC133FB8C664C0C87E49166FC8374001030000000100000009000000A4A4689487C664C0800EF5C069CA374098CF689486C664C060F548163FCA374000C7689483C664C08021F6C049CA374068BE689480C664C03072F3C0D9C93740AF7DBEE98AC664C0B0A44B16AFC937404BCD133F8EC664C0D0C9F4C0D1C9374056A2133F8FC664C0D0C9F4C0D1C937401975BEE997C664C0BFDCF5C031CA3740A4A4689487C664C0800EF5C069CA3740010300000001000000080000006C05BEE970C764C0F8AAF6C079CD37400855133F74C764C05F21F6C049CD3740C6E068946CC764C0373A491657CD374085B3133F75C764C04766F6C0E1CC37402891133F79C764C09FC3491607CD37402CD8689479C764C06053F5C001CD3740FB7F133F83C764C0002E4C165FCD37406C05BEE970C764C0F8AAF6C079CD37400103000000010000000900000056A2133F4FC764C030084A169FD23740BE99133F4CC764C04F9EA06B64D23740AD7DBEE94AC764C010E3A06B7CD23740E3D5133F41C764C0C0659D6BC4D13740C6E068944CC764C0E8E8F2C0A9D137405DE968944FC764C0C8914A16CFD137406D05BEE950C764C0A859A06BCCD137408D41BEE955C764C0C0339E6B0CD2374056A2133F4FC764C030084A169FD2374001030000000100000008000000BE99133F6CC764C040274816F7D23740B60B69946BC764C08021F6C0C9D237401775BEE967C764C000029F6BD4D237409288133F66C764C03027481677D23740A4A4689477C764C030084A169FD23740FFC6689473C764C0706CA16BACD23740B80B69947BC764C030BD9E6BBCD23740BE99133F6CC764C040274816F7D23740010300000001000000080000002A91133F69CA64C0E85F4B1697D9374085B3133F75CA64C0689EA06B64D93740806CBEE964CA64C028EF9D6B74D93740A4A4689477CA64C0B0B0481627D93740B80B69947BCA64C09059A06B4CD93740BB52BEE97BCA64C07021F6C049D93740EB63BEE981CA64C0F0E2A06B7CD937402A91133F69CA64C0E85F4B1697D9374001030000000100000008000000C927BEE90CC764C0006C48168FDB3740CE6E133F0DC764C07FD64A1667DB37401F03699408C764C0E07E49166FDB37403566133F0AC764C00098F5C099DA37404E1469940EC764C0802DF3C0C1DA37404E1469940EC764C02085F4C0B9DA3740E71C699421C764C000B7F3C071DB3740C927BEE90CC764C0006C48168FDB37400103000000010000000900000039AD68942AC764C058BD9E6BBCDC37409F5D133F27C764C008E3A06B7CDC37409388133F26C764C020D09F6B9CDC37404CCD133F1EC764C010B7F3C0F1DB3740FFC6689423C764C0E014A06BB4DB3740CE6E133F2DC764C0589EA06BE4DB3740CA27BEE92CC764C0D77E4916EFDB3740E61C699431C764C090C3491607DC374039AD68942AC764C058BD9E6BBCDC3740010300000001000000090000006D05BEE9D0C764C08740F4C021DE37406130BEE9CFC764C0F8B6F3C0F1DD3740C5E06894CCC764C02F1B4B16FFDD3740321FBEE9C9C764C0C8339E6B8CDD37400855133FD4C764C05F9EA06B64DD3740A4A46894D7C764C0A7FBF3C089DD374020036994D8C764C0688B9F6B84DD37406E05BEE9E0C764C078D64A16E7DD37406D05BEE9D0C764C08740F4C021DE37400103000000010000000900000000C7689423C964C0E0AAF6C079DE37406377133F30C964C030084A161FDE374055A2133F1FC964C0283A491657DE3740826CBEE954C964C010029F6BD4DC3740264ABEE958C964C0F0AAF6C0F9DC37402A91133F59C964C050274816F7DC3740E1D5133F61C964C0C0659D6B44DD37408D41BEE945C964C05053F5C001DE374000C7689423C964C0E0AAF6C079DE374001030000000100000008000000C727BEE9FCC764C0D8DCF5C0B1DE37402FD86894F9C764C080C3491687DE374020036994F8C764C09FEFF6C091DE374067BE6894F0C764C030084A161FDE3740020EBEE903C864C0F097F5C019DE37406ABE689400C864C050F548163FDE37401ABC133F08C864C030BD9E6B3CDE3740C727BEE9FCC764C0D8DCF5C0B1DE374001030000000100000009000000E61C699421C864C04072F3C059DF3740E61C699421C864C0F04C4A1637DF3740D2B568941DC864C0F04C4A1637DF3740D2B568941DC864C0509EA06BE4DE3740A5A4689427C864C0D07E4916EFDE374096CF689426C864C0B0FBF3C009DF3740BD52BEE92BC864C08FEFF6C011DF37402991133F29C864C04072F3C059DF3740E61C699421C864C04072F3C059DF37400103000000010000000700000067BE6894E0FF64C038D09F6B1C0139408AFA6894E5FF64C07821F6C0490039409C16BEE9160065C08021F6C0C9033940535BBEE9FEFF64C0EF14A06B34043940B80B6994DBFF64C000E3A06BFC023940A4A46894D7FF64C000E3A06BFC01394067BE6894E0FF64C038D09F6B1C01394001030000000100000006000000E2D5133F217765C0609EA06BE4C539409B16BEE9567765C0381B4B167FC0394095CF6894A67765C02FD09F6B9CC13940FFC66894B37765C01F2E4C16DFC43940E61C6994217765C0609EA06BE4C53940E2D5133F217765C0609EA06BE4C5394001030000000100000009000000E51C6994B1BE65C0B7659D6B440F3A401875BEE9B7BE65C0C0E8F2C0290E3A4096CF6894E6BE65C0401B4B16FF0E3A40C5E06894ECBE65C068AA9D6BDC0F3A40F638BEE9E2BE65C0C0469F6BEC103A40E2D5133FE1BE65C0B0659D6B44123A405CE96894CFBE65C0E06B48160F113A40C4E06894BCBE65C0BFE8F2C029103A40E51C6994B1BE65C0B7659D6B440F3A40010300000001000000090000003CAD6894BAFC65C04FAA9D6B5CC33B40806CBEE9C4FC65C0F04C4A1637C33B4058A2133FDFFC65C0D0C9F4C051C33B40C099133FDCFC65C0A80EF5C069C33B40FFC66894E3FC65C0E87E49166FC33B40F2F16894D2FC65C0708B9F6B04C43B40545BBEE9BEFC65C008E3A06B7CC33B405BE96894BFFC65C008E3A06B7CC33B403CAD6894BAFC65C04FAA9D6B5CC33B40010300000001000000080000005F30BEE92FFE65C03FE94B16C7C53B40C099133F2CFE65C0FF97F5C099C53B40BC52BEE92BFE65C05F40F4C0A1C53B40EA63BEE921FE65C0B0DCF5C031C53B40E71C699431FE65C0BF659D6B44C53B405F30BEE92FFE65C0202E4C165FC53B408F41BEE935FE65C0609EA06B64C53B405F30BEE92FFE65C03FE94B16C7C53B4001030000000100000009000000545BBEE94EFE65C0972DF3C0C1C63B402CD8689449FE65C040084A169FC63B402ED8689459FE65C040084A169FC63B40E61C699461FE65C040084A169FC63B40525BBEE95EFE65C0972DF3C0C1C63B408D41BEE965FE65C0972DF3C0C1C63B40D6FCBDE95DFE65C0C8B0481627C73B40D3B568944DFE65C0972DF3C0C1C63B40545BBEE94EFE65C0972DF3C0C1C63B4001030000000100000008000000B2C4133FEBF965C0E05F4B1697C73B40AF7DBEE9FAF965C0B0FBF3C009C73B40BD52BEE90BFA65C0A0FBF3C089C73B406130BEE90FFA65C0606CA16BACC73B409916BEE906FA65C0C0914A164FC83B405DE96894EFF965C03885F4C0B9C73B406130BEE9EFF965C0D8DCF5C0B1C73B40B2C4133FEBF965C0E05F4B1697C73B4001030000000100000009000000B70B6994DBFA65C02885F4C039C83B40AF7DBEE9DAFA65C010E3A06BFCC73B40F2F16894E2FA65C0301B4B16FFC73B4001C76894E3FA65C02F084A161FC83B409916BEE9E6FA65C08840F4C021C83B402DD86894E9FA65C0DF7E49166FC83B405AE96894DFFA65C05FAA9D6B5CC83B405AE96894DFFA65C068F548163FC83B40B70B6994DBFA65C02885F4C039C83B40010300000001000000080000009288133FC6FA65C000E3A06B7CC83B408E41BEE9C5FA65C060E94B1647C83B40EA63BEE9C1FA65C05FAA9D6B5CC83B40E61C6994C1FA65C0A7789E6B24C83B40B1C4133FCBFA65C0A7A44B162FC83B4096CF6894C6FA65C060E94B1647C83B405BE96894CFFA65C0E0C9F4C051C83B409288133FC6FA65C000E3A06B7CC83B400103000000010000000900000000C7689483FB65C0F014A06BB4C83B401F03699488FB65C03F27481677C83B406277133F90FB65C03F27481677C83B405F30BEE98FFB65C01898F5C099C83B407E25699494FB65C01898F5C099C83B40030EBEE993FB65C0888B9F6B04C93B40A4A4689487FB65C010029F6BD4C83B40244ABEE988FB65C058E94B16C7C83B4000C7689483FB65C0F014A06BB4C83B40010300000001000000050000006277133F80F765C040BD9E6B3CE93B403CAD68948AF765C0A0EFF6C011E93B40F838BEE992F765C030EF9D6B74E93B40F538BEE982F765C090A44B16AFE93B406277133F80F765C040BD9E6B3CE93B400103000000010000000A000000A2AAFC778C4966C0F02B6FD22A633C40C73B6DDEAF4966C0D8EE2A5AEF623C40FE821B5EBD4966C0C0D5B7364E633C404130EB1E894966C098AFF22218643C40B60A1DCC6A4966C0604DAE481D653C40E8C44AA45B4966C0B812D70BE7653C4026EC62CD4A4966C028213768D4663C4036581684364966C01FAB12F59A643C40E07BBEE7594966C0406684FEDC633C40A2AAFC778C4966C0F02B6FD22A633C40,-3.2%,-22,670,406,264,Hawaii,true
19,0106000020E61000000200000001030000000100000009000000C84094E6A35F56C0DC84B0882E4042402473C819D56356C0D03E16EF044042403C172E806B6456C008E7E2BB21414240E61DC819FD6456C0F4727C55BB424240BCA894E6756456C068BA7D5537474240E6EEC7195D6256C0ECA64B22B0484240F92694E62B6056C054FEB088F6464240A82BC719595F56C0ACE0B188DA414240C84094E6A35F56C0DC84B0882E4042400103000000010000005102000076CEFA4CC82855C0041218EFE489434018C1FA4C102655C0E00FB1887A894340A95CC7198D2055C050E5E4BB698D4340F69394E6D11D55C0EC004A22448E43407259C7196D1C55C05C9B4A22088D4340D7DB60B3861B55C064D5B188A68A434071CAC719D91A55C0D48B17EF50884340C48694E61F1A55C018C5B088468743406695C719DF1855C0B42D4A22E88643400221C7194D1755C050A7E4BB01864340821061B39A1455C06C86B088C6834340C2FBFA4CA41355C07036E5BB29824340783DC719F91255C0F0147E55FF7F4340EBD82D80951255C008A24A22A07D434093AA2E80751255C0946F18EF647B43403CDD94E6211255C07CE517EF98794340A422FA4C601155C0C0D416EF2C784340347BC719811055C0C8B07E55F37643401CB494E6D50F55C0E45C7D55B77543406AE32D80390F55C0B8584A229C734340C7222E80D10E55C0D0264B22507143401A7EFA4C980E55C0CCF74A22B06E4340A80D61B3860E55C0F7C04A22A06B43404A8760B3EC0D55C094E17D5567694340E258FA4C840C55C0D4084B22C06743401C5194E65F0555C01824E5BB8D634340ED102E80F50355C0684418EF486343409822C8193DFE54C048044A22086543401A752E80BBFC54C088A2E5BBB1644340D2C594E623FA54C0C84E4922C86243402EDFFA4C6AF754C0E07D16EF90614340C4BBFA4C6CF654C0C85317EFB45F4340B740C71991F554C0F003B1886A5D4340DCCFFA4C96F454C0F0467E55575B434086DAFA4C40F054C0D8C27E5573544340D4A761B3B6ED54C044BE7D55BB5143404A0362B3EEEA54C08C1AE4BBC55043408062C719A5E954C0B002E4BB6951434000E160B386E854C0708917EFEC524340985CFB4CBCE754C00CF97D5503554340306E94E66FE754C084714A226857434075B994E6B5E654C0E07518EF3C584340002294E631E254C0485A4B228C5A43401EBBC719C9E054C0EF85B088525A4340C617FA4C74DF54C0802E7D557B5943401EAF94E63DDE54C0008849222C5843400A2DFB4C30DD54C0D8614A2288564340F9F060B398DC54C08B78E4BB0556434056DFF94C54DA54C070B918EF1856434034B860B36CD954C0B045B288BE5543401ADE60B398D754C0D8C27E557354434023A7C719CBD654C0781EB2888E53434024D294E655D654C0C41A17EFA8524340C82761B3CED454C0189F18EFB44E4340A27394E603D454C0B046E4BB514D4340C027FA4C86D354C0F0554C22FC4C43400AE4FA4C38D154C07000E5BBD54D4340377A94E66FD054C010D3B088DA4E4340C8A693E679CF54C09CBE7D55C74F43400A9A2D80F9CD54C0E42DB188FA4F43404C3B61B30CCB54C0D841B1881E4F4340D5CA60B3B2C954C090DBE3BB394F4340EAA22D808DC854C0F8AC49226050434094B9C7190BC854C034B917EFA451434046FB93E65FC754C01F8816EF54544340FFBF93E605C754C074DEE3BB4D554340002194E685C654C0FCB4E5BBF1554340946FFA4CCCC454C0A8694A22F8564340B2A72D80E3C354C07F1BB08852584340341561B300C354C0EC2E4B22185A4340D1122E80FBC154C0572CE4BBA15B43404C8A61B3AAC054C098087F554B5C4340462894E609BF54C0ACA57E55AF5C43400A142E8025BB54C0C876E4BBC95F43408829FB4C7CB954C0F7E917EF3460434062C52D80B9B854C0DCAAB288565F4340823BFB4C84B854C0D0624C227C5D4340901D94E685B854C0DBC7E5BBF15A4340C675FA4C52B854C0C87918EF74584340476F60B3C6B654C0E42DB188FA4F43409F922D80E7B454C02091E3BB114B4340167D61B31EB254C02BA87D559B484340D01261B324AF54C0146417EFF846434061D32D80AFAC54C03751E5BB89444340169693E613A854C0F0A7B188263D434004492E806BA754C0B02916EF543B4340EEC694E65DA654C0E81418EF3437434012AF2D80B9A554C0009A4922AC354340259AC719BDA554C010367E55EB344340029761B3C2A554C054D217EF7C334340A311C71901A654C0B068E5BB25304340A21AC81903A654C020494A22AC2F43403EE5C719FDA554C07046B088522F43401879FA4CC4A554C080DEE4BB592E4340485D2E809BA454C047FEB1884E2A4340C0852D8067A454C0340C4B22D0284340840C95E655A454C0402916EF942743401E642D807FA454C0E0FC4A22FC25434098F793E6A5A454C0AC2FE5BB19234340B5FAF94CA0A454C050CB4B22BC2143402687FA4C94A454C0685AE4BB0D21434050042E8091A454C0C01FB2885620434042E360B398A454C09C37B288B21F43404A29FB4CC2A454C014B94C223C1F4340564A2D8007A554C020034C22F01E4340CA0162B3CEA554C0289AE4BBB11E4340ABFE60B320A654C098B318EF881E43403E3E2D8053A654C0406F17EF2C1E4340E2F5C6196DA654C09886E4BB991D4340DC4EC71977A654C084E07E55E71C43400C23FB4C62A654C01053B188D21A434061372E806FA654C0877CAF882E1A4340146094E689A654C073AB17EFA4194340D89661B3BCA654C0075D4A221C1943405D1EC81935A754C0A76A7E554B184340A6012E805DA854C098A04A22F816434070A9C71991A854C014E5B088A6164340B28461B3AEA854C080ACE5BB59164340BA18FB4CC4A854C0D0F74A22EC154340A68661B3CAA854C0E4C717EF501543406CCE94E6C1A854C0DCC1B088AE144340A0512D8065A854C094A817EF901343402BBAC71995A354C0642BE4BBB90843401A76C8193BA354C03865B0889E074340B22E61B3E4A254C0488E16EFC4054340921994E699A254C00064B2889604434028F794E627A254C03CEF4A22B0034340C0882D80A79E54C06CE1B088C6FE4240AE462E80699E54C004277D5553FE42404E7994E6159E54C0A0F216EF90FD4240122B2E80DB9D54C0A0A8B28896FC4240DE1961B3C89D54C0BF55B288E6FB4240980A94E6D19D54C0303617EF6CFB4240A0502E80FB9D54C038A6E2BBE1FA42409D87C719C99E54C0A877B088DEF842409F6B60B3E69E54C040FEB0887EF84240347594E6D79E54C0D48C16EFE0F742408C5D94E6819E54C0B0E6B0882EF74240C5E660B3EA9B54C0A349E3BB39F44240F2012E808F9B54C07013E4BBA9F342408AF9FA4C309B54C0A0E416EFECF2424074C861B3B69A54C01CEB7D559BF142404E5C94E67D9A54C048947D55B3F042400C81FA4C609A54C0587EB188DEEF4240087894E6119A54C020EC7D55BFEB4240B026C819DD9954C048694A2274EA42405AE6C619B99954C0083FB088DEE94240344DC7198D9954C080204C2258E94240979094E6859554C088ECB288CAE24240F29A60B3B89454C058DFE3BBF9E04240508160B3469454C01C5DE3BB9DDF4240728DC719439454C000D5E4BBE9DE4240A261FB4C2E9454C0305818EF40DE4240ACAE94E6419354C0CC797E5503DA424052ABC719F99254C0F8C617EF1CD84240D5DAC719AB9254C08032B0886AD742404E3094E61D9254C02044E4BBD1D64240ABB261B3A28F54C0003416EF54D54240EC722E80218F54C0B46D7D55E7D44240D7A960B3A68E54C0383D17EF5CD44240DE9794E6098E54C038F3B28862D3424038F0FA4CDC8C54C010E918EFA4D042405245FB4CAE8C54C010624A2268D0424026802D806B8C54C010E918EFA4D042402E27C819158C54C0D0F87D55D7D04240C4A2C719978B54C0408FE3BBA9D042402ABB93E6998954C03427E5BBCDCD42409A7261B3188954C07C834B22D8CC42407A8061B3E28854C02088E3BB51CC424000EDFA4CBC8854C0C30AE4BBB9CB42400C44FB4CAA8854C0E43AB2880ECB4240A45EFA4CAC8854C0C0824A2258CA42406AC9FA4CB88854C05400E5BBA9C9424058592D80478854C0F43C4B22E8C84240446D2D806B8754C04C5018EF1CC8424069BA2E805B8254C0276EB1888AC54240F602FA4C948154C060E0E3BB69C54240146EFA4CAC7F54C0F8387D551FC642403CB694E6F77E54C0A00A7E55FFC5424001EBFA4CC67D54C0D7617E55F3C442401679C7195F8154C088354A221CC0424012BD60B3D88654C0348C16EFB8B842409CEEFA4CCC8A54C0A4F94A2264B34240E8F0C719F19054C0088EE3BB1DAB4240950DC8197D9654C024B0E4BBA5A34240B49F2D800B9854C02890B188F6A14240DC5F94E6A99C54C014BE4A22509E424083DD94E6B5A154C0D07D16EF549A4240A27DFB4C7CA854C034687C55FB9442403E66FA4C9EAB54C058174B228C914240FE19FB4CC8AC54C0585E18EFB08F4240C81AFA4C52AD54C01F817C557B8E4240E4CF60B360AD54C0C01DE4BBA98D42401AD8C71925AD54C0C0837E55AB8B4240EEE7C7190BAD54C028574A22C8884240CA3461B318AD54C0B834E6BB0988424099B92D8037AD54C020CA4A2250874240F8BAFA4C64AD54C04459E3BBA1864240D8442D8099AD54C0581D4B220C864240F809FB4CDCAD54C0C4AA4A2290854240C286C71985AE54C048A516EFDC84424032B7C7192FB454C060224B2268804240725594E6B9B554C064ABB2887E7E4240A45E61B356B654C090F0B0886E7D424070D2C719B1B654C080BE16EF687C42401CD860B3B6B654C064BAE3BB4D7A4240042CFB4CAAB654C0E8A84A22A07942404CAC94E6A1B654C0F03E18EF3C78424056902D80BFB654C0D86218EF4C7642406C9E94E6D7B654C0401B4A22A8754240342361B3F6B654C0A774B188067542400BECC71923B754C0EC4A4A2260744240FAEFC7195BB754C0A832B288CE734240F62E61B39EB754C024A24A225473424044F6FA4C98B854C03098E3BB797242400E6494E675BC54C01FF0B18816704240041B2E8077C054C0975418EF9C6D42406799FA4C30C354C0F0BF4B22986D4240523394E699C354C0B45018EF646D42401E00FB4CFEC354C0D8E816EF046D424068D0FA4C46C554C0A0504A22D46A424030F5C71971C654C03C184C22B0664240E8F060B3E4C654C0D8394A229C6542405625C719A7C754C00088E4BB41644240D832FB4CD0C754C040627D55D36342405ABB60B3D8C754C038A2B0885A6342408A3694E6B9C754C0F0654A2228624240B403C719BFC754C094C57D557B61424004CAFA4CE0C754C0C4FAB188E660424090D593E639C854C030DB16EF6C60424058E894E6C7C854C0E0A3B188FE5F4240CCE3C71955CF54C0588FB0885A5E4240A614FB4CE8D554C0B7217E55CB5A42408A3594E66FD854C0C47EB2887E584240E23061B342D954C00C064B2260574240D95E94E6C1D954C0CCB07E55F3564240C8B194E671DA54C0D0844B2290564240C6D1C61993E054C0E499B188925542408AFC2D8037E654C0D0C44B2240524240A6DDC719A9E654C0F065B0882E52424022D2FA4CE4E754C0D0037E553B514240F2A894E6B7EA54C0F3514A22504D42407C2761B376EC54C044054C22FC4B4240FEBB94E6BDEE54C04808B088FA4A4240CC4294E6D5F154C0F4714A22284B4240C93CFB4CC4F354C0A00B7D55434B4240E283FA4C38F954C0B014E3BB914B4240886794E6B10155C0381617EF0C4C42403AE9FA4CB00C55C0AF87B188AA4C4240BE9094E6B11955C0F47417EF644D42408AF7C719372855C037F616EF344E4240163D2E80BD3755C0E00517EF144F4240305AFA4CC44755C0448C7C55FB4F4240321E94E64B5B55C00B8E4B22304F42407C8793E6936855C04C06E5BBB14F4240E43DFA4C807755C0B83A4B2274504240182661B3468455C0286FB18836514240E01F2E80E38D55C0A8EE17EF38524240BFB02E80FB9555C0649B17EF7C5342403B1C61B3689A55C0D0CF7D553F5442408E7160B3B29D55C074F47E55CF54424088752E807BA055C0F8DA4A22F8544240D8B794E607A155C0688818EFE4544240D26361B356A355C0C01817EF145442407714C8191BA655C06CFBE2BB0554424004C861B3F6A655C034C6E4BB01544240D8DA93E665A955C0775BE4BBF55342408A43C7192DAD55C078A9E3BBE1534240D30FFA4C14B255C05833B188CA534240143F94E6DFB755C020C9E3BBAD534240424761B358BE55C0B8477F558B5342401A4BC71945C555C064784A22685342409E8294E669CC55C06F9717EF44534240282B2E808FD355C018E649222053424080F62D807BDA55C0A0F318EFFC5242407507FA4CF4E055C0CCF47E55DB5242403C6FFA4CC0E655C0A0FB7D55BF5242407ECA60B3A6EB55C004B5B088A6524240729B61B36EEF55C00403B08892524240363DC719DDF155C03C98AF88865242404929C719B9F255C010D47D558352424074CCF94C54F555C03887E4BB75524240960494E6B3F555C028D07D554B52424004BDC7190BF655C0F8FA4A22D0524240B2BAFB4C4EF655C0A8D6B2888A534240C8E293E6C5F655C008D84B224C55424044BC94E615F755C0207EB188FE55424091A5FA4C98F755C00822B08846564240573760B31AFB55C010054A22D45642407940C719D70056C064BB18EFBC57424014442E804B0456C0886E4922485842401EC761B39C0456C0A0C2E5BB3D58424051282E80B70456C068354B220C584240E2D160B3B80456C0502FE4BB69574240DE94C719910456C024C44B2228564240FADD60B36C0356C0FCC6E4BB195042403EAD93E6930256C09F044B227C49424018BD93E6790256C0F8524A2274474240445D94E68B0256C0F0247D55CF424240B749FB4CBC0256C010A07D55D33F42408EF194E6C90D56C08FE1E4BBD53F4240720AFB4CD81856C010B27F55D73F424010BB93E6E52356C010B27F55D73F4240662AC719F32E56C02C9418EFD83F42403CD260B3003A56C03C76B188DA3F4240D2A961B30E4556C04C584A22DC3F4240A851FB4C1C5056C058C916EFDC3F42400432FB4C2A5B56C04C3AE3BBDD3F4240D6D893E6D15A56C040867F555741424080502E80CF5956C030364922544742409C0DFA4CA05956C0DC35492248494240DCCB61B3B65856C05498B288164E4240149F94E6155856C064FA492250504240C028FB4CB05756C088944A22085142400BE5C719F75656C0909AB188AA514240E22894E66D5556C010567D556B4F4240F7D42D80E55356C0800C19EF7C4C4240847C94E6355256C0F0BE7E55EF494240CC41FB4C365056C0708D17EFD8484240571F95E67B4E56C058C7B1884E4A4240376AC719254D56C06CEE16EFC44D42400073FA4C904B56C0BF0817EF28554240A4A293E6FF4856C03821E3BB055E424024D42E80814856C08431E4BB656142405035FB4C9C4856C028DB492244644240252CFA4C944956C0BC04E4BBC1684240E8BBC719D14956C01833B188726B42403256C8198F4956C058787D55F36C4240786494E6F94856C0F8F4E4BB496E424006FCFA4C5E4856C0407F4A22686F42409643C719074856C030A718EF4070424078CD94E6EF4756C0443018EF807142409643C719074856C040F87C559375424098C794E69B4756C0287D4A22207B42401C0961B3EA4756C048C717EF647D42409EEB93E61D4A56C0D4D0E3BB79814240669F94E6474B56C00C96E4BB99844240200C95E66F4B56C0D84617EFF8874240D4BFC719094A56C0443AB288E68B424030D12D80D94756C0983E18EFE48F4240BED994E6A94556C098DE17EF5C9642400A3F61B3024556C0748418EFBC974240F4A9FA4CCC4256C09892B288B29A42409E66C7191F4056C0603317EF949C4240A6D560B3263D56C0907B18EF289D4240CAD493E60B3A56C04C254B22309C4240AAD1C719832856C0775517EFB48E42401E3561B3E82356C0E0114C22D8894240BC432D805F2156C0B4D5E5BBA5884240CEEE60B3FE1E56C0DC1CB08846894240E4E894E6151D56C058B94A224C8C42402E19C819BD1B56C083B8AF887A914240704261B3C61B56C0F462B18892954240F63D95E6E71C56C0FC3818EF709942403C0895E6D51E56C02C74B088EE9D4240B2C894E6372056C0ABC316EF2CA24240742294E6CB2056C0D0444922D4A64240D4D460B3802056C058FE17EFDCAB424058E02D80451F56C020EAE5BB3DB14240875A60B39A1E56C084D97C55FBB242404A8961B3C21D56C020D9B28856B442405A7BFA4CB01C56C084DC492238B54240F0FE94E65B1B56C06C1519EF88B54240584C2E807B1856C0A4274A2278B5424018F460B3661756C02B297E55F3B5424096D22D80A71356C0C86218EF5CB942408CAEFA4CE00756C030374B22C0BC42403EF760B3D20556C093827E55E3BE4240E29C2E804F0556C0AC42E3BB85C24240523C61B3B80656C0C86EB2880AC84240DE86FA4C9E0856C03C8C7E5543CB42403EC560B3F20856C0E455E4BBF9CB424028D3C719050A56C014C4492278CF4240BE72FA4C740A56C0DFCA16EFECD1424038B560B3060A56C03FC0AF88FAD44240DE51C819350956C0579AB188CAD74240EA2BFA4C780856C0B8A7AF8886D9424078682D80D90456C0E00216EF6CDE424047ADFA4CDC0356C0107C4B2228E04240BE8FFA4C320356C0AB25B18806E34240A23394E62D0356C0A431E4BB91E54240889894E6E50256C010937E5543E74240CF55FB4C700156C0B030B18896E742405E4561B3520056C0B38A4B22E4E642408E66C71909FE55C0C0B716EF94E44240A8E593E6D9FC55C070E0B28816E442404D21FB4C88FC55C0088B4B22F0E44240261361B392F955C09B7D18EF34EA4240EB15C71981FB55C048F54922C8F1424044C994E6C1FB55C0D0BB4B2280F342408CC4FA4C4CFB55C0200880552FF6424051AB61B32EFA55C02075B1883EF74240B06D2E80CFF855C02C2B17EFDCF6424084C361B396F755C06852E4BB35F542403DBD93E6A5F655C0BF04E5BB55F34240A25B94E6A1F555C0481817EFDCF14240448493E673F455C0C898B088DAF0424072AF60B304F355C0C4CC7E5567F0424036CAFA4CC0F155C01CD04B22B0F04240442F94E635EF55C094874A2210F24240A0D8FA4C9CEE55C0147BB28826F2424002F32D8003EE55C01419B38816F34240200894E605ED55C094407D55EBF3424065F12D80F3EB55C03027492214F442403602C8191DEB55C04C2BE4BB05F34240BCBE60B3FEEA55C0EB9A17EF44F14240FE0BC819A9EB55C06CFDB1881AED42408A7861B382EB55C0D0DF4A2228EB42409C3EC7190DEA55C068C44A22A0E94240EA26FB4C22E855C0A48FE4BBD1EA4240C668C7197DE655C0B89818EFB0ED4240B61B62B3D4E555C06CB9B18832F142405EB093E625E655C0000CB288D6F34240E87594E651E755C018EFE3BB8DF742401E14FA4C94E755C0A045E4BB69FA4240C4C22D805FE755C08CD17D5503FC424052D661B3E2E655C0C070E4BBD1FC424060F62D804FE655C0D0274B22FCFC4240B61B62B3D4E555C084847F55A3FC4240068A94E67BE555C05C8117EFACFB4240FA3294E68DE555C0F8C417EF88F94240B0C360B35AE555C0301818EF44F842404473C71921E355C0909CE3BBE9F4424022B42D80A3E055C0C34D4C22BCF542400529C719FFDD55C038C1B2880AF8424019C293E64DDB55C0E3B64B2224F94240AA7B61B3EED955C0C062E5BB95F842406C2D94E66BD855C07C374A2274F742408876C819FBD655C0F3F716EFF8F54240556CFA4CD2D555C00CDD492260F4424062D3FA4CACD455C08495B18822F34240124FC71957D055C0C4CC7E5567F04240D8932D8011CE55C0FC89E3BBF5ED4240002CC71965CD55C01C0CB1886EED4240663D94E67DCC55C008E07D550BED424048CE60B350CB55C024FF4A22E8EC42409A312D808DCA55C0906EE3BB6DEC4240B21361B342CA55C09C5B16EF44EB4240FE202E801DCA55C030F216EFD0E9424096E2C719C9C955C058CFE4BB75E8424040AA61B3CEC855C0D8F317EF74E642407A112E8043C855C06C3CE3BBADE5424028922E808FC755C0A890E4BBF5E44240B2AD60B38CC555C00CDC17EF18E74240B11661B382C455C060134B2218EA4240141EC719C1C255C0147BB28826F24240AC632E8001C255C0A05BE5BB3DF4424093702D803FC155C054CBB088A6F542400E6D94E65BC055C0FCFD7D559BF64240A9EE93E637BF55C0930818EF64F742408C0261B37EBB55C038AFB08806F84240EC6C2E80A1BA55C00C2018EFB4F842406E8961B32AB955C0F05D7C55FBFA42408B8294E6B5B655C098AD7D55F3FD4240E6172D8067B455C0C8E17E5563FF42403AD494E661B355C0F09D7D5513FD4240522FFA4CDAB255C0EC99E5BBB1F942404454FB4C76B155C02037B2883EF642409C4BFA4C80AF55C0A85AE4BBB1F34240D93F2E8043AD55C04C2BE4BB05F34240FA86FB4C6EAA55C080ED17EFE8F3424014ADC71935A955C0089F4A2260F34240A0E493E6F1A955C0D84B17EFCCF042400A6093E66DAA55C0708AB18892EE42408403FA4C80A955C0F0837C5553ED4240040661B3F6A755C098784A2248ED4240A4F1C619A1A655C0801E4B22A8EE424000BEFA4C1CA655C040957E553FF14240560861B31EA655C02CAD16EFC4F342409EB5C719BDA555C08C12B188AEF542400B2C2E804BA255C0379CE3BBDDF64240505461B37CA155C02CF0E4BB19F84240DB67FA4C4CA155C0C40D4C220CFA42402C48FA4C80A155C0B8FA17EF74024340A09561B330A155C0FCF2AF882E05434014E2C71955A055C07CC415EF540643406EA494E6F59E55C06F1CB28882064340B658FA4C7E9D55C0B40918EF3C0743402045FA4C669C55C010544A22D4084340F81761B3249C55C05F407D55930B43405AA6C619819C55C0F06EE5BBFD0C4340375D2D80A59D55C01C504B22040F434042C694E6E39D55C0F85416EF6010434061B793E68D9D55C040917C5593114340D07FC719D19C55C0B0CD7D557F1143400E51FA4C149C55C098C716EFDC1043401E6961B3BE9B55C0F85416EF60104340F689C719699B55C0F04EE5BB250F4340EAC094E6A19A55C05FE14A22C00E434026AB2D801F9955C0546819EFFC0E43407232FA4C6C9655C043BCE4BBD1104340DCCEFA4C4C9555C0D0EA16EFD4124340BE6A94E6D19555C0D0174B22C4134340120561B3249755C0BC76B0886E144340F27E93E66D9855C0306BE3BBA915434074A794E6359955C0881F7E550B184340249060B3809855C0C05EE3BBE9184340A0AE93E6259755C04849E5BBB1184340CE21FB4CFC9555C014F87D55CF174340D42E2E80AB9255C030EFE4BBA9134340DADD2D80179255C0FFFC7D552B124340C1E12D804F9255C028BE4A22C80C4340D550FA4C349255C0B8D618EFCC0A43403E742E809D9155C0C8FF7E55F3084340F15394E6999055C04454E5BB8D07434032B02E800F8E55C050E5B188660543408ECB60B3068D55C06B627E551B04434052E6FA4CC28B55C04C8B7F55EF024340EEBF2D80878855C0800517EF90024340D41161B3168755C088D5E3BBF501434025C360B3AA8455C06855B288DAFD42406C32C819498355C0288917EF1CFC4240C2D22D80AD8255C0F09D7D5513FD4240EB3494E60B8255C0E47D7D553BFF4240497B93E68D8055C028B17D551F004340C87D2E806F7D55C05002E5BB01014340C6E693E6B17C55C0DC89B088C60143404C0D2E80157C55C0301016EFAC0243403EFD61B3947B55C0D88317EFB4034340B01EFB4C2E7B55C010AFB288D6044340BE24FB4C887A55C0946018EF24084340A8E860B3F07955C0E43B19EF6414434072802E80A37955C09840492208174340DC0B2E800B7955C06891B088DE19434041E7C7192F7855C0089A16EF201C4340825694E6197755C0931417EF0C1D434032F160B3787655C078454B22341E43402C872E80157555C0348B7D557B234340D2C194E6377455C0F411B188FE2443409F5FC719917355C0F411B188FE244340F84FC719B17255C0DF14B088AA2443404242C719ED7155C0204F4A222C244340613CC719997155C0FCCA4B22B0234340086F2D80457155C040E117EF9022434070C694E6877055C08CC97C5587224340CEE860B31C6E55C0188F7D55B3234340BC802E80D56C55C06419E3BBD1244340176FC719916A55C0F840B1889E2743401A6D60B32C6955C0440CE3BBF92B4340FEA4C719A96755C0E8C618EF48374340B1B9FA4CC26555C0001B17EF003B4340A86994E6716455C024FEB0888E3B434066EE2D80B36155C0E02318EFFC3B434044A4C719B76055C0F0A7B188263D4340E0FA94E6BB5F55C074DAE3BB613F4340307AC819DB5E55C044F5B088FA40434026EA60B3725B55C0E811E5BBF14443400C3494E68B5A55C090E2B288D6464340EC1EC719415A55C0988AE4BB39494340A27DC719995B55C0073E16EF384E4340F0BF2D80255C55C070B918EF185643406765FB4C9C5C55C023737E55E3574340C4C82E80215D55C0F07D4B22905A4340DA51C719195D55C0236D7D55FB5C4340662761B3E85B55C0E8B6B2880A5E43401E69C719895455C0A01D18EF245F4340011B2E80775055C090A3E5BBD55E43400AD22D80594F55C0106A19EFFC5D434016992D80274D55C0FCED16EF045A434038E0C619E74B55C0F73A4B22CC584340E24E94E64D4955C04CDF17EFB0594340A2D5C719F73F55C0AC6CB088C6624340C857C719E53B55C0DB71E4BB6D654340F22A2E80AF3955C0F4134A22E865434038A6C719713455C048044A22086543400AAE60B3983355C0FCDFB188C265434024142E80773455C07C2F18EF006A4340A30695E6013455C0A0D04A22806C434018FAFA4C1C3355C0D4A84A22386E43405A5861B3423255C0004117EF687043400C5CFA4C2C3255C028D07D554B72434018CF2D80913355C05C8D4B2218734340A0732D80593655C08C2BB1885A734340BE1694E65F3755C07C124B2220744340C677FB4C283855C0E45C7D55B7754340D497C719953755C073454B22F8764340926B61B34E3555C0405A7F557F7A434026AAC719A93455C018F8E4BBB57C43405E6BFA4C003555C05090B188E67E4340223061B3EE3555C0506CB188D6804340BA78FA4CB83755C06C86B088C6834340FC1D61B3E03755C094364B22E48743406A09FB4CF03555C07CC916EF448B43406BDC61B3B43455C0C4764922788C434043B3FA4C203155C090EB7E55EF8F4340D1C52D80173055C0D0A517EFA8914340F58094E67F2F55C0B0274A22689243403AF9C619B92E55C018907E55B7924340868160B3262E55C0E8997C5547924340B4C7FA4C562D55C0FC93B0885E904340C6D660B3FE2C55C090EB7E55EF8F43409CE5FA4C0C2C55C04876E4BB198F434076CEFA4CC82855C0041218EFE4894340,-13.4%,-79,512,60,452,Kentucky,true
8,0106000020E6100000010000000103000000010000009A00000087DBDB642ADB52C0F449A81D3FE74340B044277E5EDB52C030B6D035D6E64340CE7CD128A1DD52C02CD5CE356EE44340C0AB277E82DE52C0637479E0D4E2434060FB7CD335DF52C0CF48258BA7DD43401C837CD30BE052C018B979E06CDB4340342D7CD3EDE252C0D893D035CAD54340F0717CD345E352C0F435248B47D543403EBB267E8EE552C053A3CF35F6D34340F2717CD3E5E552C06C0AD0351AD3434074A57CD317E652C08CF7CE35BAD143408DC1D12879E652C0DC93D0354AD04340AEF97BD3BBE652C00817268BEFCE43405422277E92E652C02004258BCFCD43409F28D228BDE452C040877AE0F4CA43404206D22831E452C034B6D035D6C943405022277E92E352C030B6D03596C74340B244277E7EE352C0CCFD79E044C543400C67277EEAE352C0284FD035F2C24340362D7CD3CDE452C0F480CF35AAC043408CC1D12859E552C09F5ECF35DEBD434052E868C7A0E552C0F3067C113CBB4340B2C7D74068E452C0F7866F8C5DB84340A654E86D60E352C0F7CFA26A80B643400C3112F8C8E152C0B40A5550A2B34340FA4AD22869DF52C07C71D0353EAD4340D0C77CD343DF52C044877AE074AC4340BC607CD3DFDE52C0A05ECF351EAC43408A91ACF662DD52C08C5AF38005AA4340D37B3362CDDB52C0ACF967C94DA8434076071C626CDB52C060FAF31449A5434074A57CD317DA52C04BD2258B97A243408EC1D12879D952C0F880CF35EA9F4340904F7CD339D952C0908D258BBF9C434028F8718AE7D952C0900141A90B964340E288AACFFDD952C0EC3FE7B274934340927AC284E4D952C0386EBC0BB990434062CA9514B4D952C050478E4EFF8E43403E96E9BD6FD952C054613930238D43404E44D59BB0D952C01866F653058A4340C4D583DA33D952C038D1C54B1C874340359C7D0EA1D752C09C97F12627854340C88B90DDECD552C0002D454896824340F8FF267E26D452C050A3CF35F67D4340F2404B87E9D352C0F812CFEBE57B434044CC5F93E8D352C0DCF99A2C88794340ACFB0D61DCD352C08841B6BFC2764340A8F97BD3FBD252C0AC7A248BDF7443409A23DE79A3CF52C01CBED9E10D6E434054ECFCC982CC52C058AE31016268434080D88C18A5CA52C0D8EA3152AE6543407B90F2B458C852C07F4DFEDD316443406ABAF13065C652C0B44E32C5DE6443407ACF1B9622C652C00022BF4916664340FC2044255AC652C0284856FF196743408EB2441BEBC552C0C8DE29295F6743406C33A2D565C552C078BA0A3BE26543408897155A3BC452C0B00F8585C95643407690D6CC25C452C0C0F2AE54F95043408EC1D12899C452C040877AE0B4514340089F91C1F7C452C06C76566BDE574340C87590C087C552C0683AE585BF58434006D4962BBDC752C0F83302E587574340176BF876E8C852C018C4891A125843400867277EAAC752C02CB6D035565443405222277E92C852C0F435248B875443401E837CD3EBC852C07C71D035BE54434060FB7CD355C952C01CB979E0AC5443401E837CD36BC952C067557BE07C54434088C1D12899C952C044877AE07454434030EA7CD3CFC952C02CB6D03556544340C0607CD31FC952C0CCFD79E0445343408AC1D12859C852C01C04258B4F52434040BB267E6EC752C05FBF248BB75143404406D22851C652C05FBF248BB7514340E4E3D128C5C752C0F835248B874F434002D97CD329CC52C0D848258BA74D43403CBB267E4ECD52C0DF19CF35864B4340B044277EFECB52C0DF19CF35864B4340DE0A7CD341CC52C030B6D035964A43405322277E92CC52C037B6D035D64943402F9FD128EDCC52C0E819CF35464943403CBB267E4ECD52C0C42CD035E6484340EE717CD345CC52C0403CCF3592484340AAB67CD3BDC952C0443CCF35524B43404206D22811C852C0DF19CF35864B4340081C7CD3A7C752C0D893D035CA4A4340F0717CD325C752C07471D0357E494340ACF97BD39BC652C00417268B6F484340A4B67CD31DC652C0848D258B7F48434030EA7CD3CFC452C03C3CCF35124B4340C5BF4CCA73C452C0E4143BF9F84B4340342D7CD36DC452C08F427AE0DC4D43403BBB267E2EC452C054A3CF35B64E4340A5494888D8C352C0982F25BB674E434052D94F7DC2C352C0FCA4C579754D43404C22EC88A1C352C0E3F23ADD174B43404C947CD3B1C352C08B8D258BBF464340DE0A7CD361C352C08C8D258B7F434340E8DC148C33C352C0605B5DC0DE3F4340B582A36D07C352C028805CCEE43C4340BA3A277ED0C252C02F8FD035163A434063AA7CD3B1C352C09848D0350A3A434073A57CD3B7C352C05458248B133A4340D1C77CD303C452C0D393D0358A3A4340D6C77CD363C452C0985ECF35DE3A4340944F7CD3D9C452C0B4C5CF35023B43404206D22871C552C07871D035FE3A4340FA63277E5EC552C0B4F0248B0F3A4340F8672250F6C652C0C84718EF0C3A4340755F22506ECA52C0A80018EF043A4340C2BFEE1C6BCF52C0C8C44922083A434044A6EF1C67D452C0D4D64B220C3A43409606BCE963D952C0000C4A22103A4340205E89B660DE52C084BE7D55133A4340E0B712D68BE352C0A042E120523A434034DBD2AA56E852C050AA2064893A4340EED4F39A65EC52C06BC227DDEC3A4340926F9DC9AFEC52C060F58CC03340434048548869DDEC52C0A836467DF94643404A2F5CA938ED52C073AD2479874F43401A132FE993ED52C090AB67D454594340D2CDA42EF4ED52C0C442ED40AE6243404F03817C54EE52C01412988DB56B43400C305ECAB4EE52C0904E2C0EFD744340380A400B05EF52C024AF9EDCA47E43400A9D68006FEF52C0680E9096E3874340C28051A9D1EF52C0B8BDC0C0549143404A04C77C3AF052C00474D693289B4340846F88B69CF052C0F3417E550BA44340D40189B6E4F052C03C8517EF6CAD43408839328753F152C0102D166545B643403AD8E4A1BDF152C030D095D802C04340A5885D5E04F252C088A89F8F79C94340E0D79F5077F252C0180E8C97DED2434078117D2379F252C0F7694F2954DC4340D4C6FA4C38F252C09064492254DC43407242FA4CBAF152C0AC9A7E554BDC43407840FA4C9EF152C0F498E5BB7DDC43403EF12D808BF052C0C8F27C553BE04340DE6061B3CAEE52C0776FB28822E44340E889C719F1EC52C038B116EFA0E64340D3682E8063EB52C0B0957F5557E84340E898FA4CBCE952C0A86B18EFA4E94340CE432E8055E852C0C0824A2258EA4340CAFBC7197BE652C084F7B1883EEB4340EAD093E6ADE452C030AF4B2258EB4340842FFA4CE0E152C084F7B1883EEB4340F4DBFA4CACDF52C0B4A917EFA4EA43406020FA4C12DE52C0A86B18EFA4E943409F1394E691DC52C09816B1888AE8434028D8C7199DDB52C04847B288CEE7434094F960B336DB52C008B1B1884EE7434087DBDB642ADB52C0F449A81D3FE74340,35.4%,28,107,4,103,Delaware,true
52,0106000020E6100000010000000103000000010000005C030000AAA5FB4C8EDE53C038FFB28862DC434098E6F94C3ADF53C0E86D18EFDC9A4340E3FCC71917DF53C070834C227C9A43404CEA2D80D7DE53C04C8FB188769A4340F3132E8035DE53C0F801B288F29A4340F062C71965DD53C0843B7E55CB9B434056D894E63DD653C0484317EFCCA5434047BFC719BBD553C08370B0880EA643401652C81915D353C0F00418EFC0A64340EC2C94E695D253C0BB787E551BA743408608FA4C54D253C018D3B0889EA7434066AD2D8093D153C09F66E5BB55AA434065D8FA4C1ED153C058CD4A2270AB4340C592C71949D053C098C017EFCCAC434009E5C61979CE53C088BE7E55F3AE4340B8982D807DCB53C0C8D07D5573B14340AC15FA4C2CCB53C02468E4BBD1B143408C092E80E3CA53C0A8F84B224CB24340ACD7FA4C2CCA53C0780117EFE0B34340066694E6F3C853C09811E5BB5DB543406C5CFB4CB6C853C084497D55BBB5434064F393E677C853C078B6E4BB31B64340F60F2E8049C853C0B81DB388A2B64340EBD294E621C853C03F194A2214B74340F092FA4C52C753C033E9492250BA4340B59493E61FC753C048CCE3BBDDBA43400EA060B3DEC653C040CDE4BB69BB434058E160B392C653C0644C7D55CFBB43405AD72D8023C453C054D517EFBCBD4340B8642D80A7C353C0B874E3BBDDBD4340984FFB4C10C353C09CFEB088C6BD43408A7461B3F8C153C0D8F2B0881EBD43408ADD61B3EEC053C0106D7E5527BC4340C25F94E6B9BF53C0E700E5BB59BA434016E62D800BBF53C0D47D4C22BCB94340AA6A2E808FBE53C060EAE5BB95B94340EAD1FA4C04BE53C028C6B288A2B94340CC37FA4C4CBD53C0940EE3BB21BA4340DCFF61B3EEBC53C05F28E5BB95BA43408182C719A3BC53C0BC114B2218BB4340E443FA4C00BC53C00CEBB088AEBC4340CD55C7192BB853C07B11B188C6C24340910F61B366B753C0C89C17EF70C44340244EC719C1B653C0F0E5E3BB29C643404C3561B38CB653C090B8E5BB95C64340D0BD61B348B653C0FB6017EF04C7434005BDC7190BB653C00BED4B2258C74340807BFB4CBCB553C0E80117EFA0C7434030162D8067B553C0B42FE3BBD1C74340E68BC71949B453C09808B18832C843407D8394E6E9B353C01030B1886EC843402E1461B3B6B353C0C03EB088C2C84340681C2D80C7B353C00812E5BB1DC9434055F3FA4C0CB453C05CE1E3BBD9C94340C86394E61DB453C0507118EF64CA4340C699C71913B453C0245FB1880ECB4340062DC719EBB353C010A0AF88BACB4340FC2561B3B8B353C0C42918EF50CC4340267F61B3C8B253C09856B18886CE43402A1DFB4C70B253C07BF34B2298CF43407C1FC7192DB253C037197D559FD043401C27FB4C02B253C0A0C74B2218D14340FE84FA4CD4B153C07CDBB08882D143401EA2C71995B153C0A83919EFA4D14340F8122D8047B153C007827F558BD14340C64FFA4CD4B053C0585818EFE4D04340FCB061B3A2B053C0183F492260D043407A27FB4C0EB053C0081FB1885ECF434014BD61B356AF53C0B73DB0889ECE43400CD0C71937AF53C040A1E3BB29CE43400679C71949AF53C0C8D9E4BBDDCD4340D09C2E809BAF53C0B79FAF88AECD43407B41C71921B053C07C1BB18832CD4340F0D42D8047B053C014364B22E8CC43406495C61961B053C0F056B18892CC43407AA32D8079B053C0C0B44B2218CC434096FF93E67DB053C08F0C492294CB4340085661B37CB053C0C0C84B223CCB43401EDFF94C74B053C06BD6492204CB4340BF62FB4C68B053C0E8D116EFDCCA43407C1EFA4C0CB053C0D09717EF14CA434040FC61B3E8AF53C00488B288E2C94340A839C719B1AF53C07FD17E55A7C9434087C0C7195DAD53C0F86A7E55DFC74340F205C8194FAC53C0104C4C22BCC64340FEBD2D8009AC53C070794A2250C64340BA4CFA4CBAAB53C0EC0BB088EAC54340C637C81929AA53C0185B4B221CC5434087CAFA4CF2A453C0B373E3BBB9C34340868D61B3CAA453C064C87C5537C4434098CE2E809BA253C0B8A67E554BC543405A7C2E80039E53C0C84A18EF4CC44340B8232E80059C53C03C4DB2889AC64340CAFC60B3B89B53C02441B288E6C7434046D661B3089C53C0F42E4B2290C843404ACDC7194F9D53C054CF17EF3CC943403A4C94E6199D53C0F80B4C220CCB4340B27C2E800F9C53C0ACDD16EF84CB43409F64FB4CD09A53C0B8427E558BCB4340E6832D80FF9953C0F8494B220CCC4340D2C62D80C39B53C0708BE5BBE5CF4340D8CC2D801D9B53C0C33717EF8CD0434002D893E68D9A53C0C45AE4BBA1D043402A1F2D804D9953C0880A7E554BD043408C4261B3B69853C0C0744B2268D043404C28C7190D9753C00C454B22B0D14340C869C719C79553C010237F5527D24340583DFA4C329353C0F8247D5547D143404C4694E6EB9153C0BF8F7D5553D14340CE2FFA4C749153C048E3B088F2D1434019FFC7194F9053C09403B2883ED4434088BEFA4C908F53C020D117EF2CD5434036D32D80A98D53C0400FE5BBBDD84340D96FFA4C248D53C0908CE4BB55D94340BC51C7198B8C53C088E74922C8D9434072EA93E6CD8B53C0E09C17EF24DA43408BEB61B3828853C06C94E4BBC5D94340C298FA4C908553C054F716EFD0D6434070ABFA4CB08053C04CCE17EF18CF434012132E80797F53C0046FE4BBD1CD43407123FA4C067E53C0A00B4C2200CD4340CFE5C619A77C53C014364B22E8CC43402663FA4CAA7B53C010517D55D3CD4340648D2D80F77A53C0C0717E552BCE43408AE5C7192F7953C098C6B28862CD43407898C719D37853C010517D55D3CD4340D080C7197D7853C048367E55CBCE4340CC2861B3B67753C0A0167E55FFCE434016A894E6D57653C0F4A77D55BBCE434006A22D80337653C098E1E4BB4DCE4340B23394E6437553C0FCE1E4BB59CC43409AAA60B3987553C048D0E2BB61CA4340EA0794E6C37653C0402016EFD4C84340AA37C719597853C07C447F552FC843405E3BFB4CF67753C06BC84A22C8C643405F17C819097753C050F518EFFCC14340DAA92D80A37653C050F518EFFCC1434058A5FA4C7C7653C04819B18836C34340AA8DFA4C267653C0DCC44A229CC443404C83C719AB7553C0D8CEB18876C543404E32C719177553C0E48417EF14C5434095862D80AB7453C0249EE2BBA1C34340509C2D80E57453C0ECCAE3BBADC2434087B660B3467553C070194C22F0C14340DECA93E6537553C03CF716EF1CC14340DA222E80857453C0F8407E559BBF43400EE4F94C947353C05BACB18896BF4340CC2361B3807253C038B917EF1CC04340596AC719517153C00447E5BB3DC04340596AC719517153C0F848E3BB5DBF4340DEFC93E6337253C0E43A17EFF8BE43408E3761B39E7253C0E46DE4BBF9BD4340405EC7199D7253C050C24A2294BC43404AA360B33A7253C0105AB188FEBA43406AA82D80997353C0088717EF5CB94340907DFB4CC87253C0F8DFB0881EB843409AAD60B3D86F53C0C0BCB08826B64340368961B34A6F53C0A4894B22FCB343404A7460B39A6F53C0044C16EFA0B1434032C0FA4C187053C0E0C14B223CAF43405E3D2E80157053C000D1AF88EEAC4340883D2E801B6F53C04C8F4B2270AA43404041C719056F53C0E8004B2260AA43404A2E61B3246F53C0D05EE5BBE5A94340821261B3906F53C030FCE4BB55A84340D45E2E80F77053C0C061E3BB29A343400EAEFA4C0A7253C044AA16EF389F4340541694E69F7353C0D8CE16EF6099434000632D80A77453C0783F7D559B95434046C1FA4C167553C00C13B28802944340D89F61B37C7553C078924A227492434027E2C719097653C0F4C6B08836934340064A2E80B57653C0588FB0880E944340F0CB93E6517A53C04CD67E559B9843404A3CFB4CEE7D53C0C0BD7E55279D4340F4EDC7198B8153C038A57E55B3A14340989F94E6278553C0B0FD4A2240A64340425161B3C48853C018747E55CBAA43402ED3C619618C53C0AC3D17EF58AF434088432E80FD8F53C09484E5BBE5B34340FAFDF94C9A9353C0FCFA18EF70B84340CE56FA4C9E9453C0A8A718EFB4B943404CE9C619819553C057C617EFF4B8434066A894E6699653C064D54C22BCB6434046AE94E6BD9653C053AB17EF78B54340021294E6E39653C09CE4B0886EB44340103361B3DC9653C034C14B2224B3434052E0C7197B9653C037C118EF4CAF4340A6D12D80739653C0BF384C22FCAD4340E1ACC719919653C090D518EF7CAC4340A4B7C619AD9653C098D017EFB8AB43403C942D80F79653C020484B2268AA4340554AFA4CDE9753C02CD0B188F2A743406AF0C619D99953C050CF7D558FA343403AA161B30E9A53C03C7B17EF00A343403ED5F94C349A53C0D36EE4BB69A243407E6094E6499A53C04C1BB188CAA14340FE272E80499A53C0D0677C553BA14340841095E6419A53C0804FE4BBA9A0434060E160B3309A53C07CDD16EF1CA04340EE70C7191F9A53C0CB0D4A22C49E434051A6C719259A53C0ECFCE3BB059E43409A992D80399A53C0972DE5BB499D43405245C719A59A53C0F07BE4BB419B4340CB882E80C39A53C08065E5BB7D9A4340147C94E6D79A53C094EF17EFB8994340B8B760B3D29A53C00CEAE3BB05994340CB882E80C39A53C0584FB0885E984340D64094E67D9A53C05C7816EF849643409688C719759A53C0D436E5BBE9954340C8CFC7197D9A53C057C54A224C954340420A2E80999A53C018DCE4BBC9944340C0DA2D80E79A53C000367F5517944340325FFA4CFA9C53C014F0B18816904340764DC819899F53C03CB44B22F08C4340DFA6C71911A253C0883FB1883288434084D293E61FA353C0F4C9E3BB798543400EF893E63FA353C0C033E3BBF9844340EC442D804DA353C02044B18882844340A9C293E639A353C098427D550784434054B761B32EA353C048DCE5BB89834340459694E635A353C017B7B1880A8343408160C8198FA353C0646117EF00824340284E61B332A553C0C0F7E4BBA97E4340663261B39EA553C0ACA37E551B7E4340B474C7192BA653C0D0E97D55977D4340AE9AFA4C34A753C010014B22047D434004CAFA4CE0A753C0D0204B22D07C4340F6502E8069A853C024004A22787C43403C8C2E80C3A853C06FABB088FA7B434010322D8027A953C0A802B188EE7A4340E631C819D5A953C0FC887E55AB7843404AE3FA4C46AA53C0FC987E5597774340C05CFA4CA6AA53C068E54922087743402AE1FA4C24AB53C05091E3BB79764340A2C4C7199BAC53C070E8E3BB6D754340B64E61B31EAD53C0C0BA17EF3C7543405A0F61B386AD53C078917E55337543405C21C819D7AD53C05372B1885675434098C82E801BAE53C09033E4BBAD754340EAA82E804FAE53C05C594B221C7643400A422E807BAE53C0A842B1889E764340144994E6ADAE53C020DF7D5513774340B2022E80E3AE53C097B87E5563774340462F94E635AF53C0346BB2886677434010A3FA4C90AF53C0686818EF0C77434032CB94E603B153C0489F17EFB47343400098C719FDB253C00C7C49222C6F4340D8B1FA4C52B553C043134A22D0694340E20262B32EB753C0183B7C5587654340EE4661B388B753C0D41119EFE46443401EF0C719E9B753C06CF7E3BB81644340968C94E65DB853C0A86617EFB46443404406C719A1BA53C0A0D24B2230674340682EC8195DBD53C0ACAAB0882E6A4340DE1CFB4C3EBF53C07032E5BB3D6C4340729960B398BF53C03CFCAF88466C4340B68461B3EABF53C0C0EE16EFD06B434094C1C619A1C253C0103C7D5513664340764394E613C353C0F0D54A22E8644340507FC7195DC353C04880B088DE6343405D1C62B374C353C05BB07E55336343404CC761B3A2C353C007CF7D557362434082BEC719EFC353C0E07D16EF90614340C4482D800DC553C0C02F4922145F43402AC6C71959C553C0B00FB188125E4340E629C7197FC553C0501DE5BB415D43403C59C7192BC653C01C9CE4BB0956434070BA93E645C653C068474B228C55434090CF60B390C653C044114C22FC544340E668C7190BC753C0200BE5BB59544340E4E5FA4C02C853C0403116EF6C534340C24D61B3AEC853C0780FE5BB9D524340FC20FB4C56C953C04078E3BB9151434030C8C619E7C953C05832E4BB21504340BCB993E62DCA53C0BC1119EF304F4340B6DE60B35ECA53C024077F55674E434053C42D80F7CA53C0ECCEAF882E4A4340EA0AFB4C10CB53C00408E4BBD1494340D47861B316CB53C00C224B2298494340F4EE93E62DCB53C0F8D24A2220494340886B94E63BCB53C0BC1D7D55C3484340DCD92D802BCC53C0A8E74A225C44434046E260B38ACC53C0D0E7E5BB154343406EE4C719F5CC53C07CC8AF88EE414340AA4D60B31ACE53C03C45E4BB6D3F4340B8FD2C80A7CF53C0B870B1880A3C4340F2B8C619EDD153C010167E55133743406E42C81935D253C0440E7E55A33643403AB62E808FD253C0A4704B22503643404076FB4C08D353C0988116EF603643406A1294E605D753C0089E17EF74384340BA1994E663DA53C05C2EE4BB353A434035C994E649DD53C017444B22B83B434017BF60B346E053C04C477D55473D4340C499C71975E053C0B06917EF6C3D43404CF5FA4C8AE053C0E8D3E4BB893D434014E42D8077E053C00B057E55033E4340DE3CC71933E053C0E0EF17EF003F43409CC32E8021E053C068FDB088763F4340A42BFA4C20E053C0FCDB17EFDC3F4340980A2D8027E053C08C74E4BB19404340CACDFA4C4EE053C0A4C84A22A840434063542E80CBE253C0BC504A22C4474340FE04C719FFE253C097C916EF3448434038032E8031E353C0707F17EF804843404AB193E659E353C0FF834A22A8484340EEC62D80B3E853C0B88AB288CA4B4340423DC71919E953C0F4307D55CF4B4340DC95FB4C82E953C07871E3BB454B4340E7D9FA4CDCE953C088157D55474A4340929AFA4C44EA53C03F9B17EF144843402731C71965EA53C0A0C44B22D8464340DAB92E806FEA53C014514A22D0454340787B2D8067EA53C04063B18826454340F54BC81969EA53C09C994B2270444340F20E94E68DEA53C0DCDB4A22B4434340B65F2D80D3EA53C0EC1FE3BBC5424340E1B9FA4C04EC53C098E5B0881A404340C87760B312EC53C078FAB188CA3F434025792D803FEC53C018D64B22F43D4340EE332D8053EC53C0506D4C2298384340CCAC94E677EC53C0C8E44922E037434074F1C619C1EC53C0A0C8B18816374340A67FC719CBED53C010367E55EB344340080E2D8027EE53C04CDB7D55CB334340567C61B3CAEE53C0B09317EFFC2F4340FEC093E613EF53C0A85E7E554B2F4340EA52C819BBEF53C06882E3BBA12E4340C87CFB4CFCF053C0084218EFE42D4340BD41C7193DF153C02C587F55732D4340560462B374F153C0DC167D55C32C4340046A61B3B6F153C0A03F7E55972B4340D0DDC71911F253C0D813B088862A4340362594E6B3F253C038A94A2234294340D6CBC71909F353C0F4047E554F2843406E6294E629F353C02C87B0881A2743402ED7F94C14F353C02C414C22582643402A2794E6CFF253C080E7B1881625434011222E80B9F253C0DC6F4B22842443405831FB4CB0F253C02846E4BBDD234340EA17C719D9F253C0F335B1880E2343409265FA4C24F353C09443E5BB3D224340CABDC71939F453C0889B7D557320434050B960B3A6F553C058C77D55F31E434060B6C61947F653C094D5E4BB111E4340F26A61B3AEF753C07C7EB188461B43403E462E80A9FA53C0C4C47D55EB164340AC8294E6E1FA53C0F476E3BB51164340112B61B304FB53C014187E55A71543406075C71907FB53C01069B288A6144340007DFB4CDCFA53C02CE67E555B134340D81994E6F1FA53C0E7527D5587124340A4EEC61961FC53C03F784B22580B4340DEC2C619E1FD53C00032B088BA0643401441C719FFFF53C028D44A2234004340867594E6090254C0C04917EF84FC42408C6FC7198D0554C0200880552FF64240F0ED93E6450854C0EB9A17EF44F1424032CAFA4C840A54C0385B16EF38ED4240D6B094E63D0D54C0B8E818EF4CE842407C682E80570D54C0B4C84A22E4E74240986394E6DB0D54C0088B4B22F0E4424056EA60B3160E54C0989319EF08E44240D8A060B3E60F54C044F517EFA4DE4240E240C8193B1254C038B3B288B2D74240C8EDC719851254C0E4D0B08866D64240BAA92D80771254C0E881B088EED54240CEEBC719691254C0D88A4C22A4D542403855FB4C481254C09C6918EF5CD54240D72F60B37A1154C0B42719EF24D44240784895E6C71054C048527D555FD342408AE2C719EF0E54C028D1E2BBE1D142407FAF93E6A50E54C0F4DB17EF64D14240BB81C719750E54C0A41DE4BBB9D04240985B94E6650E54C0A0994A2290CF42404C4EC7198B0E54C018714922C8CE4240FAF2FA4CC40E54C010EEB0882ACE424090D8C7195D0F54C00402B1884ECD424070ABFA4CB01054C03832E4BBF5CB424046CEC719BF1154C00422B18826CB4240FE7961B32A1254C0D4AE7D55BBCA42405A8494E6A51254C067317E5523CA424062602D804D1354C0D89AAF8806C9424092E6C619991354C0A05B4A2228C842408BBB94E6C11354C05C697E5557C742404C53C719C11354C0C88617EFB8C64240A0F42D80B11354C0F8387D551FC642409EB794E6891354C08C8BE5BB99C542408EDD60B34A1354C0DCCAE5BB31C542403C0E62B38E1254C070F549226CC442409C81FA4C4C1254C03CDDB188DAC34240787E94E6511254C064A87D557BC24240349494E68B1254C010D97E55BFC14240164194E6D51254C00C55AF882EC14240DCB3C619A11A54C0546DB28826BA424092D493E68D1C54C020D4E4BB69B742405E1BC819F51C54C0D8DDE2BBF9B642402A862D804D1D54C054F716EFD0B642403C7A2D809F1D54C0889E18EFC8B6424002EE93E6F91D54C0B8F6E3BBE1B64240CC3E2D803F1E54C058E215EF20B7424056E0FA4C7E1E54C0E8F0E5BB89B7424051FCC619AD1E54C0700F4A2210B84240F7242D80C71E54C043CEB088AAB84240D2B9FB4CCE1E54C07445E4BB4DB9424076F5C719C91E54C0BCE14B2270BA4240D47AC719D71E54C050424A22E8BA42406A50C819EF1E54C0641419EF64BB4240EE6EC719291F54C018394922E0BB4240CC7D2D80CB1F54C044964B2224BC4240221794E6452054C02BC57D5533BC424058F494E6C72154C0E0B54B22F0BB424081DDFA4C442354C060ABB18826BB42401880FA4CF02554C0D4ED4B2224B94240046360B30C2954C050864A22D0B642404ECB60B3EA2B54C04823B2880AB442407C27FA4CCC2E54C0303D4B2240B142406A57C8191B2F54C0C79819EF08B14240221D2E80992F54C058D54922E0B04240EC1DC819D72F54C084AB7D55E7B04240687BFB4C083054C094E5B28816B14240D4ED94E6353054C07C29B0886EB142406C8461B3563054C0109CB088EAB14240FE6A2D807F3054C067744B225CB242402427FA4CC03054C0B888E3BBB5B24240062DFA4C143154C02C5D7E55EFB24240C687FA4C343254C09465B1884EB3424090E194E67B3254C06CAAE5BB99B34240A03FFB4C9C3254C04823B2880AB442408CA460B3A03254C0F4664A2210B54240B09D61B3BC3254C0A0874B2268B54240E671FA4CF43254C0DF074A22ACB5424076BAC719293354C038484B22D0B542403A7793E6ED3454C068BF7E5573B6424064BF94E6813554C0309B4B2280B64240B424C819233654C06C7E4A2260B642406AA594E6033754C08C71E4BBD9B542405C62FB4C823754C02494E3BB51B5424068A6FA4CDC3754C0F05DE4BBC1B442409C8394E6153854C0E84B18EF24B442406ED22D803F3854C0344018EF7CB342400469FA4C603854C00CC47E55C3B24240FEC1FA4C6A3854C048067E5507B242407C3995E6613854C0B0ADE4BB51B142401267FA4C443854C038CB7D55B3B04240E87594E6513754C0E8DE4A22F4AD4240A043FA4C463754C04403E3BB39AD4240DA5DC8195B3754C0602FB18856AC42400AC8FA4CC43754C06BD6492204AB4240DEB52E80213854C070E34A2244AA42401A7761B3783854C0581E18EFB4A942402920FB4CB03C54C0147F19EFBCA54240D4A1C619213D54C0A0D9B08892A54240265794E67D3D54C068677E55B3A54240ECC2FA4C623E54C07CFCE2BBEDA642409B2095E6E13E54C02819E4BB0DA74240344D60B3803F54C097D216EFF4A64240FCCB2E80414154C0E850492288A54240B03A94E6D14154C0F059E5BB3DA54240265994E6734854C018967D55DFA34240B3AEC619A14D54C030D67D558F9F4240C4662E80574E54C0D8D2B088469F4240DC8E61B3824E54C04CF54A226C9F42405E9394E6A94E54C098B7E3BBA19F4240D897C719D14E54C06FAE18EF00A042406A3094E60D4F54C080ABE3BBEDA042401002FA4C3A4F54C0E86517EF60A142402A4DFA4C7A4F54C0C46D17EFD0A14240BD9E2D80FD4F54C0C0A2B08882A242402AB294E6575354C0D02917EFE8A5424051382E80A35354C04897B1884EA64240B4CF94E6015454C034854A22F8A642406A7C94E6455554C00488B288E2A94240DD82C719895554C05F42E6BB55AA4240F21FC719ED5554C090A317EFBCAA424055FDC719755654C0307E7E55EBAA42405AA52D80435754C0A0A87D55D3AA4240CB64C719CD5754C044DD7E554FAA42401847C7191D5854C04CDC7D55C3A94240445A94E64B5854C0E0FE7C553BA94240F6552D80BF5854C09C18B1881EA74240AAC42D80035954C0ACDF17EF34A642405AA6FA4C645954C0E4D616EF38A542405013C719275A54C088D27E55CBA34240B3E7C619AD5A54C0BC43B0881EA34240B2C5FA4C245B54C0C0177D55BBA24240EA39FB4CB05D54C0488DB2884AA24240F627FB4CA85E54C0D061B288D6A142409A64C8192F5F54C0407149226CA142401A1961B39A5F54C0B88117EFF4A04240130C2E80EB6254C014524C223C9B42400C3A61B36A6354C09892B288B29A42409A68C719D96354C0B3DCB188669A42403672C7195F6554C088C0E3BB359A42401C3CC719416954C0384A4C22CC9A4240A05BC719076A54C014A04B22289B4240B4D560B39E6B54C01C77E5BB019D424038DB60B3E66D54C02824B388E29E4240FB84FA4C366E54C0571418EF489F4240EE0B2E80BF6E54C0C88E18EF34A04240B1ADC719996F54C068C2B0884EA2424034D5C719D56F54C078A0E4BBC5A2424088D894E61D7054C04819B18836A34240F687C719737054C0E8F717EF9CA34240581F2E80D17054C0544E4A22E8A342403C8594E6617154C0E49817EF38A442400899FB4CC87254C0476DB28872A4424014D5FA4CAC7354C0207917EF6CA44240D0ACC7197B7454C0303CE3BB91A44240EAEEC619B97454C0B0A017EFA8A44240A6ACC719757554C0480BB38862A542400F5495E6077654C0B802E5BB49A642404C99FA4C407654C06CC84A22C8A64240F27361B36E7654C064D5B0884EA742402C242E80017754C06800B188B6A9424060A8C719317754C0CFDDB1883EAA42401D2F94E66B7754C004F1E3BBB9AA4240882661B3067854C064667E558FAB42401684C719157B54C0B0874A2200AF4240DAD460B35A7B54C0282417EF74AF4240F25594E68F7B54C09472E4BBFDAF4240488D94E6B17B54C08013E4BB99B042405EC82D80BD7B54C0ECB3B08846B14240ACC294E6B77B54C048067E5507B242402A9B94E67B7B54C0AB7EE5BB19B54240D3D660B3767B54C060ADB288D6B542401400FA4C807B54C0A4E817EF7CB6424046A0FA4C927B54C0001818EF28B7424002B4FA4CB07B54C00C9BB088C6B74240D20294E6D97B54C0835A4A2250B84240E212FB4C0E7C54C0F8854A22C4B84240AB0A94E6497C54C0D4ED4B2224B94240A8D72D80917E54C0906CE4BB7DBB4240DE04C719D37E54C0FC1416EFECBB4240F6D3F94CF47E54C048107E5573BC4240CA5FC719F97E54C0186A7D5507BD4240FA102E80CF7E54C068E77C559FBD4240A2B660B3987E54C0F0F415EF14BE42409A8061B30E7D54C06CBF17EF04C0424019EFFA4C047D54C018594A2220C04240D2FB94E6EF7C54C05486E3BB61C042403C2694E6D77C54C0A0814B22E8C0424082DC60B3C47C54C080637F5597C14240487D94E6C57C54C0342DE5BB4DC2424097EAC719DD7C54C078D916EFF4C24240045D61B30A7D54C0009E16EF94C3424072CFFA4C387D54C067584A2208C4424001EBFA4CC67D54C0D7617E55F3C442403CB694E6F77E54C0A00A7E55FFC54240146EFA4CAC7F54C0F8387D551FC64240F602FA4C948154C060E0E3BB69C5424069BA2E805B8254C0276EB1888AC54240446D2D806B8754C04C5018EF1CC8424058592D80478854C0F43C4B22E8C842406AC9FA4CB88854C05400E5BBA9C94240A45EFA4CAC8854C0C0824A2258CA42400C44FB4CAA8854C0E43AB2880ECB424000EDFA4CBC8854C0C30AE4BBB9CB42407A8061B3E28854C02088E3BB51CC42409A7261B3188954C07C834B22D8CC42402ABB93E6998954C03427E5BBCDCD4240C4A2C719978B54C0408FE3BBA9D042402E27C819158C54C0D0F87D55D7D0424026802D806B8C54C010E918EFA4D042405245FB4CAE8C54C010624A2268D0424038F0FA4CDC8C54C010E918EFA4D04240DE9794E6098E54C038F3B28862D34240D7A960B3A68E54C0383D17EF5CD44240EC722E80218F54C0B46D7D55E7D44240ABB261B3A28F54C0003416EF54D542404E3094E61D9254C02044E4BBD1D64240D5DAC719AB9254C08032B0886AD7424052ABC719F99254C0F8C617EF1CD84240ACAE94E6419354C0CC797E5503DA4240A261FB4C2E9454C0305818EF40DE4240728DC719439454C000D5E4BBE9DE4240508160B3469454C01C5DE3BB9DDF4240F29A60B3B89454C058DFE3BBF9E04240979094E6859554C088ECB288CAE24240344DC7198D9954C080204C2258E942405AE6C619B99954C0083FB088DEE94240B026C819DD9954C048694A2274EA4240087894E6119A54C020EC7D55BFEB42400C81FA4C609A54C0587EB188DEEF42404E5C94E67D9A54C048947D55B3F0424074C861B3B69A54C01CEB7D559BF142408AF9FA4C309B54C0A0E416EFECF24240F2012E808F9B54C07013E4BBA9F34240C5E660B3EA9B54C0A349E3BB39F442408C5D94E6819E54C0B0E6B0882EF74240347594E6D79E54C0D48C16EFE0F742409F6B60B3E69E54C040FEB0887EF842409D87C719C99E54C0A877B088DEF84240A0502E80FB9D54C038A6E2BBE1FA4240980A94E6D19D54C0303617EF6CFB4240DE1961B3C89D54C0BF55B288E6FB4240122B2E80DB9D54C0A0A8B28896FC42404E7994E6159E54C0A0F216EF90FD4240AE462E80699E54C004277D5553FE4240C0882D80A79E54C06CE1B088C6FE424028F794E627A254C03CEF4A22B0034340921994E699A254C00064B28896044340B22E61B3E4A254C0488E16EFC40543401A76C8193BA354C03865B0889E0743402BBAC71995A354C0642BE4BBB9084340A0512D8065A854C094A817EF901343406CCE94E6C1A854C0DCC1B088AE144340A68661B3CAA854C0E4C717EF50154340BA18FB4CC4A854C0D0F74A22EC154340B28461B3AEA854C080ACE5BB5916434070A9C71991A854C014E5B088A6164340A6012E805DA854C098A04A22F81643405D1EC81935A754C0A76A7E554B184340D89661B3BCA654C0075D4A221C194340146094E689A654C073AB17EFA419434061372E806FA654C0877CAF882E1A43400C23FB4C62A654C01053B188D21A4340DC4EC71977A654C084E07E55E71C4340E2F5C6196DA654C09886E4BB991D43403E3E2D8053A654C0406F17EF2C1E4340ABFE60B320A654C098B318EF881E4340CA0162B3CEA554C0289AE4BBB11E4340564A2D8007A554C020034C22F01E43404A29FB4CC2A454C014B94C223C1F434042E360B398A454C09C37B288B21F434050042E8091A454C0C01FB288562043402687FA4C94A454C0685AE4BB0D214340B5FAF94CA0A454C050CB4B22BC21434098F793E6A5A454C0AC2FE5BB192343401E642D807FA454C0E0FC4A22FC254340840C95E655A454C0402916EF94274340C0852D8067A454C0340C4B22D0284340485D2E809BA454C047FEB1884E2A43401879FA4CC4A554C080DEE4BB592E43403EE5C719FDA554C07046B088522F4340A21AC81903A654C020494A22AC2F4340A311C71901A654C0B068E5BB25304340029761B3C2A554C054D217EF7C334340259AC719BDA554C010367E55EB34434012AF2D80B9A554C0009A4922AC354340989794E6B1A554C0F0A6E5BB99354340549860B35EA354C084454B22E83343403E412D8093A054C00BC4B0885E3443402E35C7192B9B54C0E0FAB0886E3743401ECA60B35E9654C068BFB0880E3843403813FA4C3A9554C09C3B4A22C838434056FB2D80499454C0001B17EF003B43403A59C819CF9354C03065E4BB453D4340283694E6719254C020F67C558748434090DDFA4CBC9154C0984717EF4C4B43403CC861B3D69054C0A8BF4B227C4C4340E24FFA4CC48D54C0AC78B088C64B43404EE394E6558C54C05CBC7E55334C4340F8AA2E805B8B54C088317E554F4E4340A907C8194F8B54C05F43E5BB994F43402B0CFB4C768B54C0B0DF16EF54514340A1122E80B98B54C0AC41E4BBF552434000902D80518C54C01021B1882E55434045EDF94C348C54C09338B1887E5643409CBB2D80CB8B54C0741BB088525843407B4560B3008C54C0D84A7E558F5B43406602C7197F8C54C0740D4A22A85D43406EC493E6138D54C0448C18EF685F4340E46961B38A8D54C01CB9B1889E614340321E2E805B8D54C0FCAE7D559B644340F05494E6458C54C0D8B87F55236643400A8461B30E8B54C06C23E5BB7567434040E4C719518A54C030B449226C6A4340A00F61B37C8954C0C0694A22AC6C4340D3F4FA4C2C8954C06C82B088DA6D434000EDFA4CBC8854C0508D4B2218734340C23D2D80B98754C0DCB5E4BB09774340680461B3E68554C064ABB088FA7B434020DAFA4CBC8354C00317E5BB698043408428FA4CB48154C034247E55D3824340686061B3308054C06CB97D55C78243402E95C719FF7E54C0DC537E558B8143408412FB4C027E54C00C0E7F551B80434086F5C619FF7B54C08CF67E55CB7E4340AA00C819237B54C0A09917EF407D434024FD93E68B7A54C014DCB1883E7B4340904AFB4C3C7A54C0782AB18836794340F21694E6037A54C09BB949228878434036B394E6DD7954C02037E4BBD97743408C4BFA4CCC7954C0134BE4BBFD764340B094FA4CF07954C044AB4A2240764340BC172E80417A54C004794B22E87543400E6BFA4C927A54C010754B22B0754340B4EC60B3B67A54C0B4DDE4BB51754340781A2D80E77A54C0BC3AE3BB9D7343406E0BC7193F7B54C0088FE4BBE5724340EDBFFA4C5E7B54C07BCAE4BB4572434076232E80E97A54C07CBF7C55DF7043406CD5C719B57954C0A4C87D55E76F4340307494E6517854C0FC467E550B71434025CD2D80137754C06B517D551B734340A2AD2D804D7654C020FF7D55EB744340F25894E6CF7554C0A03B17EF007843407465C7196D7554C06F3317EF847943401C36C719C17454C0A4FDAF882A7A43400A6D94E6F97354C0D8F5AF88BA79434042A1C719D97254C003D27C55D3774340803CC719277254C097B87E556377434098A1C719E57054C068127E55F77743401A2A2D80ED7054C0FCC27D55737943402866C719857154C06C2D7E55737B434049F761B3EE7154C050A816EF947D434038742E809D7154C09C5F7E553382434080C094E6BB7154C0E88BE4BB798443402F7794E6917254C02C537E5573854340925EFA4CF87254C084564B22BC854340D88694E6717354C0908BE4BB6D8643402C4D2D80DF7354C09C77E4BB49874340B6EEFA4C1E7454C0B3B1E3BB11884340D603C819697454C010C018EFC0894340E32495E6617454C0875CE5BB358A4340FC4BC719017454C0C4F64A22408A4340742294E6CB7054C0083D18EF4C8C4340B4E260B34A7054C03885E3BB798D434000F02D80257054C0A31C18EF68904340EE9A2D80537054C064027F5527954340505D61B33C7054C0B4DBE4BBBD964340AC7994E6BF6F54C034994A22C0984340D2C8C619AD6C54C0EF8818EF589E4340CC8AC719AD6B54C00C1F4C22B0A24340A437FB4C626A54C0ECCBB08846A34340B210C719CD6854C0D09B18EF58A3434066CDFA4C686754C050D5E4BB31A443400A8D94E6F76654C01402E6BB3DA343407C3B61B3746654C030964922ECA3434000B960B3126654C0886AE4BB25A44340C22D61B3B06554C0300716EFECA34340FA7C61B32E6554C01402E6BB3DA34340EA74FA4C706454C0F40AB188D2A44340B040FB4CFC6354C01C954922C8A94340F2F7C619796354C0C8207E550FAC4340F01EFA4CA65E54C09C42B08846B3434021CFFA4CA45D54C078D6E4BB09B44340767794E6E95A54C03F1E18EF00B44340525961B3505A54C0D0F116EF00B34340E6E7C619B35954C0B02A18EFC0B0434028C0FA4CDC5854C0BC527D555BAE4340FA4B61B3985754C000D1AF88EEAC43406E24FA4C145654C0F4097F553FAD43407A9BFA4CDA5354C084FD7E557FB04340D206C7198D5254C0B89CE5BB4DB1434024B1C719375154C04C947C5587B14340CAF32D80CF4F54C028F418EF24B24340B882FA4C864E54C0D0F116EF00B34340DB112E808B4D54C03F1E18EF00B443405A5B2E80BB4B54C0ECA1B1881EB743404AB6C719994A54C0ACA516EF9CB84340840961B30C4854C094DFB08812BA4340364BC819154754C03CDFB08806BC43406F1494E6994554C0F446E5BB3DC043400E7B61B38A4354C050AE4B22D8C343407C22C7196D3C54C048C2E4BB8DCC4340A2DA94E6033854C0B4264C227CD04340A25EC719E53754C0B76DB188CAD143408203FB4C243754C0681D7E554BD54340909594E61D3754C0D48E18EFE8D54340E602C819353754C0B0D417EF58D743408203FB4C243754C0EF7BE3BBE9D74340EA9760B3DA3654C04B59E4BB71D84340B61B62B3D43554C0A4ACB288BED943407A512E807B3554C0A89518EF34DC434098432E80B13554C034BBE4BBE9DD4340F0722E805D3654C0C8FA17EF64DF4340C4CB2E80613754C0E0014A222CE143402ECB60B3BE3754C0D8CF7D55B7E24340D1672D80393754C04C0D4A22C8E34340B61B62B3D43554C0DC29B0882EE54340008A94E67B3554C0DF114B2280E64340D253FA4C383554C03C6B4A2208E94340DEDE2D80FF3454C04053E5BB59EA43403B1E2E80973454C054C27D55D3EB43401A9694E62F3454C0D38218EFE8EC4340589294E6FD3254C0209117EF30EF4340D41C95E6D53254C0640AB2883EF04340EE5E94E6133354C0F4447F55A3F14340736A2D806D3354C00C25E4BB1DF343409A0C2E809B3354C0100D7F556FF44340451262B3543354C0D7D0B08866F64340F0D960B3A63254C00CD216EF44F64340DCED60B3CA3154C02CD3B2888AF54340580D95E6FB3054C0D89B17EFB4F54340D14FFB4C8E3054C078F5B188F6F643401C4361B3A23054C0D013B1882AF8434042FF2D80E33054C034517D553BF94340580D95E6FB3054C0C08A492214FA434084AC94E6813054C0501118EF44FC4340516493E6ED2F54C0D87F7D55CFFD434068B02D80712F54C06075B18896FF43408F97C7193D2F54C0A4A77E557F024440BC2EC7194D2F54C0EC2E18EFC8074440AA5D94E60F2F54C0D435E5BB3D0A4440E687C7195D2E54C03830E4BB610D4440B0A061B3FC2C54C01C54E5BBD9114440685EFB4C702C54C0AF1AB1882A144440E44761B3F82B54C033E44922B81844408C3B2E80612B54C0C33FB088AA1B44405533FB4C082A54C0BC464B22B02044402C0CC7196D2954C04C377E55B3214440A807C819B12754C0785E7E55E323444096BAC719552754C074B6E4BBA924444053402E80B72654C038B5B188A228444042A52E806F2654C094077F55632944401A42C719852654C020BC7E55172B444042442E80EF2654C0B8F417EFF42D444082FCFA4CF82654C0B018E6BB952E4440726861B3E22654C03841B188F62F444042442E80EF2654C034C449229430444046FD94E6352754C01CC0E4BB093144402FE72D80A72754C010E7B1885631444027F293E6112854C094D9E2BB793144408E642D803F2854C0583318EF743144400CB9FA4C222854C030B817EF703444401E4B2D80D32654C0B85FE4BB75394440B60CC7197F2654C0E04AB188563C444030C3FA4CBA2654C05CD47E55333E44406473C7194D2754C028304A2278404440DA8CC719B92854C06079E4BBC1444440A225C719D92A54C074AF16EF2849444030AD2D80512B54C0486BE3BB5D4B44405AB693E6A52A54C0C0CA7F55EF4D444016D32D807D2954C00CAC4A22484F4440ECA32D80D72754C098E516EF2050444072F493E6392654C09708E4BB35504440780494E6252554C0DFF37D553F4F44401F34C819492254C09C59B0885E5244403B492E804B2154C02CBBE5BBC95244403B492E804B2154C0487AB188B65244403B492E804B2154C0C8984B22A45244403B492E804B2154C0E4C8E3BB915244403B492E804B2154C05376B1887E5244403B492E804B2154C070357D556B5244403B492E804B2154C0E0E24A22585244403B492E804B2154C0F0A116EF445244403B492E804B2154C0DCAEB28832524440FCE060B34A2154C0E0677E55EB474440E7FEC719492154C053F1E4BBA53D4440585595E6472154C0588C49226033444060BD60B3462154C03093E5BB19294440D8132E80452154C0342E4A22D41E44401173FA4C442154C0A846E4BB8D144440FC9061B3422154C08C2F19EF480A4440FC9061B3422154C0A0CA7D550300444074E72E80412154C04F6518EF18F743407C4FFA4C402154C02CB2E2BB2DEE4340EEA5C7193F2154C0E04C7D5543E543402E0594E63D2154C09C58E4BB59DC434070022D80E71854C0A0C9B0885ADC4340285F94E6911054C0A0C9B0885ADC4340A7C4FA4C3C0854C01C9A4B225CDC4340F0C193E6E5FF53C02C7CE4BB5DDC4340AA1EFB4C90F753C03CEDB0885EDC4340FA8C60B33AEF53C0485E7D555FDC4340F24894E6E3E653C0584016EF60DC4340AAA5FB4C8EDE53C038FFB28862DC4340,-53.1%,-162,143,17,126,West Virginia,true
53,0106000020E610000008000000010300000001000000590000001C41D3C4EEC255C0689B14026FA546408C03479AFBC055C02075C65C65A546400E9526D65CBF55C0A040701CD9A5464096C97C16E9BE55C02075C65C65A546400A0F95133BBF55C050E057F3BCA34640EE0711C679BF55C0E8897D39A5A24640587EBD5C77BF55C0C859F12497A14640A098E87C3DBF55C05403176B7FA0464068F38C62D3BE55C0043A52C14A9F464064C79700AABF55C0B4C1F38DA79C46404A806FF91CC255C0B407E196FD9E4640C894F35CC3C255C0043A52C14A9F4640A218A009A6C355C0946EA801D79E46402E1C62B086C355C09CE37707339E4640D8A016E206C355C0180CABC27B9D4640C894F35CC3C255C0B4C1F38DA79C46402E1C62B086C355C093C049769F9846400E8F4CA0A3C355C0B4AAE8815797464098920E4784C355C01CBBD53219964640AACA262EF1C255C0D866E08E40944640C894F35CC3C255C08C9D1BE50B9346409AAFF3888DC455C0208D2E344A94464002FAAABD61C555C0974CB56E7A94464046F4030142C655C0400E21BFE9934640E4F22670A0C555C07479B255419246406AB0FB0D2BC355C0D043B2FDAC8E4640C468FEFA99C355C0AF1326E99E8D464022E449C919C455C0F02D5109658D4640785F959799C455C060E1B4BE518D4640A641A8D0F2C455C06F62A749F18C4640B8D35C1858C555C078BF3045C68B46409246470875C555C0AFCD38E0488B46409083FE2664C555C0143BAF8CDF8846402C562C3499C555C0946F05CD6B884640185BCB6B1BC655C05355DAACA58846400323B384AEC655C0D420846C1989464084EE5C4422C755C0DC2CA7F15C8946400AC62989D9C755C0143BAF8CDF8846408A91D3484DC855C00C983888B487464006E30ECBE2C855C020D33D0AFE8446406B679083C9CB55C0100D99743F7E4640D2B147B89DCC55C0FC0BEF5C377A46402BB611E41BCB55C0FCC50154E17746408EB7EE74BDCB55C0FC2EAED4F9764640BEB6E6EF1FCD55C06C4BBE0AFF754640661BC944BACD55C00C0107D62A754640B64D3A6F07CE55C0E0D07AC11C74464054A6F93E5ECE55C0FC17A3C8A9714640D471A3FED1CE55C0642890796B704640F2DBF996F2D155C004C7CD38476A46405E6F8B6FF9D255C06CD7BAE90869464090D442D097D555C024B16C44FF6846409C1A30D9EDD755C090411182296C46401B89509D8CD955C0BC662429FC7046409A54FA5C00DA55C000985A55127646409E80EFBE29D955C0D82150517F7B4640914BC47299D755C00C3B40730E8046400DE09049D7D355C01B01E508CD864640704A1A5B91D355C0F473CFF8E986464036D652DAD2D255C0348EFA18B0864640742D351988D255C01B01E508CD86464008F43FA179D255C0E4F2DC6D4A87464052DDD62794D255C0CC1461E7D5884640742D351988D255C0DC2CA7F15C894640C6BC2F3FAAD155C0F8F38685528B46404A77174258D155C090E399D4908C464087CEF9800DD155C01CA4CA26C9904640100350C199D055C0005DA21F3C934640AD3E2A4FE7CF55C0B0701EFE44954640FECD247509CF55C0003AE3A7799646407470C66D30CE55C0887A5C6D4996464074CD4F6905CD55C0A0EF2B73A5954640063ABE90FECB55C0B87C418388954640886E14D18ACB55C034DF3EC2E3964640C07C1C6C0DCB55C03C82B5C60E9846409B6C6234E5C855C034252CCB39994640D47A6ACF67C855C084EEF0746E9A464088CE8A673CC855C0801C98733D9C464084EE5C4422C755C0188C624FE4A146409B6F4FCFC1C655C06CBED37931A246401A1E144D2CC655C04431BE694EA24640E4F22670A0C555C00417934988A246409083FE2664C555C08BEE5F8E3FA34640DCE603EB5CC555C0D8B7243874A44640FE7319FB3FC555C0AFC162A778A546401A7B9D4801C555C06432688156A646409AAFF3888DC455C064C9BB003EA74640EC3EEEAEAFC355C077B35A0CF6A546401C41D3C4EEC255C0689B14026FA546400103000000010000001600000094AF846FBCBB55C0E8B7026B16B646402C65CD3AE8BA55C0182394016EB446400A72F844C9B955C08FE21A3C9EB446407482E5F58AB855C018BAE78055B54640962FCDE253B755C03C47FD9038B5464056BB056295B655C048257917ADB34640E607A2ACA8B655C008C560EE90B146406896944D2DB755C0E4F15DD557AF4640340E1E75CCB755C07004309C58AD4640E6613E0DA1B755C0B4123837DBAC4640962FCDE253B755C0C7FCD64293AB4640F2937CBE54BB55C0C8932AC27AAC464028DC4EDDE9BC55C0B87BE4B7F3AB4640009DB2A8BBBD55C0282F486DE0AB4640CC143CD05ABE55C0C8932AC27AAC464038F494E770BD55C0A8A98BB6C2AD46400E98137139BD55C06426B415E4AE4640871AE38C7ABD55C0AC2943432BB24640839451CA58BD55C01017717C2AB44640068CF0EBF5BC55C078049FB529B646403CD7AFA567BC55C014E88E7F24B7464094AF846FBCBB55C0E8B7026B16B6464001030000000100000014000000CF13E1742DAF56C054669ED9D2634740C25E6DB505B256C0ECE11C21EC604740081C0FDAF6B256C074B9E965A36147407655045205B356C008405034C9634740963FA35DBDB156C0B0DEFC0C766647407E6AEEA7DEAC56C01706F5C9876A474020E37F541BAC56C0484EC7E81C6C47404AE5646A5AAB56C0C0A4A1A2346D47401B63C8C7B2A756C034AA15E6BA6F47407BB06C9763A656C0CC02D5B511704740A5A62E285FA556C0D8C80A32FF6D4740D17C1EDC74A556C058660DF3A36C4740F0E9610F72A656C04042A463D96B4740701BCBB421A856C07F5CCF839F6B4740A6639DD3B6A956C02012184FCB6A4740240F75B644AB56C07C0ABFF505694740A723F919EBAB56C088E83A7C7A674740380AD67EC2AA56C0C802669C406747400C8E822BA5AB56C088A24D7324654740CF13E1742DAF56C054669ED9D26347400103000000010000001000000022B27CA19EA356C0C0B033414976474060095FE053A356C0F80FA2525D744740A8C6000545A456C0A78CCAB17E7547405C80E08255A556C0A017FBAB227647403810B0B47BA656C0C0B033414976474020E66CEFF7A956C0DF3126CCE87547409A745F907CAA56C0AF2F41B6A9764740E77DC8F37CA956C044B6A784CF784740803311BFA8A856C0CC8D74C9867947406006724577A556C0A497B2388B7A47402C274CA7FAA256C03887C587C97B4740531D0E38F6A156C02F7BA202867B47407930B50AFBA156C05CDA10149A794740DCF4DA7CADA256C05C43BD94B2784740D17F0B7751A356C03C133180A477474022B27CA19EA356C0C0B0334149764740010300000001000000E0020000584B936967B556C02435B5F92F794740B9F2D39910B556C044B6A784CF78474054C8EE4122B356C0049C7C6409794740402A177579B256C09851C52F35784740C8A7475938B256C0B098ED36C2754740FFB54FF4BAB156C00828E85CE47447409A6B98BFE6B056C07744F892E9734740E2480CC1BDB056C09F3ABA23E5724740C8A7475938B256C0740A2E0FD7714740E57114880AB256C0AB1836AA59714740963FA35DBDB156C0CC02D5B511704740B56F2F72CBB256C027FB7B5C4C6E474010CBA86365B456C05CF278EB7E68474014ABD6867FB556C0C802669C40674740AAD7A0F4ACB656C0381F76D245664740E44B68756BB756C038D988C9EF63474084677026D3B756C004EE3FA62F614740FA63AE7FF2B756C024418B32005F4740F2578BFAAEB756C0372B2A3EB85D47402A66939531B756C09F3B17EF795C474068BD75D4E6B656C0C425B6FA315B4740021635A43DB756C06C50CECBB95947404AEDCE6F5BBB56C0F0CAA2FBCA524740B243A92973BC56C07CC52EB8445047405E2E1D412FBD56C0F7BFBA74BE4D47409699AED786BB56C060D0A725804C47409EA8BEF7A6B956C0C80E3CD5104D474008C27279FEB156C05CDB8FAC8C514740161A5D3D51B056C000E3E805525347405DDAEBFC1EAF56C0E89BC0FEC455474084ADEE1558B156C0E89BC0FEC455474084ADEE1558B156C000C0298E8F56474096E506FDC4B056C010D86F9816574740A65AD60221B056C0FC567D0D77574740D81F04FA70AF56C01FF0B5A29D574740524837B5B9AE56C08FA319588A574740A2D44440FFAF56C0DC033281A65947408C169B9670B056C0A4F529E6235A4740F2633F6621AF56C09C52B3E1F8584740BA0175A05FAA56C0A09831D17D524740AE0FDBA877A456C0B0996CCFB44D4740EAA94E3CD59F56C0382B4C0B164C4740B4BE0519159D56C0045849F2DC49474042E2999CDB9B56C0740BADA7C94947403E3D2AB5339A56C0E0EA4B38674B47406E5EC719679A56C0978A4A22C84A47407EE7FA4C129A56C0787DB1885E4847404A4094E6CD9956C0D88318EF0C47474046902E80899956C07C17E4BB85464740B761C8191B9956C0E8D9B28822464740128F61B3629856C068C37D55F74547405967FA4CD89756C04BF2AF8806464740BDFDFA4C5E9756C078AE7C5547464740EE312E803D9656C04CB77D5543474740F0ACFA4CD09556C0CCAAE5BB594747403DB161B35C9556C00FA84B2200474740610AC719B99456C0F47D4C222445474086B4C7195D9456C0C4354B2290444740EE632E801D9356C018154A223844474058EF2D80859256C0E4D6E5BBE54347403AD1FA4CEC9156C0DC49B0880643474008EBFA4C649156C0D46616EF7842474022EFFA4CA29056C0EC9F4A221C42474061ADC719059056C0CC2918EF04424740206961B35C8F56C0F4E4E3BBB94147401E4E94E6BD8E56C007B5B0881E414740F6CFFA4CE88D56C04C56B088C63F4740AC9EFA4C208D56C028E2B188363E4740FD7D94E67B8C56C060BA7E55173C47405A88FB4C628B56C0E87CE4BB75384740BEA92D80B38956C000F816EFE83247405ADD2D80A38856C050B916EF682F4740583E2E80238856C020F516EFD42C47400ACFFA4CF08756C04F077E552B2C4740BC222E80958756C09C00E4BB992B47405CC894E6C98556C0740719EFE42A4740FE27C8191D8556C0D77AB188A22A4740AB3CFB4C368356C013BDB088E6294740524061B3428056C03F8017EFC42847408A9393E66D7C56C0182FE6BB49274740EE3761B3E67756C0C880B2888A25474062C6C719D77256C040D417EF9823474058BA61B36E6D56C0C0D57D5583214740327DC719D96756C0E8D716EF5C1F474042372E80436256C067C8B188361D47407AFB60B3DA5C56C0649AB288221B4740FBFA93E6CB5756C0C00B7F552F194740A26FFA4C445356C07CCE17EF701747408A81C7196F4F56C0E81D18EFF4154740687C2E807B4C56C0A0F27C55D3144740169161B3944A56C05C944A2218144740BE6161B3E84956C03CD87D55D713474074C42E80A14756C088C87D55F7124740EF3261B34E4656C024FC7D55E7114740993561B3824256C0083CE3BBDD0E47404AA92D80B73E56C0DCABB188D60B4740ECAB2D80EB3A56C033BCB188CE0847401BE793E61F3756C09CAE4A22C80547401CB194E6953556C0389CB0888E044740CAACC619C13456C0B4977D556704474041DE61B3423456C050CD7F556F044740E2F5FA4C503356C07C894C22B0044740D48E2E80E13256C090CAAF88AE044740DC21C7196B3256C0B4977D5567044740DCDBC719F53156C01C62B188C603474062A961B34E3156C06CA5B18896034740FDD461B3C83056C0A85D7E559F03474066C9C619732F56C0C0E57C5553044740EC6B2E80F52E56C050CD7F556F044740CE4DFB4C5C2E56C0C086B288560447400E39FA4CB22D56C0471E7E5507044740024BFA4CBA2C56C004C04B224C03474090E1FA4C462B56C05407B188A6024740B29394E6172956C058B7E5BB0901474028CD94E65B2856C02BFB18EFC800474062BA93E6CD2756C0D8B2B288E20047405C5061B36A2656C0E0507D556B02474026DD2D80FF2556C08037492294024740C2612E80832556C0DF027E557F024740CAF4C6190D2556C0507B7C55530247406629C819892456C07C9FAF8846024740A20361B31A2456C0FBB5E4BB71024740FA162E804F2356C0BC3E16EF140347402C89FB4CE22256C0CB784B224403474042CC94E6632256C03FE9E4BB550347406430FB4CDE2156C024D27C553B0347403A3FFA4C382156C07452B188E6024740CC2D61B38A2056C0507B7C5553024740F099C7197B1F56C0EB8BAF882E01474091C3C719D91E56C0B0FF4B22F0004740129361B34E1E56C0B0FF4B22F0004740BE1CC819E91D56C0F8FDB28822014740309561B3701D56C0B0E5E4BB29014740C09F94E6F11C56C00477E4BBE50047409A7894E6C11A56C06C5118EF30FF464009B494E6211A56C06B7C4A2208FF4640528C2D80971956C06B7C4A2208FF4640F28094E6431856C0EFACB08892FF46404EF4C719B51756C07C194A226CFF46409C7360B3201756C05CE8B088F2FE464046D02D807F1556C0D0FF18EF18FD464096EE60B31E1556C0044F7E55E3FC46407EABFB4C081456C0476FB1889EFC46404CB12D80CB1156C0E4E0B0888EFC4640681594E6451156C00C834C2270FC4640D25294E6C11056C0D0D2E4BB29FC46400487C719A10F56C0D0B7B2883EFB4640120894E68D0E56C0B0E07D55ABFA4640816661B3020E56C0E3D57E558FFA4640B5AC60B37E0D56C010ACB28896FA46409ADCC719850C56C008924B22D0FA4640D89C94E6030C56C084DF17EFCCFA4640759261B3880B56C058A07C5587FA4640CA2AFB4CE20956C0788E4B22A4F846409A2894E6770956C0D46D4A224CF846405C82C719770856C0ECD1B088C6F746405AC0FA4CE20756C0F4417C553BF746404CA72D805F0756C09CCD18EF58F646404CF560B3B60556C0303317EF2CF14640022D2D80790556C0887116EF38F04640D511FB4C880556C010A0B08812EF464084B62E80C10556C04C83E5BB59EE4640B2E3C719030656C0535F17EFB8ED4640C6C7C719690756C02FDDB18816EB4640506094E6A50756C038B9E3BB75EA46406888C719D10756C0C8A74A22C8E94640CCBDC719D70756C0B04A7E55EBE84640DE12C819A90756C040414A2200E8464056BF94E6090756C00405E4BBCDE646407473FA4C8C0656C044F9E3BB25E64640101AC719990556C0ACEE49225CE5464092DEFA4CA40456C078B84A22CCE44640EE3861B3920356C010B017EF6CE44640E6CF94E6070356C047D44A2260E44640E8F960B3060256C0636D4A228CE446401698FA4CB40056C024687F5523E54640AB8FC719550056C0344A18EF24E54640D9CD61B30E0056C0876FB188F6E44640BC2B61B3E0FF55C04C714A22C4E44640061E61B31CFF55C054C6E3BB4DE346403653FA4CD4FE55C088BEE3BBDDE24640E8AF2E807BFE55C0F4DF7C5577E24640C0ADC71911FE55C0C800E3BB21E2464029EAC61901FD55C0CC34B188AEE146408A632E8037FA55C09CE44A2258E146404C5C61B3B6F955C03822B28822E146402ACBC6194DF955C0781F18EFC8E04640A630FA4CF4F855C0688218EF64E046409295FA4CACF855C0F0627D55EBDF4640FAE360B3ECF755C010E9E5BB55DE4640A89094E69BF755C0B49F7E55E3DD46400C7E93E613F655C0BCD14A2258DC46409AC5FA4C70F555C00862492288DB46402AC7C719A3F455C0AC3AE4BB05DA46406CD52E80C1F355C08C1D4B22B0D84640AE7994E65DF355C0AB9B18EFF0D746401233C71945F355C0341017EF8CD74640667D2D8047F355C0BC254B222CD746407EA560B372F355C06CC718EF70D646401011FB4CBCF355C09F30E5BB01D646407C2294E669F455C0600EB0882ED54640460061B392F455C044F77D557BD44640702494E685F455C0A8D6B2888AD3464094ABC71915F455C06CA717EF30D24640E8B52E80FBF255C058C5B0889ECF46401294C719C5F255C078B44A22E0CE4640FAC494E6A3F255C0A4BD4B22E8CD4640985060B3A6F255C0385CB18836CC464092252E80CFF255C09CE8AF882ECB46402938C8190FF355C01061E4BB69CA46403E23C7195FF355C07C11B18802CA46400961FA4CC4F355C033F07C55BBC946409C9861B334F455C0F880492288C946409C98C61981F455C080447E5503C946406A7D94E68FF455C09C8416EFDCC746402A53FA4CFAF355C0B049B18842C54640EFFB2D8071F355C06C097D5547C146405AD82D806DF355C0EC5EE4BB6DC046404CC061B376F355C004E617EFFCBF464000B394E69BF355C0B427E4BB51BF46404C5F61B3F6F355C0E8B6B2880ABE46403E13C71973F455C0CCAF4A22DCBC4640325B61B3B8F455C054617D5553BC4640F8FBF94C06F555C04030E4BBD9BB4640148F60B320F755C0A0277E5597B946401651C81969F755C00C264A221CB94640FE81FA4C94F755C08C0F4B2258B846404C2561B3A0F755C0B7664B224CB7464079D6C71977F755C0846F7E55B7B546407C9793E67FF755C040F6E3BBA9B446404C2561B3A0F755C0B42DE4BBD1B34640322161B362F855C07F234A2214B14640EC6A94E675F855C0F42AB2884EB046408E69C71949F855C024684B227CAF46404164FA4CE4F755C08C5DB188B2AE4640824F94E6EDF655C0FF0018EFC4AD464032F361B34EF655C0D0857F5597AD4640C2F493E6CDF555C034254B22B8AD4640A20A94E60DF555C04C2BB2885AAE46409C1494E69FF455C0F876E5BB89AE46402A28C81923F455C0ECF316EF84AE4640F41494E6ABF255C0B7297E55DFAD4640347C60B320F255C0482AB188CEAD464039572E80A3F155C0A7B8B188DEAD4640C1BA61B32EF155C02CBDE4BB05AE4640D83FFB4C7CEC55C04C6C7E5597B14640C41F2D8013EC55C06F764A22C4B146409BCDC619A1EB55C06CE2B088AEB14640DD7A2D803FEB55C0CC927D5547B146408A0494E6D9EA55C05CFE15EF94B04640D0E52D8051EA55C02FB64A2268AF4640A67BFB4CE8E955C0C0C67D5543AE4640D0462E80D1E955C0A84F4A22A0AD464002852D80D7E955C048AF7D55F3AC4640F81CC71925EA55C074FE18EF24AC46403E7394E61DEB55C0A865E3BB9DAA46407ECA60B3A6EB55C038B74A228CA94640467461B33EED55C0B83AB0885EA4464072772E8081EE55C01CEE7E55339F4640366FC719BDEE55C0CC914A22989D464016ABFA4C06EF55C05CF94A2284994640D62861B3F2EE55C098F5AF889E98464072772E8081EE55C0A4B3B088669746406EFAFA4C8AED55C0A88E17EFA09546403626FB4C0AEC55C0181A4B2274934640C86461B364EB55C0EC904B2234924640929A2D800BEB55C0A4EC7E554F914640208194E6E7EA55C0C82D18EFB4904640ED9993E6D3E955C09BA418EF748F464046C7B43D5EE655C0C82BE3CE708D4640F6ACF5CC8EE655C0D809E8799A8C4640A0F1054543E855C0143BAF8CDF8846405FD7DA247DE855C0F40A2378D18746403E877C3389E855C0E35B89EE62864640A53AE0E875E855C0B07040CBA2834640D259AA40BEE855C0B4AB454DEC80464038E1189481E955C00CA4ECF3267F4640EE5D41F3A2EA55C0080176EFFB7D4640F449929B00EC55C0609070151E7D4640BC8F4C2BBDF155C0283C7B71457B4640D4B0C81FABF455C07334221880794640A68E112D86F655C000985A551276464020B744E8CEF555C083EF6F0D61724640D6336D47F0F655C0C42C5AA5E96E46400630782776FA55C06CD7BAE908694640F071CE7DE7FA55C0D4E7A79ACA674640B5A07D0154FB55C0EBC523213F66464032E695FEA5FB55C06857035DA06446409FE2D357C5FB55C057A869D331634640859E98EB14FC55C0A01F1EEFCC6146407EEC11C7C9FC55C09C7CA7EAA1604640D2FEB01431FE55C05828B246C95E46402EC3D686E3FE55C0487918BD5A5D464088B8909241FF55C050D6A1B82F5C464072FAE6E8B2FF55C0BCB8E76A225946404CE73F16AEFF55C0ECBACC8061584640666832A14DFF55C0D0F3ECEC6B564640409E65727BFF55C074B5583DDB5546409B56685FEAFF55C0B0C360D85D55464041BB4AB4840056C0DF2EF26EB553464098734DA1F30056C038BEEC94D7524640CB5560DA4C0156C07C41C435B65146403ED82FF68D0156C0B409DFC7E24E464032A0170F210256C050EE0990144B4640B1B49B72C70256C080F0EEA5534A4640E479C969170256C0B45B803CAB4846406EDA140CCD0056C00C5427E3E546464072FAE6E8B2FF55C098FD4C29CE4546401862B6D829FE55C088E5061F474546404A0AFF8D70FC55C0B87E3FB46D454640F4F75F4009FB55C033E13CF3C84646400630782776FA55C070D8A89BCC49464084DE3CA5E0F955C050855D0FFC4B4640E868989380F855C0D80BC4DD214E46406294B8E9A5F555C06C297E2B2F514640CC041C3119F155C08787B13E0C544640B0A3FB825FF055C0EFDD8BF823554640566567D3CEEF55C08CD9C1CCA5564640A1AB8755BEEE55C0647A53BB915846403EE761E30BEE55C0A4DA6BE4AD5A46402CAF49FC9EEE55C0CCA14B78A35C4640C4FED2E18EEC55C0BF4FAA03DB6246407255E01440EA55C0DCF3CA1F0E68464002FF055B28E955C02048C0C3E6694640F606922D87E755C000F57437166C464024EC9101BDE555C048CA5C668E6D4640CA90181023E455C0273124D1676D46408CFC7EB27EE455C0005E21B82E6B4640DA05E8157FE355C0D8675F27336C4640D039694A07E155C03C83345F017046400EEED48491DF55C074FAE87A9C6E464004C5CCBD44DE55C0A442BB99317046403B7938F8CEDC55C03C32CEE86F714640902805FBD6DA55C0F4C5923A106F4640BC4ABCEDFBD855C0F045DBADA76A4640DEF7A3DAC4D755C0ACF1E509CF684640CE85C16F45D655C0DCF3CA1F0E684640EA6F607BFDD455C08C2A0676D96646401646502F13D555C0C8F2200806644640E6A92AFF0FD755C0E8970D099F5B4640A68FFFDE49D755C04B9CD7341D5A464062EF42FC61D755C0F4C6EF05A5584640FEC1700997D755C00C3CBF0B0158464065CF701F7CD855C074B5583DDB554640C0D04DB01DD955C000B0E4F9545346407201AFD02FDC55C064401A1EAE4D464014837667D3DD55C0048EF166F8484640B27289B611DF55C0C04475305B434640362A841EE3E055C0B021D885F6344640D039694A07E155C00077082806324640FA95EAC03EE155C0CC3A598EB430464062A3EAD623E255C0E0755E10FE2D464002FCA9A67AE255C0C0AE7E7C082C464014D7389212E355C04CA90A3982294640AEE61DBE36E355C0F4D3220A0A2846400A08CD2BBEE255C0A72D1DD897234640D2A215CB1FE055C05FF0C3263E1E4640C6106183BADF55C0B0DC4748351C4640ACCC25170AE055C078F1FE24751946401217DD4BDEE055C003EC8AE1EE1646403A0AB241FDE155C0D01888C8B5144640AEE61DBE36E355C070377D14FA12464070F20DCAE0E655C0F425E64B3010464045390358D4E755C0EC826F47050F4640D41CF321CFE855C00FD6BAD3D50C464048F671032CEC55C0241D74C1910146407A5E16FFA6EC55C08C7EC7E8E4FE45405B9449D0D4EC55C0C8C7D405B1FB45403CCA7CA102ED55C0D0245E0186FA4540FA46A50024EE55C04413C738BCF7454024A326775BEE55C063FD654474F64540EE5767BDE9EE55C0D0190761A8EC45407C1E7245DBEE55C08816783361E94540DE3F21B362EE55C034419004E9E74540DAB98FF040EE55C083DCADAF4EE745405B9449D0D4EC55C00834C3679DE34540A1AE74F09AEC55C0B45EDB3825E24540C4FED2E18EEC55C0D3487A44DDE04540CA47AD85C1EC55C0CBA50340B2DF454094FCEDCB4FED55C0A46954A660DE4540D153D00A05ED55C0148664DC65DD4540390734C0F1EC55C02807576705DD454094FCEDCB4FED55C0B8A45928AADB45405B9449D0D4EC55C0FF33544ECCDA4540708CBDFD75EE55C0D06BCAA2CED4454064B7776168F255C0E049D70F72CA4540C27B9DD31AF355C05B4463CCEBC745403CC1B5D06CF355C0D826A97EDEC44540B7AC316DC6F255C024D9621CC3C0454068E07F28B5F355C0ECA72CF0ACBB4540F81A1FB8CBF755C0548A0389CEAF4540E05C750E3DF855C018FC4361E3AB4540FA9DC3DF10FA55C0688BCF6D34A2454064512795FDF955C03472DF4BA59D45405C450410BAF955C0E09CF71C2D9C4540D8F3C88D24F955C070A3A65EEA99454082787DBFA4F855C04C3950C6C9964540ACD4FE35DCF855C09C25D4E7C094454050B34FC854F955C03738A6AEC1924540C2351FE495F955C0D4B324F6DA8F45409616558C4DF955C03BC411A79C8E4540243AE90F14F855C048A28D2D118D4540F81A1FB8CBF755C078A47243508C454064541430DAF755C0485CA024BB8A45402277A02E03F855C06F5262B5B6894540B929FC5E52F955C040397293278545409FE5C0F2A1F955C0D03F21D5E48245406E7D1CF726F955C0BC8464C632814540E4886A7066F755C034AD97817B80454059E231C55AF655C06C75B213A87D4540DA533F24D6F555C078A49410AE7A45406294B8E9A5F555C0345C53D8477045407E9B3C3767F555C00C20A43EF66E4540249A5FA6C5F455C010F2FC3F276D4540A40E5AA01DF255C0AC278E7EEA674540D4103FB65CF155C0E4EFA810176545403CC4A26B49F155C0D8A9BB07C162454050627A38F2F155C04869D328205A4540383B240E4BF355C0941B8DC60456454026030C27DEF355C040AF5118A553454052D9FBDAF3F355C000E68C6E70524540E2624F44F6F355C0940482BAB45045409679B8BDDBF355C0D46F13510C4F4540A474198659F355C0AC9C1038D34C454084E7037676F355C0E813C5536E4B4540FD69D391B7F355C0208B796F094A454026030C27DEF355C08C9B6620CB4845401A3C61C178F355C07843C24CF33E45407F46FB4C9CFE55C08C3117EF1C3F45408CDCF94CF40956C01F18E3BB453F4540FAEF2D804B1556C01B7CE4BB6D3F45406A742E80A32056C00F51B288963F45405F3195E6FB2B56C0B0377E55BF3F45406EC793E6533756C0331E4A22E83F454062132E80AB4256C034F317EF10404540D2972E80034E56C0C8D9E3BB3940454016252E805B5956C0D41F7E556340454054B22D80B36456C0D86518EF8C4045404C6F94E60B7056C0684CE4BBB54045408AFC93E6637B56C0F832B088DE404540008194E6BB8656C0EC077E5507414540BCD52D80139256C0EC6B7F552F414540742AC7196B9D56C080524B2258414540EAAEC719C3A856C01CAAE3BB81414540D6132D80C7A856C01CAAE3BB814145402AD860B3CCA856C01CAAE3BB81414540C0FB60B3D0A856C01CAAE3BB814145409C872E80D5A856C01CAAE3BB8141454082EC93E6D9A856C01CAAE3BB814145409E48FA4CDEA856C01CAAE3BB81414540F29B61B3E2A856C01CAAE3BB81414540DD00C719E7A856C01CAAE3BB81414540AC8C94E6EBA856C01CAAE3BB81414540CFE8FA4CF0A856C01CAAE3BB814145403415FA4CF4A856C01CAAE3BB8141454008A1C719F9A856C01CAAE3BB81414540A63594E6FDA856C01CAAE3BB81414540425994E601A956C01CAAE3BB81414540DD7C94E605A956C01CAAE3BB814145407C1161B30AA956C01CAAE3BB814145407869FB4C3CA856C0336118EF3C4445403E3561B314A856C0AC3BE4BBB1454540EDE2FA4C9CA856C0D37C4B22A8474540A2F160B338AA56C088EFE3BB4D4B4540848DFA4CBEAA56C0809A4A22C44C4540166DC719FDAB56C0B78D4A22F8514540561394E6FDAC56C0A804E3BBE1534540D4C02D807FAE56C0E87417EFA05445409B3E60B300B056C033A716EFF8544540025CC719EDB256C0E8914B22A456454096B7FA4CDCBD56C068F1B188CE594540C46A94E6ABC056C0BCD37D55B35B45405EE0FA4C1CC256C050E87E55575D454046A6C719E9C256C0F4DE18EFFC5E4540218361B316C556C0786D492260654540EE7AFA4C52C556C0D0B017EFC0674540A840FB4C84C556C0F018E4BB2D6D45406E0461B3E6C556C0E4BBAF887A6F4540063A2D8087C656C00CB77C5547714540560B2E805BC856C05456B188A674454060B193E60DC956C0D4E8E4BBD1764540E3FB60B35EC956C028F8E4BBA5794540B4272D8073C956C0D86D4A22887F454094DD2D80BFC956C02884E4BBF9804540DE2994E6DDC956C04C164A2288824540087194E6E5C956C043027D553B874540806661B364CA56C04427E4BB918B45407DC8C719BDCA56C0E8C7E4BB8994454052BDFA4C04CA56C0508C17EF009945400DD7C7199FC656C0103417EFE89F454022DCC6196DC556C00C4BB288DAA3454046D5C71989C556C008B97C559FA84540B049C8191BC756C04C09B18886AB4540E5452E809DCC56C0B05B4C22D8AE45407EF7C7195DCD56C013417C55BBAF45406DB42E80DBCD56C0DF10492214B145408AC0FA4C24CE56C07F614B2298B44540E811C71959CE56C0D85418EFF4B5454074CD60B3AACE56C0A4547D553BB745406AB6FA4C8CCF56C080BF4B22D8B945407CAAFA4CDECF56C004FA18EF3CBB4540784094E60FD056C0449EAF88BABC45409E66C7191FD056C020B97C5553BE4540C6C02D8007D056C01BAA7D55F3BF4540A2F3FA4C02D056C038437D551FC04540405C94E6A3CF56C09C7AB0881EC345409CA4FA4C8ACF56C084184C22BCC445409CC7C7199FCF56C0004A7D556BC645409CEAF94C00D056C0642B4C22BCC945406A55FA4C0CD056C0EC6E7F556FCB45406E1661B3C8CF56C0F8787E5573CF45405884C719CFCF56C0B8484B22CCD04540B48EFA4C4AD056C0ABCFB18832D44540988293E64DD056C0E888492260D54540068AFB4C88CF56C0809B492254DC45409CA4FA4C8ACF56C080677F55BFDE4540DE9960B3BACF56C0E0CCE3BB41E1454046D6C619F3CF56C0FC3216EF6CE2454060ED93E659D056C0A8E8B18866E3454008FD93E639D156C09C4519EFF0E44540055FFA4C92D156C0F05AB288D6E54540AE532D80D3D156C0109E17EFECE6454044EAF94CF4D156C01C70B08802E8454004E42D80FFD156C048A7B0881EE94540420661B3D6D156C028134A22E0EC454012E22D80E3D156C0A4FDE3BBD1EF4540087AC71931D256C0C0ECB088EAF245403C212E8075D256C01CE5E3BB5DF445407C052E80E1D256C0D32017EFA0F5454020B5C71985D356C0C8FF4B22A4F64540DE5661B35ED456C0F0AA17EF6CF745401858FA4C1AD756C0B0314B22F0F84540A02F60B39AD756C09C517E559FFA4540E42D2E8015D956C01402E3BB61FD45405CCAFA4C8AD956C010C8B1882AFF45401EDEFA4CA8D956C0640018EF240046407565FA4CD2D956C0D4C817EFFC00464016F261B314DA56C01445B188B601464054CD60B37EDA56C010577D5553024640C20AC81943DB56C027ABE3BBE1024640B87760B39ADD56C05479B28826034640771094E625DE56C074A64B2268034640D4A9FA4CA0DE56C07761B288CA034640127FC71941E256C06F327D552B08464074162E809FE256C0D477E4BB65084640481B2E80CFE856C0709BE4BB69084640AFA894E69BE956C09FEB4A22C00846401D36FB4C68EA56C0382117EF600946401DE5C719D1F156C0F4EFB18826134640ACF12D804BF456C0535DB188D214464097952E808FF556C0CC04B08846174640A2D6C61961FA56C0747919EFFC244640C8F561B3CEFC56C058B816EFF82A46408E23C719910657C0CC1B16EFEC3746406EA7C719FD0957C0B893E5BBC9394640C66AC719731157C0B8C94922A03B4640511E61B34E1257C0A09AB2883E3C4640447161B3FE1257C024BA17EF503D464036F894E6871357C054FA7D55BB3E4640F1D0C7192F1557C0F355B2883E4446406566FA4C061757C020A14A22A8474640BC0A2E80331957C0EFE84B22304A464053A2C719751B57C09BA1B0886E4B46401C6FC7196B2557C00438E4BBD14D464010F9C719312857C04FBBAF88525046402794C719792857C05C96E4BB1D514640A664C719C72857C0B4B4E3BB51524640EC6994E62B2957C05039B0886A534640884761B34E2A57C06C8E17EF84544640E282FB4CCE2E57C0801516EF145B4640C4ECF94CC03257C068647F55CB5E4640124B2E80773457C0409118EF006146407EF82D80D33157C0F42818EFFC6846407E7CFB4C683157C0ECDEB088726C4640000561B3703157C070EE4B22006E4640208DFA4CD83157C0487416EF20724640C23B2E80A33157C0A0EAB18882734640B5F62D80BD3057C0CCFFAF88AE75464056A561B3883057C0746FB1887E764640F678C719D13057C09406B088FA7B46407E7CFB4C683157C0CCF14A226C814640B0A0FA4CF03257C0F4627D552787464066DBC7195B3357C044727D55FB894640FF9B60B37A3257C07CC0E5BB318B4640422594E62B3157C08772B088DE8B4640E2B8FA4C583057C004D9B088A68D4640909260B3FA2F57C050DF4A222C904640874461B30E3057C087ACB0880E93464034B4C7192B3157C0D06617EF589746405BC994E6753157C0907217EF009846405A4DC719573157C04F887E5583994640AA1BFB4CEE3057C03CE6B088329C464038A260B3DA3057C0783AB388E2A146400A75C719993057C000124A2244A44640874461B30E3057C00CC317EF5CA646401A942D802D2F57C0403716EFECA7464052B5FA4C2C2E57C0F8D24A2220A94640BAE093E6572D57C0EFEE7D5597AA4640BC7E2D80FF2C57C010687D55EBAC4640AE1761B3902C57C044E7E3BBE1AF46402C0861B3B62A57C01C774B2244B44640116D61B36E2A57C0148BE3BB91B646400E05FB4CBC2A57C0DC3E4B2204B94640FE3D94E6A52B57C088DE492208BB4640F85061B3CE2C57C030697D55C3BC464064E72D80E92D57C09014B288D6BE4640889294E6652E57C03762B188B6C0464054C8C719552F57C0A8814922A0C54640874461B30E3057C040107D5593C74640CE772D80873257C07C21B188EEC8464016D1C719BD3557C034D54A22D0C84640281FFA4C863857C03091B288BEC94640CCCF94E6B53957C0EFEF4A2240CE4640C0D093E6453957C0AB9B18EFF0D74640EC672E80093957C0A06916EF14DA46406564FA4C723857C094D87F55A3DB46403E8060B3E63257C07097B1883EE3464079C394E6213157C0086E4B220CE746407E7CFB4C683157C0AC92E4BBC5EA4640640B61B3D62E57C018CFB088B2F146409F4594E60F2D57C028E14A22E0F446405A58C7190D2B57C0488D17EF34F64640D29BC719E32957C0149517EFA4F6464040122E80712657C0E8CB17EFB4F94640CC0994E6C92457C0EBF74A2218FA46405253FB4C422457C08FB84A2280FA4640E4EAC619F32357C094B94B220CFB46403DC860B3322357C094DEE4BBD1FC464092EFF94C202357C088287F5533FD46406A3C2E80E12257C0E4FBE2BB79FD46400234FB4C822257C0C0497D5513FE46408A3E2E80032257C09B9717EFACFE46409E05FA4C662157C0CC477F55F3FE4640BA7194E6C11E57C0CC477F55F3FE464012B093E6CD1D57C010B216EFA8FF46409A25C719611C57C0D892B2880A0347403E4661B3701B57C04C6418EF300447406200C7194D1A57C0A03BB28816044740362AC719B11857C07C874A22980347402AEDC619411757C040BEB2887E0347405AC9FA4CA21657C0D0D1B28896044740C0EC93E6571657C0BB91E4BB55064740A25B94E6A11557C0E74B7D550F084740AA7BFB4CC21457C0148CE3BB790947401A7161B3F81357C074017E554F0A4740D0612D80B91257C050E6B088AA0A4740D0612D80B91257C014BFB188E20E4740C2F060B3B81257C0BC9BE4BBC1104740FADE60B3B61257C0CC61E3BBDD1847406C352E80B51257C044A517EFF82047406B2C2D80B31257C0606B16EF14294740D6112E80B11257C03C0E19EF3031474007002E80AF1257C058D417EF4C394740C02694E6AD1257C0D38818EF684147407A4DFA4CAC1257C0EC4E17EF84494740DE32FB4CAA1257C0E7327D559F514740A4CA2D80A91257C01C7E4B2270544740AAFE60B3821257C068D317EFDC544740488AC719391257C0F8D34A22CC544740CA9EFA4C4C1157C06443E3BB51544740902C61B3241057C07C62B0882E544740C82A61B30E0F57C0A7EAE4BB495447407C2D94E61F0E57C064ED7E55A35447408B45FB4CCA0D57C0F8A818EFF45447400A1EFB4C8E0D57C000B7E4BB59554740BA57C7196D0D57C03C074B22B0554740F079FA4C440D57C0603D4A2240564740EC7094E6F50C57C080E37D5583594740403F2D80D90C57C017EE17EF4C5A4740FE7FFA4C9E0C57C0E8DBB088F65A4740D04960B35A0C57C034D718EF7C5B4740A673C719070C57C0F379B188E65B4740FE0BC819A90B57C083127E55235C47403ED494E69D0A57C08CAF7D55875C474016F5FA4C480A57C0AC1D4B22DC5C47401A0F62B30E0A57C06C547D555B5D47405A762E80830957C0DC0418EF845F47401A6660B3000957C06FB816EFAC604740AFF260B3FA0757C0E007E5BBC1614740E64DE6ED1D0757C0F48AACA55562474060EC0B3DAD0657C01C7B55B612614740C676672B4D0557C0C80E1A08B35E474002688A84C60357C018FB9D29AA5C4740B824579DB30257C0648A984FCC5B4740042EC000B40157C0F0BEEE8F585B47405AA3C27FA9FD56C044141F32685847406B813E061EFC56C05CA134424B5847402A56E20FC1F256C060DBFEC55D5A4740721CDCEB76E456C0EC7870A0D3614740C474F92863DF56C00CA9FCB4E1624740D0B2EB4589DA56C098BA937DAB6547402842E66BABD956C0C0B0550EA76447404CFEDD7894D656C064FE9B70C268474036A3970094D156C008CBEF473E6D47401076F88662CE56C08C7FFD1433714740FE34AAB58ECC56C0740A2E0FD7714740A013FB4707CD56C0F7F896460D6F4740EAA2F56D29CC56C027FB7B5C4C6E4740E4F35BE4BACA56C0401FE5EB166F474092674E5975C956C08373DA8FEF704740FEDDFAEF72C956C0745B9485687047406B915EA55FC956C0A875BFA52E704740487EB7D25AC956C064434E7BE16F474092674E5975C956C087453391206F474066EEE7A034C856C0D8C80A32FF6D474006A4306C60C756C01C86AC56F06E4740289AF2FC5BC656C0740A2E0FD7714740C95B5E4DCBC556C0F4D5D7CE4A724740953071703FC556C0FCE1FA538E72474043A463E5F9C356C0982E979EA1724740A002CA7170C356C0E86008C9EE7247402E43433740C356C06F38D50DA6734740DE59ACB025C356C018A9DAE783744740B23AE258DDC256C040CD43774E7547409CD9C1AA23C256C0A017FBAB227647403CDBD1B45EBF56C09045A2AAF1774740C85802991DBF56C0349E617A487847402CC38BAAD7BE56C08CDCF529D97847401731D76272BE56C09CF43B34607947404EB94D3BD3BD56C05CDA10149A794740F8004B4E64BD56C0846726247D7947408E3002576EBC56C01C299274EC784740E78E68E3E4BB56C044B6A784CF784740712C6BA489BA56C0634FE019F6784740C804406EDEB956C07B5B039F39794740FE8CB6463FB956C05CDA10149A7947408BCD2F0C0FB956C06CF2561E217A4740150EA9D1DEB856C0B4AFF842127B4740787832E398B856C0B0464CC2F97B474000AD882325B856C0DBEBA7DC637C4740F683805CD8B656C0642C21A2337C4740C258937F4CB656C020FAAF77E67B47403E0758FDB6B556C0942E06B8727B4740CA0A1AA497B556C08416C0ADEB7A47405BD1242C89B556C0947F6C2E047A4740584B936967B556C02435B5F92F7947400103000000010000000E00000096457D9376AD56C0C0B0334149764740524837B5B9AE56C040CD43774E754740D65CBB1860AF56C0D3BC56C68C76474084ADEE1558B156C044B6A784CF7847402EF5EB28E9B056C0A3005FB9A3794740909C2C5992B056C0BC24C8486E7A4740647D62014AB056C0BCBB1BC8557B4740E9FA92E508B056C0DBEBA7DC637C47404396B0906EAF56C03887C587C97B47406806E15E48AE56C06889AA9D087B47400C4EDE71D9AD56C0A497B2388B7A474016B78AF2F1AC56C054379A0F6F7847403644A002D5AC56C07821391B2777474096457D9376AD56C0C0B033414976474001030000000100000009000000535FB1DADABC56C0C05E92CC807C47402E2C382BF0BD56C0CCD361D2DC7B474030491D6DF9BE56C00010116C2E7D474052997B5EEDBE56C04CD9D515637E4740144586BA14BD56C0B4C6034F62804740FEE3650C5BBC56C04CB6169EA0814740DA396BBA6EBB56C0ECD40BEAE47F4740C63E0AF2F0BB56C08BF30036297E4740535FB1DADABC56C0C05E92CC807C47400103000000010000000C00000084BF0D9EB29B56C02B352413018247402B210358709E56C0CC53195F45804740482887A5319E56C010EEFB0B74844740782A6CBB709D56C09096E653258847409051C2E5179C56C050B685B7718A4740B8EDE7151B9A56C050B685B7718A4740B8EDE7151B9A56C05C2B55BDCD8947400AD77E9C359A56C07CAC47486D894740C0F90A9B5E9A56C0D453887816894740A22F3E6C8C9A56C05488DEB8A2884740E08620AB419A56C0E454C3764D84474084BF0D9EB29B56C02B35241301824740,-22.3%,-119,415,23,392,Wisconsin,true
6,0106000020E610000001000000010300000001000000AA00000085FF94E6478359C0A0CA7D5503004440A202FB4C428359C060C9B08802F443403DCDFA4C3C8359C0A0987E5503E84340DA97FA4C368359C070087E5503DC43402F9261B3308359C03007B18802D043404424FB4C2A8359C00077B08802C44340E0EEFA4C248359C01F64E5BB01B84340842AC7191F8359C0EFD3E4BB01AC4340A0BC60B3188359C0AF614B2200A04340B54EFA4C128359C074D14A22009443400A4961B30C8359C03F414A2200884340A61361B3068359C0642E7F55FF7B434041DE60B3008359C0440F4B22007043405E70FA4CFA8259C0F49CB188FE634340FA3AFA4CF48259C0C40CB188FE574340483561B3EE8259C0F46AB288FE4B43405DC7FA4CE88259C0C469E5BBFD3F4340795994E6E18259C0846818EFFC334340461B95E6DB8259C044674B22FC274340EA5661B3D68259C0833619EFFC1B434006E9FA4CD08259C0D4D57D55FB0F43401B7B94E6C98259C0A4457D55FB034340B74594E6C38259C068B57C55FBF74240D348FA4CBE8259C014734C22FCEB4240F0DA93E6B78259C06312B188FADF424035642E80B18259C038F37C55FBD342405A6794E6AB8259C004637C55FBC742407D6AFA4CA68259C038C17D55FBBB424092FC93E69F8259C004317D55FBAF424028C793E6998259C0C82FB088FAA342403AF161B3948259C0882EE3BBF99742405083FB4C8E8259C0C48CE4BBF98B4240ED4DFB4C888259C088FCE3BBF97F424081EA2D80B78859C088FCE3BBF97F42407BC72D809F9059C088FCE3BBF97F4240EC6BC719879859C088FCE3BBF97F4240970762B36EA059C088FCE3BBF97F424059ED60B356A859C088FCE3BBF97F4240CC91FA4C3EB059C088FCE3BBF97F42403D3694E625B859C088FCE3BBF97F424030A2C7190DC059C088FCE3BBF97F424007E160B324CC59C088FCE3BBF97F42401517FB4C3CD859C088FCE3BBF97F42402C262D8053E459C088FCE3BBF97F42403A5CC7196BF059C088FCE3BBF97F4240C259FB4C82FC59C088FCE3BBF97F4240E5682D8099085AC088FCE3BBF97F42406D6661B3B0145AC088FCE3BBF97F4240FBD461B3C8205AC088FCE3BBF97F4240DA84C719E12C5AC088FCE3BBF97F4240A95294E6F7385AC088FCE3BBF97F4240B7882E800F455AC088FCE3BBF97F4240D59760B326515AC088FCE3BBF97F42405C9594E63D5D5AC088FCE3BBF97F4240B29BC71955695AC088FCE3BBF97F424001A2FA4C6C755AC088FCE3BBF97F42409010FB4C84815AC088FCE3BBF97F4240257FFB4C9C8D5AC088FCE3BBF97F4240438E2D80B3995AC088FCE3BBF97F424051C4C719CBA55AC088FCE3BBF97F4240A1CAFA4CE2B15AC088FCE3BBF97F4240F7D02D80F9BD5AC088FCE3BBF97F42404CD760B310CA5AC088FCE3BBF97F4240540DFB4C28D65AC088FCE3BBF97F4240B284FA4C40E25AC088FCE3BBF97F4240C0BA94E657EE5AC088FCE3BBF97F424096F92D806FFA5AC088FCE3BBF97F4240E6FF60B386065BC088FCE3BBF97F42403B0694E69D125BC088FCE3BBF97F4240C103C819B51E5BC088FCE3BBF97F4240994261B3CC2A5BC088FCE3BBF97F4240EF4894E6E3365BC088FCE3BBF97F42407DB794E6FB425BC088FCE3BBF97F4240FD7E2E80FB425BC0280217EFF88F4240FD7E2E80FB425BC0C8074A22F89F4240FD7E2E80FB425BC0787E4922F8AF4240FD7E2E80FB425BC098C5E3BBF9BF4240FD7E2E80FB425BC054ADAF88FACF4240FD7E2E80FB425BC0E84116EFF8DF4240FD7E2E80FB425BC00818E4BBF9EF4240FD7E2E80FB425BC0B48EE3BBF9FF4240FD7E2E80FB425BC05805E3BBF90F4340FD7E2E80FB425BC068F917EFF81F4340FD7E2E80FB425BC008FF4A22F82F4340BD1661B3FA425BC0C457E3BBF93F43407DAE93E6F9425BC0D72DB188FA4F43407DAE93E6F9425BC084A4B088FA5F43407DAE93E6F9425BC0341BB088FA6F43407DAE93E6F9425BC0D420E3BBF97F43407DAE93E6F9425BC0E485E4BBF98F43407DAE93E6F9425BC088FCE3BBF99F43407DAE93E6F9425BC0280217EFF8AF4340753DC719F9425BC0E3E9E2BBF9BF4340753DC719F9425BC0F34EE4BBF9CF4340753DC719F9425BC098C5E3BBF9DF4340753DC719F9425BC054ADAF88FAEF4340753DC719F9425BC06412B188FAFF4340753DC719F9425BC00418E4BBF90F4440753DC719F9425BC0A81D17EFF81F4440753DC719F9425BC05705E3BBF92F4440E89394E6F7425BC074DBB088FA3F4440A82BC719F7425BC024C37C55FB4F4440A82BC719F7425BC0C4C8AF88FA5F4440A82BC719F7425BC068CEE2BBF96F4440A82BC719F7425BC084A4B088FA7F4440CA5961B3EA385BC084A4B088FA7F4440AD1F2E80DD2E5BC084A4B088FA7F44409C56C719D1245BC084A4B088FA7F4440BF8461B3C41A5BC084A4B088FA7F444030F460B3B8105BC084A4B088FA7F444019BA2D80AB065BC084A4B088FA7F444082B860B39EFC5AC084A4B088FA7F44401DAE94E691F25AC084A4B088FA7F444087ACC71985E85AC084A4B088FA7F4440EFAAFA4C78DE5AC084A4B088FA7F44405AA92D806BD45AC084A4B088FA7F444081D7C7195FCA5AC084A4B088FA7F4440ED46C71953C05AC084A4B088FA7F4440D50C94E645B65AC084A4B088FA7F44403F0BC71939AC5AC084A4B088FA7F4440A709FA4C2CA25AC084A4B088FA7F444049FF2D801F985AC084A4B088FA7F4440ADFD60B3128E5AC084A4B088FA7F444016FC93E605845AC084A4B088FA7F444007332D80F9795AC084A4B088FA7F4440AF992D80ED6F5AC084A4B088FA7F4440925FFA4CE0655AC084A4B088FA7F4440FA5D2D80D35B5AC084A4B088FA7F4440655C60B3C6515AC084A4B088FA7F4440065294E6B9475AC084A4B088FA7F4440F0882D80AD3D5AC084A4B088FA7F4440CAE62E80A1335AC084A4B088FA7F44403AE561B394295AC084A4B088FA7F4440E5B32D80871F5AC084A4B088FA7F44404DB260B37A155AC084A4B088FA7F4440B8B093E66D0B5AC084A4B088FA7F4440E736FB4C70035AC084A4B088FA7F44404076C719C3F959C084A4B088FA7F4440B47E2D8025F259C068514B22F87F444095DD60B386EA59C0F8F17C55F77F4440AC3395E6E7E259C0F8F17C55F77F44405C0C94E649DB59C0F8F17C55F77F4440C8A32D80ABD359C0F8F17C55F77F44402F3BC7190DCC59C0F8F17C55F77F4440C8C961B36EC459C0E880B088F67F444036D2C719D1BC59C0D89E17EFF47F4440640194E631B559C0D89E17EFF47F44404BD193E693AD59C0D89E17EFF47F4440EA5F2E80F5A559C0D89E17EFF47F4440D02F2E80579E59C0D89E17EFF47F444038C7C719B99659C0CCBC7E55F37F44406E6760B31A8F59C0BC4BB288F27F444006F6FA4C7C8759C0BC4BB288F27F4440BEB761B3508359C0BC4BB288F27F4440F8162E804F8359C07C724B22F477444077DEC7194F8359C0382818EFF46F444077DEC7194F8359C0F8BF7D55F7674440EFA561B34E8359C09793B188F65F4440B13D94E64D8359C047497E55F7574440B13D94E64D8359C0077017EFF84F444078D5C6194D8359C0C796B088FA474440F19C60B34C8359C0774C7D55FB3F44407064FA4C4C8359C0A46118EFFC37444062F32D804B8359C053A618EFFC2F4440D949FB4C4A8359C0035CE5BBFD274440D949FB4C4A8359C0B311B288FE1F444094E12D80498359C080384B22001844408C7061B3488359C0305FE4BB011044408C7061B3488359C0F014B1880208444085FF94E6478359C0A0CA7D5503004440,24.3%,231,"1,181",275,906,Colorado,true
4,0106000020E610000001000000010300000001000000590100006E672D80536E56C0846F4A221000424098602E806F6E56C0845418EF24FF41406E772D803F6D56C0CCFBB088DEFB4140B84EFB4C906B56C033F2492210F94140B4D3C719B56A56C0D410B18826F5414042022E80236B56C01851E4BBB9F24140644C94E61F6C56C064A6B08826F34140926A2E80016E56C094A7E4BB95F54140A6BFFA4C686F56C01CE0E5BB49F5414036D5FA4C9C7056C090007E5557F441400A85FB4C8E7156C0889EB088B6F24140D9A8C7192D7256C010A9B28856F04140FC6A2D807F7056C02CA3B08806EF4140DC9B2E80C96E56C0BCA97C5507ED4140F22CC719376E56C0009CB088AEEA4140BE6F2E803D7256C0A7ECE3BB39E541406E0BFA4C067C56C080D44A2240DE4140F41794E6EB7C56C0CCCCE5BB89DC4140DEDEFA4CFC7C56C0045F18EF40DA4140A873C719077C56C0DCCDAF8846D7414008B160B33A7A56C0A856E4BB79D341409DD460B33E7A56C0487818EFCCD14140422CFB4C647B56C0ACC617EFC4CF4140817BC719777C56C043CEE4BB51CE4140392761B3E27C56C00C034B2220CD4140E02C95E69B7C56C068404922A0CB41402E30FB4C9C7B56C0F4BB17EF40C941405BA3C719BF7A56C0C80819EF24C64140DE4FFB4C687B56C06C1DB1888AC441406C1561B3E07C56C0000C18EFDCC34140D6FA2D80737E56C0EC9D4A2288C34140E4AAFA4C008056C0B821B188CEC2414076B594E6C98056C0232818EF7CC141401DFAC619138156C0A8777D5553BF4140961A61B31C8156C094D1492210BC4140EA6D2D806D8156C04C7AB188F2B94140EEC593E6338256C0B0B7E5BBD9B741404807FB4C308356C03410B188FEB54140E2A860B3988656C02CE2E3BB59B14140ACA1FA4C608756C0676CB1884EAF4140447E61B3AA8756C0149AE5BB55AC4140B6A860B3928756C0C42FB2887EA64140887BC719518756C0042A4B22E8A3414019A861B30E8656C0842917EF909D4140B45794E6698556C0202C4B2230984140FCFAFA4C768556C0F4A917EFFC92414023A7C719CB8656C0F4084A22D08F4140120C94E6178856C04BBA17EFF48F4140EA63FA4CD88956C000074C22B0904140DCB760B3608B56C0B85AE4BBA190414054F3C719098C56C064CE7C556B8E4140CA7D2D802D8C56C0244BB188EA8B41407AB8FA4C988C56C05C00B188B6894140A66AC719478D56C06C064A22C8874140C2EA60B3388E56C02CECAF881E8641407E012E80939056C000C5AF88EE83414052F92D80179256C00C0A7F55F3824140FA6193E64D9356C05C497F558B824140C14061B3029456C0D06917EF988141403A10FB4C789356C08090B1880280414046EB2D80479356C05BE9E5BB717F4140561294E6519156C0281FE4BB8D7B4140105CC719659156C0C0BCB088267641407C9294E68B9356C05B0FE6BBC971414079E4C6198D9656C0C0BBE4BB996E4140E839FB4CB09D56C06422E4BBF969414081E293E66D9E56C0B0BA7D55536841406E5095E6279E56C0584C7D551B6641404AAD93E66D9D56C0385EB1888E634140F0DFF94C1A9D56C0EBBB18EF30614140DE2A95E6079E56C09CADE3BB815F4140204C2E809B9E56C0C8D5B188665E4140909260B3FA9F56C0E882B188B65D4140D4372E806BA156C0A01CE4BBD15D4140FA702E80A3A256C0782E4B221C5F4140A9CE2D806FA356C004A34922B85E4140D86F94E659A456C028CD4B22245C41407B6E2E8075A556C078504C22A4574140D2B094E601A656C0046B4A2238524140F66AFA4CDEA456C0649F17EF68494140BEF0C71989A556C044874B22983E4140CB1195E681A556C0A41B17EF283A4140188A2E8003A656C0D4204A22683641403E3561B314A856C0D8907D55B33241407299FA4C6CAA56C00487B188923041406FB52D80E3AB56C0144E18EFA82F4140B88794E68FAE56C027B27E55232F414066CBC71949AF56C0DFDAE4BB3D2F41404A6761B3CEAF56C0F87C4A22B82F41406A1B2E8099B056C094FCB088BA304140D20094E6E3B056C028CDB0880E304140AE8360B3E6B056C0A4A8E5BBE52E4140960B2E80B3B056C0E0FAE4BB152D41401CF393E61FB056C06C7016EFAC2A4140007460B306B056C07014E6BB15294140663FFA4C3EB056C0C82F18EF0C284140E9DAC71923B156C044B74B22A82541402C4AFB4C56B156C050C34B225C2441408544C7199DB156C054E0B188CE234140D6A9FA4C3EB256C0CBF5AF88062441400E38FB4C48B356C0285A7F55CB244140CAD994E621B456C0AC89E4BBC9244140D2C693E68DB456C037B5492290244140A491FA4CD6B456C0B8BCB188CA234140E15CFB4C50B756C0F4A87D55671A41403A4FC71921B856C0108FB1885A19414088E02D8025B956C0EBA6B188B618414002CFC7194FBC56C0D8007E5573154140B2D5C6192DBD56C038134A221C1441403E6E2E801DBD56C0A40519EF7C104140B8E993E679B856C064AB7D55BB0C41404CC7F94C54B856C0E8974A22CC0741401E8A60B326B956C0BB4D7D5587054140501861B330BA56C03CCE16EF840441407D8CFA4C74BB56C028F4E2BB45044140F6C8C719F5BC56C0A8474C224C04414023622E8069BE56C014F818EFE4034140EC4FD91E28C156C0F3993110850141404011C819FBC156C0235CB188CE004140038961B36AC556C034797C5593FF40404651FA4CF4C556C040CF16EFA8FE404024952D80B3C556C0A8094C22E4FC404030A42E800FC556C02C4DB18806FC40407A7361B336C456C077D54A2274FB4040848AC71955C356C0E09B7E559BFA40403D112D8047C256C03C7BE5BB19F740404AAF2D8037C356C0A04AB188FEF34040627761B36EC456C06C7D4B221CF1404096302D8007C456C0082F4B22BCEC40405A43C7194DC356C06C89AF88AEEA40403E35FB4CE8C256C010B8E4BB41E840409030C819BBC356C018D7E3BB8DE5404004E960B35EC456C08464E3BB11E54040EA6194E617C656C02C36E4BBF1E440406B2894E6D3C656C07038B088AEE4404076B42D8073C756C064FEB088E6E340403AF5C619CDC856C04437B288A6E1404078E2C7193BC956C04C597E552FE14040EAF160B3CCC956C0D04F4A2244E04040E23CC8194FCC56C0DC36E3BBA1DA4040786A94E679CD56C0A885B08836D9404094432E8075CE56C0381DB2884ED84040797D61B3A2CE56C0A857B18822D740401C8C94E661CD56C08CA17D55F3D44040F88660B3BACA56C0FC2CB188C6D240404643C819B5C956C074E97D5513D14040B4272D8073C956C0C8B3E3BBE1CD40404A4C2E8003CA56C0E7C67D5533CB4040AE712E801DCB56C09F674A22ECC940409C52C81989CC56C0286B7C5587C94040802C61B30ECE56C0E053E5BB81C9404008ACC71911CF56C03803B1888EC8404076402D80C7CE56C01CFF7D5573C640401A11C819CFCD56C0F0FA4A2258C44040E011FB4CC4CC56C0A8B67F5563C340401D0EFB4C92CB56C0046A4B22A8C2404072C9C6194DCA56C0D00E7D55EBC0404068072E8023C856C09CD8E5BB31BD40407E40C71913C856C034657F55E3BA40405F1A94E603C856C030A549222CB74040064EFB4C3CC856C03404B28866B340403E0F2E8093C856C0E791B188F6B04040BA162E80F7CA56C0D85118EFB4AB404076722D80A7CB56C098D6B188F6A84040E2FDC719C3CA56C0F8B7492278A64040A06061B310CA56C080A24B2240A640400EEAF94C14C856C0AB30E3BB05A5404042D793E639C756C08C59E4BBD9A340400A1661B3E2C656C06C26492248A240406B2894E6D3C656C0145C4A22E89B404006BEFA4C1CC656C0E87717EFA4974040FE8061B3F4C556C0104B7E556F95404098C793E659C656C0F000B1882A934040FA332D802DC756C07438B18852924040A8922D8085C856C0C09D7D55AB9140407F4B94E6C5C956C07CF9B088C690404056C660B352CA56C0A8F0E5BB318F40403E3D2D80A7CA56C020DEE4BBD5814040CA49C7198DCB56C020BB17EFC0814040DE8561B3FED656C004E5E3BBB9814040C0CAFA4C70E256C0585017EFB4814040DA0695E6E1ED56C02CAA4C22B0814040061CC71953F956C010B6B188AA814040205861B3C40457C07421E5BBA5814040826494E6351057C0582D4A22A081404066A92D80A71B57C0904518EF98814040C2B560B3182757C090C249229481404054B994E6893257C0D8BCB0888E8140403EFE2D80FB3D57C038B717EF888140402243C7196D4957C010E1E3BB81814040367F61B3DE5457C0C83A19EF7C814040988B94E64F6057C0C8B74A2278814040C2A0C619C16B57C01C41E5BB71814040DBDC60B3327757C000DC7D556B81404070E094E6A38257C05F47B18866814040C8B593E6B98257C0D0B2E3BBAD9040408808C819CF8257C0C80C18EFF49F404018D5C719E58257C0B4664C223CAF4040A7A1C719FB8257C020D27E5583BE4040B6DC60B3068357C014BAE4BBD5C64040B6DC60B3068357C04012B088EEC6404030BFC719A58357C060A34A2258C74040B86B60B39A8457C0946018EF24C84040ECAAC719758657C01827E4BB75CA404084D893E69F8757C00C7818EF74C940409C1394E6F38857C0D00D4B2258C94040A6BAFA4C328A57C0F4F0E4BBE5C94040AE14C8195D8C57C0BC89E4BB05CC404034322D80538D57C044184A2268CB404093A7C719298E57C0C094E3BB2DCA4040442894E6098F57C0E053E5BB81C94040C9642D801F9257C0308E17EF2CCC40403B25C819359357C06C94E3BB21CC4040BEC8FA4CDC9357C0E0B4B18896CA40403665C719519457C0282118EF8CC84040F879C819FB9457C08CA8B0886EC74040D2F3FA4C449657C038B5B188A2C840409EA560B39E9757C0E036B1887EC740403ADC2D80CB9857C0103918EFE8C7404032B160B3409957C0146FB28826C94040BEB22D80739857C01827E4BB75CA4040BEB22D80739857C03073E5BB41CB404060DFFA4C0E9A57C010E24A22D8CA4040BED92D809D9B57C0281C4A22A0CB4040D44861B3CA9C57C06CF9AF886ECD40405A5FFB4C429D57C02093B0881AD0404062EB94E6E19D57C0CBDC4A2270D240403FD82E80FB9E57C00C14B088DED24040745BC7199F9E57C0B02E4B22B0EE404018CD61B3429E57C0F0CBB088820A414056C1C619E79D57C0346916EF54264140F43261B38A9D57C0D383B1882642414018DD61B32E9D57C0182117EFF85D41404E60FA4CD29C57C0BCAC7E55CB794140740AFB4C769C57C0EC674B229C954140A88D93E6199C57C0A0647F556FB14140262161B3889D57C020DCE4BB41C34140792EFA4CF89E57C08471B18812D541404E032D8067A057C0E8067E55E3E64140495E94E6D5A157C04B9C4A22B4F841401033C71945A357C0C03117EF840A4240E307FA4CB4A457C0A0977E55571C4240E8D32D8023A657C0149E17EF282E4240B6A860B392A757C087A4B088FA3F424086BAFA4C069657C087A4B088FA3F424020D593E6798457C087A4B088FA3F4240F0E62D80ED7257C087A4B088FA3F42408A01C719616157C087A4B088FA3F42408C0A62B3D44F57C087A4B088FA3F4240AE5D61B3483E57C087A4B088FA3F42407E6FFB4CBC2C57C087A4B088FA3F4240188A94E62F1B57C087A4B088FA3F42406AD494E6A30957C087A4B088FA3F424002EF2D8017F856C087A4B088FA3F42409C09C7198BE656C087A4B088FA3F42409DE70A1D1DE456C087A4B088FA3F42406D1B61B3FED456C087A4B088FA3F4240C56561B372C356C087A4B088FA3F4240D84794E6E5B156C087A4B088FA3F4240F89A93E659A056C087A4B088FA3F42404274C719CD8E56C087A4B088FA3F42402ABBC619618A56C087A4B088FA3F42406200C7194D8A56C080AD4C22B03F4240D2DAC6192D8A56C0C4BB7D55673F42402ACCC719D98956C028E9B188623E42400C5594E6358956C010E07D55833B424066832E80098956C03467B188123B424072AC60B3C48856C0BC7CE5BBB13A4240E4F9C719758856C0ACF0B0885E3A424030DBC619398856C0D09AB188023A42406ED0C7191D8856C058FEE4BB8D3942400A42C7190D8856C028B6E3BBF9384240DEAAC719FD8756C0D48D7D55EB36424002552D80ED8756C047177D5537364240DC642D80D38756C0889AB0888E354240F62AFA4CA68756C070464A220035424058A793E6658756C04CA4E4BB853442408E1795E6478556C0789A18EF64324240A0E7C619F98456C0E42C7E55FF314240874CC719B18456C06B1FE5BB89314240FCB3FA4C748456C0E8FF492210314240F2AC94E6418456C07CB17C55873042405C0DC7191F8456C083107D55EB2F424086672D80078456C068F94A22382F424078F660B3068456C043EE7D557F2E4240CD0A94E6138456C09C014B22B42D4240208A2E807B8456C07441B088AA2A42406042FB4C848456C0BC72E4BBDD294240C06594E6398456C0C43017EF14264240DEC1FA4C3E8456C0E4D1B1886A2542401E4494E6518456C0CFCB4A22C82442403C1CC819758456C03425B288262442401B4DFA4CA08456C030B3E4BB992342405EA461B3DC8456C0B86417EF102342400E0A61B31E8556C05B1BB0889E224240914B2D806D8556C058EF7C553B224240883CC719C58556C06C69E5BBF1214240C7FD60B3648756C0B7F9E3BB212142404E3F2D80B38756C0EC977F55CB2042408A8D93E6ED8756C074FBB2885620424017B393E60D8856C03442E5BBC11F424078D72D804F8856C0BC6517EF341D42405EB860B3728856C0882AB2888E1C42405ADD2D80A38856C09C6B4B22F41B4240E475FA4CE08856C06C4617EF741B424012FC93E62B8956C058384B22101B424092482D802D8B56C094A8B1883E1942405E2661B39E8C56C040704B22441842405A66FB4C6E8D56C0BCE44922E0174240AE8394E6C98D56C07C644B229C1742409A03C7196D8E56C0E87C7E55E71642403A902E80AF8E56C0508D4C22701642403676C719E98E56C048AAB288E2154240FD5394E6118F56C06CCDE4BB491542405C3294E6298F56C037034C22A41442407240FB4C428F56C048D217EF7C13424018EF93E6598F56C0E8314B22D01242403E3894E67D8F56C08820B288221242401C72C719AB8F56C010AF17EF84114240344CFB4CEA8F56C034844A22001142405558C719339056C0D8ECE3BBA1104240CC81C7198B9056C0C872B188521042409E6FFB4CE89056C0C47A16EF141042402225FA4C2C9256C07432E6BB950F42406ED1C619879256C074284922540F42401C99C719D59256C07C7FE4BBF50E4240ED0A2E80139356C0F4714B22800E4240ACB6C7197F9356C074E0E2BB790D42405453FB4C429456C0C4E1E3BB110C4240764661B3509556C064CD7D5527094240E4AEFA4CEC9556C00C8CB188DE074240505894E62F9856C0633F7C55BB004240F082FA4C669856C0641BE4BB81FF4140128F61B3629856C020034C22F0FE4140DE2D95E6479856C0702BE4BB6DFE414022D2FA4CE49756C0282D7D553BFE41401C15FA4C409356C0E0FB7E556FFE41400979C719238A56C0902D4B22D8FE4140C074C719058156C050D0E3BB41FF4140F6A82D80E77756C064617E55ABFF4140DC9B2E80C96E56C0240417EF1400424023F9FA4CAC6E56C014227E551300424062E5FA4C8E6E56C098C2AF8812004240A0D1FA4C706E56C09451E3BB110042406E672D80536E56C0846F4A2210004240,-51.3%,-234,222,63,159,Arkansas,true
7,0106000020E610000001000000010300000001000000D40000009630FA4C40F351C050D6E4BB65014540CECEFA4C36F351C0F02CB18802FA4440CE75FA4C2CF351C0873018EF9CF244408C4C61B322F351C0C42716EF38EB4440142CC71919F351C0405BE6BBD5E34440D2022E800FF351C07852E4BB71DC44405AE293E605F351C02438E4BB0DD54440928094E6FBF251C0AFAC17EFA8CD4440A09860B3F2F251C0589217EF44C6444074CB2D80EDF251C0E0507D556BC24440EA0794E625F351C018A6E3BB1DBD44404A4FFB4C7CF351C06431B18836B54440F805FB4C52F451C043C3E3BBE1B44440E49693E6B9F451C0A8D2B088DEB34440901095E61BF551C064367F5523B244404CF0C619ADF551C02CFBE2BBADAB4440600794E613F651C03F727E5527A944403AB45CFE37F651C07C8B16D0C8A74440B21AB73DC6F751C0BCC5CDC7BAA64440108731BE2FF851C0B04EE2A1DFA74440DEC5FF73D1F651C0BCBEB2B947A944404206D22831F751C03C3CCF3592AA44404406D228D1F751C01CB979E06CAB444002D97CD3A9F851C088427AE01CAC4440964F7CD379F951C0700AD0355AAC4440F2717CD3A5FD51C044877AE034AC4440D6C77CD343FE51C07C71D035FEAB444048947CD3510252C00817268BAFA844406389277E560552C01804258B0FAD44406989277E160652C0F4CB7AE04CAC44408CC1D128790652C0E419CF3546A944405FFB7CD3150752C0443CCF35D2A744400C67277EAA0852C0244FD035F2A74440D07CD128C10A52C0E419CF3546A9444030EA7CD36F0C52C0204FD03572A94440392D7CD3CD0C52C0403CCF3512A64440F0717CD3850E52C0D8FD79E0C4A74440372D7CD36D1252C060BF248B37A444408CC1D128791452C044D2258B97A54440342D7CD3ED1452C06C557BE03CA64440663E7CD3D31552C0687479E0D4A644407AA57CD3371652C038B6D03556A74440329FD1286D1652C0E819CF3546A84440C2AB277E421652C0F880CF352AA94440D2C77CD3031652C0BC2CD03526AA44409ADD267EFA1552C01304258B4FAB44401E837CD34B1652C037B6D03596AC4440309FD128ED1652C0403CCF35D2AD44409ADD267EDA1752C00417268BAFAE4440623E7CD3131952C0CCB2CE35E2AE4440745AD128551852C02004258BCFAC4440EE717CD3451752C0A87A248B1FAB4440392D7CD3AD1652C09C5ECF351EA94440745AD128551752C0403CCF3512A644406889277EB61652C00CE8CF354EA54440725AD128751652C0A05ECF351EA544400A67277EAA1752C0CC48258B67A34440C4AB277E021952C007E8CF358EA34440AAB67CD3BD1B52C0A05ECF351EA5444078A57CD3F71C52C0680AD035DAA44440081C7CD3671E52C088F7CE35FAA344405622277EB21F52C0640AD0359AA24440DA0A7CD3812052C03F3CCF35D2A044409EDD267EDA2052C0FC80CF356AA144406F5AD128152152C0D448258BA7A14440C2607CD33F2152C0FC80CF35EAA144401B837CD36B2152C0647479E094A24440EE717CD3E52152C0647479E094A24440944F7CD3992252C0838D258BBFA14440A6B67CD33D2552C030D5CE35AEA34440745AD128B52652C03C3CCF3552A444409CDD267E5A2A52C0647479E014A344405022277EF22A52C070557BE03CA244404606D228712B52C040D2258B57A144405622277EF22B52C03F3CCF35D2A04440DA0A7CD3C12C52C03FD2258BD7A04440DE0A7CD3612D52C06B0AD0355AA144404C947CD3F12D52C0F835248B07A244404D947CD3912E52C0647479E094A244404A947CD3712F52C030B6D035D6A24440C2AB277EE23152C0647479E094A244401C837CD38B3252C064BF248B37A2444060FB7CD3953352C07C71D035FEA04440382D7CD30D3452C090F7CE353AA144407E073391E53452C0E0592941D5A04440D41A52F1F13552C08093C09515A144402B6971CBC93652C05C9951E2699F44408646DB841D3952C008C416555B9F444027D86492533952C04480F3ECB6A044401A837CD34B3952C0F835248B07A24440309FD128CD3952C088F7CE357AA344408CC1D128F93952C064BF248B77A64440A228D2283D3A52C010E8CF350EA7444030EA7CD3CF3A52C08CF7CE353AA64440944F7CD3593B52C064BF248BF7A44440F0717CD3853B52C03C3CCF3552A44440081C7CD3E73D52C03F3CCF35D2A044401A837CD38B3F52C01804258B4F9D4440D07CD128214052C0D4B2CE35629C444086D5DC8DE24052C0B8F0CBEC759A444056B108C3754252C003C216E1449A4440309FD1286D4352C06C0AD0351A9B4440643E7CD3134452C04CA3CF35369A44408CC1D128794552C060BF248B379944401A837CD30B4652C068557BE07C984440D6C77CD3A34652C034B6D03516974440BD607CD3DF4652C08C427AE05C964440F6F7BCEF134752C01CA5E388BA944440E8BF686BF14652C07488EEE20893444078116757974852C0100304B0D79244403CD3E2F1EC4952C0BC975C7B55944440E46A2184844A52C0D0CB7B4B229544405ED4A313E34A52C088253E81B4954440D902E5C3C74B52C057990D324996444038C60334CB4B52C0A0F09BFAB4944440C28A6ADC5E4D52C0FFCE557E0F94444030EA7CD3CF4D52C09C5ECF35DE944440F0717CD3054E52C0848D258B3F954440F4FF267E264E52C0AF107BE064954440FC4AD228694E52C0C02CD035E6944440521D39D2594E52C070FE680A2D93444020E8632F954E52C09C5C4B1C47924440B2C36596F64E52C0A46205C77E914440FE91A345A54F52C08041C23261904440F1F156B1C65052C0388EF339628F4440C8A3A19A605152C0241A293D0E8F444073D0EA4CD05152C06FE0C369A4904440CCF9133C555252C064CCCB0B37914440D0F35522CB5252C08F0ED991C18F4440C2B8DEE0525352C0346C9B89F98E4440267BA73C395452C0902EA46DC38E4440927850BB455552C027080F218E8E44402C6A5CD7665652C08CF4808BAB8D4440727CEEE34C5752C0AC46D73B928D4440392D7CD3CD5752C0F3CB7AE00C8D44403A2D7CD34D5852C0483CCF35D28C4440AE44277E1E5B52C0284FD035F2894440DE0A7CD3015C52C06C0AD0355A894440C0607CD35F5E52C0ACC5CF3502874440372D7CD30D5F52C0B0107BE0E486444078CA39CA446052C0089692DB72854440829D1C4A7C6152C0F896DF34C08244401271483D606252C0EC0BDEED008444409E28D228FD6252C0284FD035B2834440F8FF267E266452C014B979E06C824440FEF93774C26552C034D418AFE4814440836F7F33336652C06C8474A107834440F09213AEA66652C0474A0EA0EB824440866DD6091D6752C038DEFA767381444066EFE2B6A36752C0A071BB531E814440B680ABFD9C6852C030E73D2EE780444008DE5A9D116952C01892A0203A80444002F423A9246952C0B444A8F4228044408A636585706952C0B02D3EAF938144408E9C2D809F6952C007CF7D5573824440A2902D80F16952C01824E5BB8D834440C0822D80276A52C0F0374A22F88344403C1694E64D6A52C040FAE2BB2D844440EAD493E6996A52C04033B2887E844440BA852E80CF6A52C0384DE3BBDD844440E6022E80616C52C0145AB288A2884440DEC760B3EA6D52C02CBA15EF548C4440AA3BC719456E52C0E4407F553F8D4440104D94E65D6D52C0D37918EF288E44400C88FA4C8C6A52C094904A22D090444088FC60B3FE6652C0A377B28826944440684461B31E6352C064CCE3BBCD97444076E72D80FF5F52C060937D55BB9A4440DA852E80FB5E52C0D00519EFE49B4440989A94E6F15F52C00CECE4BB019E44407A4895E6C76052C0F0FA16EF38A04440142EC719AD6152C03CCD18EF98A2444000AFFA4CDC6252C0207A4B22C0A54440141EC719C16252C0F81BB1882EA84440F6D2C619816252C03038E5BB19AE4440CCAE2E80416252C037B97C5507B44440AE632E80016252C008A64B22F4B94440DCE8C619C16152C0F826E3BBE1BF4440C49DC619816152C0544317EFCCC54440CED8FA4C406152C0C0237D55BBCB4440BEFEC619016152C014B17D55A7D14440A4B3C619C16052C0742017EF94D74440362761B3806052C0C03C4B2280DD4440A414C719416052C0CCBDE2BB6DE3444086C9C619016052C098AAB1885AE944409E75C719C15F52C0882B492248EF444004F260B3805F52C047A74B2234F54440646EFA4C405F52C0B887B18822FB4440CC5B60B3005F52C098B5E3BB0D0145406C40C719C15E52C00F257D55FB064540A6CD94E6F55652C0A76A492288064540A5F294E6294F52C0206FB28816064540682094E65D4752C0B8B47E55A305454070B660B3923F52C0DCCAE5BB31054540361DC719413B52C0D8D24A22F4044540E01661B3263752C0C8F816EFB4044540B1F8FA4CB03352C0B056B1883A044540EA3DFB4C9C3352C014CF17EFE4004540DAA793E6D93052C0D071B0884E014540EA6FFB4C7C3052C0B056B1883A044540D5232D80B32752C068584A22080445401E9194E6352652C0DC11B3885603454054CE2D80632552C088014A222003454086C42D80D72452C040FB7D552B0345403667FA4CAC2352C0A09F4A22100445402CB561B36E2052C0143B16EFF8034540F2BFC719F91652C0A8F6E5BBB1034540F2A3C719850D52C060D5B1886A034540FA87C719110452C078A27F5523034540F8FAFA4C9CFA51C0CCB0B088DA024540630CC7194DF351C0D8FEAF88C60245409630FA4C40F351C050D6E4BB65014540,-23.4%,-66,216,43,173,Connecticut,true
1,0106000020E6100000020000000103000000010000000D0000005422277ED20556C090789E6BA43E3E4018837CD3EB1356C037D09F6B9C3C3E40DC0A7CD3011356C090789E6BA43E3E40AAF97BD31B0D56C0281B4B16FF413E40603E7CD3930956C0281B4B16FF413E40A7B67CD39D0856C0F06B48168F423E40EAE3D128050856C068AA9D6BDC433E40392D7CD38D0756C08F0EF5C069453E409EDD267EFA0656C0A7A44B16AF463E40289FD1288D0456C0281B4B16FF413E40289FD1288D0456C027D09F6B1C403E40DA0A7CD3610556C027EF9D6BF43E3E405422277ED20556C090789E6BA43E3E40010300000001000000960100004196FA4CC4F455C0EF6416EFD4804140BCBE60B3FEEA55C088547E55B3804140266D94E6E9E055C088547E55B38041409D8393E6D3D655C0941CE6BB5580414086F960B3BECC55C0C8074A22F87F4140F4A794E6A9C255C040F54A226C7F41406CBE93E693B855C0F4CEB0880E7F4140CEFBFA4C7EAE55C0FC9618EFB07E4140FE4161B368A455C0FC9618EFB07E4140B4C02D80539A55C0FC9618EFB07E4140663FFA4C3E9055C0A89CB188B67E41404644FB4C288655C027CC16EFB47E41400894FA4C507C55C0E0027F559B7E4140347AFA4CFE7155C0A4934B22687E4140A98F2E80C36655C0BC6C7E551B7E4140B0DD2D80AF6655C0FCAE7D555F7D4140BC6861B3766655C0F8ECE4BB357B414018B1C7195D6655C09C1FE4BB99794140BCC961B3F66555C0686F7F55E3744140B45794E6696555C0287618EF0C6F414039252E80C36455C0A074E3BB29684140223B2E80036455C0E0B1B18856604140B8E1FA4C106355C0B4854A22A8574140B2D02D80036255C008257D55374E4140D3B661B3F66055C028187E551F44414028EEFA4CD05F55C08804E5BB753941400A65FB4C905E55C080427D55532E41408EC0C7195D5D55C0D8B3B088CE224140E2F760B3365C55C07C637E5503174140924A2E80035B55C09C127E559B0A4140B65D94E6E95955C0FC4F19EFF0FE404064B061B3B65855C04C3D7D55DBF240403072FB4C685755C0EC1E17EF84E540400C1F94E6695655C0340F7E5513DB4040924D2E80435555C098F17D558FCF4040E584C7191D5455C09C2F16EF6CC44040AD4FC7191D5355C0607B4B22C4B94040A811C8191D5255C0100F7E55ABAF404044B894E6295155C074AEB0883AA64040F4A961B3765055C0A8E117EF8C9D40400CE494E6A94F55C0684E4B22B895404068DBFA4CFC4E55C0D00BB388D68E40404AB4C619614E55C01042B188FE8840405A0061B3E44D55C088A34A2248844040861B2E80894D55C0E7E718EFCC804040583E94E64F4D55C0E80719EFA47E404018BCFA4C3C4D55C0C0797D55E77D4040ACE7FA4CB64C55C0B80116EFE07840408AB061B3E24C55C0989BE3BBB5774040D249FA4CCC4A55C050BC4B227C6E4040403661B3FC4A55C0F813B188CE6A40405C6FFA4CEC4A55C020D717EFAC6940408A5694E6B74A55C0B0C87D55AB684040050CC719674A55C06C957D55C7674040723661B3024A55C098D216EFF4664040D21BFB4CB84855C0CC71E5BB99644040CE3FC7195D4855C0971419EFBC63404078ED60B3E44855C040734B22846240402EB460B3A64855C0D860B1884A61404009962D800D4855C058BA7D55FB5F40405EF194E6874755C0C098B1887E5E4040B58094E6274755C0EC564922085A4040899894E6834655C050A57E556757404051D7C619794655C0D8F5E4BBC9554040B68894E69D4655C0BC8DB08886534040F82CFA4C3A4655C0F09E16EF50524040CA6061B3784555C05883B188765140401A03C719F94455C0C8927E5573504040BA02FB4C584555C060137D55C34E40402AFC2D80EF4055C010E5E4BB1145404066CD60B3324055C05C9F4A22F4424040708EC719EF3F55C0385BE4BB514140402E1D94E69F3F55C098994B22343D4040D01261B3243F55C02BA017EF343B4040088D93E6793E55C057107E5563394040B8532E80EF3D55C0142EB2887E374040804261B3DC3D55C0A8CC17EFCC3540401C892E80F53D55C0F4F3E4BB2534404094CCFA4C603E55C0B830B088B6324040581D94E6A53E55C0185AE4BB793140406835FB4C503E55C030204A2204304040F6D793E6B33F55C01CC1B188762D4040325AC8197B3F55C00836B0881E2B4040A171FA4C3A3E55C088C6492208294040AABDC6192D3B55C088EEE4BB092640401802C8198F3A55C000A316EF2C2540405CA62D802B3A55C0A4AAE3BBB92340403A9A61B3E23955C008D5E2BBA1234040AA2EC719993955C0D7367D555F2340408A5F94E6773955C0CC27B0886E224040F2D12D80A53955C0684F4B22642140401A2494E6173A55C0788B7E55B3204040CE9BFA4CAA3A55C094357F55572040405C462E80373B55C0DC29492248204040FAAEC719D93A55C0F09DAF88AE1E40406E9B2E80093B55C0242D7E55671D4040E090FB4C883B55C0F83B18EF741C4040C4ED60B3163C55C06FE8E4BBD51B404076B6C7193D3D55C05F6F7D55AB1C4040E080C719313E55C0B03DB188421C40401CCF2D806B3E55C05CE27D55331B4040480561B3663D55C020C9E4BB151A4040F4A194E6293E55C0C0014B221C194040B4D9C719353F55C050AA17EF44184040262095E6474055C0806E7F55AF174040F232FB4C224155C0287C7D55771740400D0B94E6914155C0F8684B22FC164040140A95E6014255C0841417EFD0154040FEB5FA4C084355C0C8BEE4BB9D1140407AF060B3244355C0C8CEE4BB8910404016BB60B31E4355C04CE04A22600D40405860C719474355C008C6B088B60B404044E9FA4CEC4355C0E8FEB1887609404093C9FA4C204455C07C797F558B064040C068FA4CA64355C080C3B088AE034040AE6CFA4CDE4355C0E09F18EF80004040BC0995E6F54355C068807D5507004040841395E6814455C010D7FBAA3EFC3F40C822C719C54455C0701D60110DFB3F407056FA4C924655C0400A954400F13F40F8C4FA4CD04755C0A06B924428E73F40CEE6C619534855C0D756974498DE3F4018D2C719A54855C0383A2DDE39DB3F40A89EC719BB4855C00870CA77FBD93F40546E2D80CB4855C09FF52EDE61D83F40847094E6354955C06F28FBAAEED23F4028302E80C54855C0D858FBAABECD3F40FA1C95E6014755C050EB5F113DB13F400F81FB4C7C4655C050AE2EDEF1AC3F405EA7C719494455C088BB9644A0A23F40A42F61B3B64355C08029C877D39D3F401C0A61B3964355C090CA9444989A3F40A2F2C7198F4355C02FEEC9779B933F401AC4C6196D4355C050189644A0913F40604C60B3DA4255C098419344888C3F40C244C719B94255C0BFA3C8770B893F4038C7C7191B4355C080836511FD823F405858C719D14355C04027C877237E3F40F757FB4C304455C0DF9F2EDED9783F40A2F2C7198F4355C05F73FDAA86713F4057C294E6E74455C0D8E79544686B3F40D05560B35A4555C01F98934408623F400E7994E6BD4555C0F8A29644684E3F40FD102E800B4655C047A69544204C3F4080892E80DB4655C069D1944420483F40D1602D800D4755C04843CA7783453F40C87C94E6EF4655C0276264117D433F4048F32D805B4655C0AFFBFAAA763E3F406212FB4C384655C0888A31DEF93B3F40926261B38E4655C0488CFBAACE323F40BABCC719774655C010ACC877C32E3F400E7994E6BD4555C0B01D5F11752B3F40B437C819754455C07814C67743293F40E4502E80B54255C0C8856211FD203F40664A94E6294155C038AEC6773B163F405FA22E805B4055C02066FDAA360A3F40447BFA4CC03F55C0BFC6631185073F402E1D94E69F3F55C080EBFBAAD6043F40840695E6D53F55C0D7162EDEB9023F40AEFFFA4C3E4055C05079964420013F40137294E66B4055C03F95FBAA06003F406C8761B3964A55C03FB3621105003F404AD594E6C15455C03FB3621105003F406CF360B3EC5E55C01FEF30DE01003F40C4082E80176955C0FF0C984400003F40A25661B3427355C0FF0C984400003F40CA742D806D7D55C0086C6211FDFF3E40228AFA4C988755C0E8A730DEF9FF3E40FAD72D80C39155C0E8A730DEF9FF3E4052EDFA4CEE9B55C0E8A730DEF9FF3E40780BC71919A655C0D006FBAAF6FF3E405259FA4C44B055C0E8246211F5FF3E40E065C8196FBA55C0E8246211F5FF3E40CF8C93E699C455C0E8246211F5FF3E40DFD1C719C5CE55C0D0832CDEF1FF3E4038E794E6EFD855C0E7A19344F0FF3E405A0561B31AE355C0E7A19344F0FF3E405573FA4CFEE555C0B0DD6111EDFF3E4054F82D806BE655C0B7932FDE61FC3E403629FB4C4AE655C0C06E62115DF03E40F0C22D8065E655C0E8A9944420EF3E40ECA1C719B5E755C0D8A0954440E53E404BC661B3F6E755C0AFAD63119DE23E40BA86FA4C10E855C0D062FEAA16E13E40DDAC2D801FE855C0A0AC944480DF3E403084C71905E855C0874EFDAA7EDD3E40FCDC60B3C0E755C0F8F660115DDB3E40404B2E801BE755C070822FDEE9D73E400CCF94E661E655C0F8939544C0D43E405C9BFA4C4CE355C0F0722DDE39CA3E40C0A4C719EFE255C067EA964450C83E40767BC7199DE155C0A0F19444D8BF3E40DCFD60B3B6E055C02880984478BB3E40B35CFA4CCCDF55C020146411FDB83E40663061B3A8DA55C0AF3D2EDE19AE3E404FA6C71925DA55C009FACB777BAC3E40AA7B61B3EED955C05825924490AB3E40E24694E6D7D955C047D932DEF9A83E4040CC93E6E5D955C018DE611135A53E40F7772D8051DA55C080E3FCAA569C3E40CCA2FA4CD6DA55C0CFFEC87793953E40AA8693E6EDDB55C0980E6311C58E3E40B4EFFA4C2CDC55C0572331DE918C3E403C422D803FDC55C0309E6011758B3E40FAA5C71919DC55C0A06BFBAA56873E40F0C82D80E5DA55C087D7FAAA1E7B3E4036D8FA4CDCDA55C0686FCA77D37A3E408723A30ADBDA55C097A8F72CC97A3E40369437E8DADA55C0402A61C4C77A3E404406D22851DB55C09FA44B16AF7B3E404406D22851DB55C037D09F6B1C7A3E409ADD267EDADA55C000029F6BD4773E40A228D2285DDA55C0A8FBF3C009763E4006D97CD3C9D955C0311B4B167F743E4076A57CD317D955C020D09F6B1C733E404B947CD391D955C020D09F6B1C733E401A837CD3ABD955C0776CA16BAC703E40FD4AD22869DC55C00098F5C099673E40725AD12815DD55C0C7469F6B6C633E400A67277E8ADD55C03085F4C0395F3E404606D22851DE55C01FEF9D6BF45B3E40299FD128EDDF55C08F789E6BA45A3E40B244277EDEE055C087789E6B24593E404506D22871E155C0B0469F6BEC553E403EBB267E2EE255C00F029F6BD4523E40FE4AD228A9E355C058BD9E6BBC513E4004D97CD3A9E455C0C0914A164F523E404A947CD3F1E455C0C0914A164F533E40D70A7CD301E555C03772F3C0D9543E40A6B67CD35DE555C0EFE2A06BFC563E4098DD267E7AE655C0D1339E6B8C5A3E40DD0A7CD3C1E655C058BD9E6B3C5C3E40081C7CD327E755C058BD9E6B3C5C3E4004D97CD309E755C028EF9D6BF4573E40ACF97BD39BE655C0E714A06B34553E409CDD267E5AE655C0FFE2A06B7C523E40DD0A7CD3C1E655C050F548163F4E3E401E837CD30BE655C0CF339E6B0C4E3E40944F7CD359E555C008029F6B544E3E4062FB7CD3B5E455C0D0339E6B0C4F3E40DC0A7CD321E455C0E8E8F2C029503E40E8E3D128C5E555C0311B4B167F463E40D6C77CD3E3E955C0B8FBF3C089403E405EFB7CD355F255C037D09F6B9C3C3E40C5AB277E42FA55C037D09F6B9C3C3E40F2717CD3E5FF55C067F548163F393E40362D7CD3ED0156C08021F6C049393E40FFD87CD3290156C058AA9D6BDC3B3E409EDD267EBAFF55C0C0FBF3C0093E3E40081C7CD347FD55C027D09F6B1C403E40934F7CD3B9FC55C0E014A06B34413E4088C1D12859FC55C020D09F6B1C433E40D0C77CD3E3FB55C030BD9E6BBC433E40061C7CD387FA55C030EF9D6B743F3E40CF7CD12801F855C0EF019F6BD43D3E40E6E3D128A5F555C0F86B48168F403E4060FB7CD3B5F255C07F59A06B4C433E40FC4AD228E9F055C0086C48168F473E40392D7CD3ADF155C0E8E8F2C029503E40663E7CD3B3F455C0FF6B48160F5A3E402E9FD1282DF555C0B8A44B162F5D3E40D4C77CD303F555C001E3A06BFC5F3E40663E7CD373F455C088789E6BA4653E402CEA7CD38FF455C00098F5C099673E40E8E3D12825F555C020D09F6B9C693E40081C7CD367F555C00198F5C099693E40C0607CD39FF555C067AA9D6B5C683E408BC1D12879F655C040BD9E6BBC643E40C0607CD35FF655C00F1B4B167F633E405422277E72F655C0381B4B16FF623E40F6FF267E66F755C02F85F4C039633E40C3AB277E22F855C03FBD9E6BBC633E40E5E3D128C5F855C0806CA16BAC643E40633E7CD353F955C017E3A06BFC653E405422277ED2F955C00098F5C099673E40643E7CD353FA55C0182E4C16DF693E40F84AD228A9FA55C01F2E4C165F6C3E406989277ED6FA55C048084A161F6F3E40F0717CD3E5FA55C0C8E8F2C029723E407AA57CD317FB55C08059A06B4C753E40FAFF267E86FB55C0618B9F6B04783E40944F7CD3F9FB55C0B0A44B162F7A3E40745AD12835FC55C09FA44B16AF7B3E4060FB7CD315FC55C030EF9D6BF47F3E4032EA7CD38FFB55C0509EA06BE4843E40D07CD128E1FA55C0BF7E49166F893E40C5AB277E42FA55C0B0FBF3C0898C3E400C67277E0AFA55C09859A06B4C903E40F0717CD365FA55C0E77E49166F953E405122277E52FC55C05F9EA06BE4A83E401A837CD30BFD55C098789E6B24AC3E4041BB267E6EFE55C0E014A06BB4AE3E40B044277E3EFF55C0AFA44B162FAF3E40382D7CD3EDFF55C050BD9E6B3CAF3E40F8FF267E660056C0CF27A16B14B03E40643E7CD3930056C0D027A16B14B33E403CBB267E8E0056C06FF54816BFB63E40DA0A7CD3A10056C0888B9F6B04BA3E40EC717CD3050156C05FF548163FBC3E40362D7CD3ED0156C03072F3C0D9BC3E405DFB7CD3750156C048BD9E6B3CB93E408BC1D128790156C00098F5C099B53E40362D7CD3ED0156C007E3A06B7CB23E40372D7CD3CD0256C0E77E49166FB03E40FE4AD228690256C03F72F3C0D9AC3E40EAE3D128C50256C07721F6C049AA3E409E28D2285D0356C0708B9F6B84A73E402C9FD128AD0356C09F659D6B44A33E40C1AB277EC20356C0DFE8F2C0299E3E40F8FF267E060456C077F54816BF9A3E40C0607CD37F0456C01098F5C019983E4032EA7CD32F0556C07021F6C049953E4001D97CD3690556C0101B4B167F933E40904F7CD3790556C0606CA16B2C913E402A9FD1286D0556C0B0FBF3C0898C3E403EBB267E8E0556C018E3A06B7C8A3E4002D97CD3290656C038D09F6B9C873E401B837CD34B0656C0609EA06B64853E4040BB267E6E0656C01085F4C039813E40FC4AD228090756C0E7339E6B8C783E4017837CD32B0756C007E3A06BFC733E40392D7CD30D0756C0C0659D6B44693E4030EA7CD3AF0756C02FD09F6B9C563E4062FB7CD3150856C000E3A06B7C533E4031EA7CD3CF0856C06FAA9D6BDC513E409EDD267E1A0956C0D727A16B94523E405CFB7CD3350956C0876CA16B2C543E409DDD267E5A0956C0AF27A16B14553E403A2D7CD3AD0A56C0E714A06B34553E40725AD128B50A56C0AF27A16B14553E40061C7CD3C70B56C01F1B4B167F553E401A837CD36B0C56C09F59A06B4C563E40EE717CD3850C56C038BD9E6BBC583E40904F7CD3F90B56C07F789E6B245E3E4079A57CD3D70D56C0B027A16B94603E4006D97CD3C91156C00998F5C099633E404D947CD3711356C02185F4C0B9663E400C67277E8A1356C0A0659D6BC4643E40071C7CD3A71356C03FBD9E6BBC633E40F4FF267EC61356C0002E4C16DF623E4018837CD3EB1356C0D0AAF6C079613E404A947CD3511456C0D0AAF6C079613E4076A57CD3771556C0609EA06B64673E40AAB67CD3BD1656C069AA9D6B5C673E402A9FD1282D1856C018029F6BD4643E4022F941DDBD1956C038FD52DA48633E40C61F94E6BD1956C0EF9DC9774B633E40EEFE2D80131A56C0A8649544507B3E401E4F94E6691A56C049AE2FDE59933E40442E2E80BF1A56C0C051FFAA5EAB3E406C0DC819151B56C060FA631165C33E4064662D806B1B56C0378561116DDB3E400B0D61B3C01B56C0072EC67773F33E403C5DC719171C56C0309032DE790B3F40EA74C7196D1C56C0211B30DE81233F40928CC719C31C56C0A0E1FBAA863B3F40C2DC2D80191D56C0788A60118D533F4070F42D806F1D56C0EFB0FEAA966B3F4098D3C719C51D56C06F77CA779B833F4088BB60B31A1E56C048202FDEA19B3F4038D360B3701E56C0DF69C977ABB33F406623C719C71E56C07F309544B0CB3F404632C8191D1F56C017B6FDAAB6E33F400E21FB4C0A1F56C037DDFDAAE6E53F40FC9FC719D51E56C05760FCAA3EEC3F40CC4F61B37E1E56C0A81EC9777BF63F404E42C819091E56C0D01E16EF2C024040A23B2E80771D56C0FC4517EFC40A4040527DFA4CCC1C56C0946AB188E61440405E102E80091C56C01417E5BB69204040600FC819311B56C0408E7F552F2D4040783EFA4C461A56C038BFE4BB113B4040945C61B34A1956C070647E55EB494040246F94E6411856C010D217EF9C594040EA16C7192D1756C0C0037E55FF6940401A54FB4C0E1656C0FCE818EFF07A4040AEF361B3E81456C0E8E118EF4C8C4040DECE94E6BD1356C03C3DB088EE9D40404898C719911256C0583817EFB4AF4040EFC9C719651156C0E4924C227CC14040A8DD60B33A1056C048D07C551FD34040B44461B3140F56C034C97C557BE4404039C3FA4CF60D56C0F04E49226CF540407A32C719E10C56C014E07D55CF054140FAD32D80D70B56C0A06B7E557F1541409E2AFB4CDC0A56C0EBF2B0885A2441406E8994E6F10956C0501218EF3C3241404202FA4C1A0956C01C9BB088023F414052952D80570856C0ACB8B088864A4140B49594E6AB0756C034FBB188A6544140088FFA4C1A0756C0F0A47D553F5D414010BAC719A50656C0505216EF2C64414062A2C7194F0656C0E8104B224C6941408A8060B3180656C0A4A5AF887A6C4140089FFA4C060656C020664A22906D4140993FC719B90556C0002FB0882E724140CA13FB4CA40556C054757D553B744140523C61B3B80656C070C07D557B744140B44F61B3CA0856C058154A22DC764140C2FF2D80570A56C028E1E4BB8D7A41403C8194E6750B56C0B82D16EFB87F41402C1B2E80DF0B56C084557F553F8141408648C719270B56C084557F553F81414062D1C719EF0856C0D8AEB0883681414092172E80D9FE55C01081E4BB058141404196FA4CC4F455C0EF6416EFD4804140,-21.3%,-101,373,52,321,Alabama,true
3,0106000020E610000001000000010300000001000000A80100007DB794E6FB425BC088FCE3BBF97F424004F0FA4CFC425BC0B476B1884E69424004F0FA4CFC425BC0D8F07E55A35242400C61C719FD425BC0779AB188F63B42404BC994E6FD425BC0A8854B224C2542404BC994E6FD425BC06882E3BBA10E4240CC01FB4CFE425BC07C8BE4BBF5F74140533A61B3FE425BC09C05B2884AE14140533A61B3FE425BC05C917D559FCA414061AB2D80FF425BC07C7C17EFF4B34140691CFA4C00435BC0ACF6E4BB499D4140691CFA4C00435BC05C11E4BB9D864140A884C71901435BC07C8BB188F26F4140A884C71901435BC03C88492248594140A884C71901435BC04C207E559B4241406825FB4C02435BC0709A4B22F02B41407696C71903435BC03097E3BB451541407696C71903435BC05011B1889AFE4040F7CE2D8003435BC080FC4A22F0E740407E0794E603435BC030174A2244D140407E0794E603435BC06002E4BB99BA4040BD6F61B304435BC0108EAF88EEA34040C5E02D8005435BC03097B088428D4040C5E02D8005435BC044117E5597764040461994E605435BC0049D4922EC5F4040CD51FA4C06435BC0301717EF40494040CD51FA4C06435BC0B4F0B288963240405BFB2C8007435BC0F3ABE3BBE91B4040CB5AFB4C08435BC024977D553F054040CB5AFB4C08435BC0AF45924428DD3F40CB5AFB4C08435BC0E7579444D0AF3F40DACBC71909435BC02F4C2FDE79823F40DACBC71909435BC0A763C67723553F40DACBC71909435BC0371731DE19553F40DACBC71909435BC01811944410553F40DACBC71909435BC0DFE7FAAA06553F40DACBC71909435BC088DCC877FB543F40DACBC71909435BC050B32FDEF1543F40DACBC71909435BC0E0A7FDAAE6543F40DACBC71909435BC0E0A16011DD543F40DACBC71909435BC08878C777D3543F40DACBC71909435BC02F6D9544C8543F40DACBC71909435BC0F843FCAABE543F40DACBC71909435BC0A038CA77B3543F40DACBC71909435BC087322DDEA9543F40DACBC71909435BC050099444A0543F40DACBC71909435BC0D9BCFEAA96543F40DACBC71909435BC0B8D4C8778B543F40DACBC71909435BC068AB2FDE81543F40DACBC71909435BC047C3F9AA76543F40DACBC71909435BC0109A60116D543F40DACBC71909435BC0804DCB7763543F40DACBC71909435BC068472EDE59543F40DACBC71909435BC0283CFCAA4E543F40DACBC71909435BC0EF12631145543F40DACBC71909435BC0B72A2DDE39543F40DACBC71909435BC047DE974430543F40DACBC71909435BC028D8FAAA26543F40DACBC71909435BC0D8CCC8771B543F40DACBC71909435BC0B8E4924410543F40DACBC71909435BC05F7A964408543F40DACBC71909435BC0F06E6411FD533F40DACBC71909435BC0D0862EDEF1533F40DACBC71909435BC0983F2EDEE9533F40DACBC71909435BC060B7CA77E3533F4052D3C71909435BC0E060D2E9CF533F4027B44FD46D445BC03F84D1E9CF533F40EB2F6F9929475BC03F84D1E9CF533F4066412EF2E4495BC03F84D1E9CF533F40DD6B0C90A14C5BC03F84D1E9CF533F40B9D42A555D4F5BC060C9D686CC533F40973D491A19525BC060C9D686CC533F40D1FDC64BD5545BC060C9D686CC533F40AE66E51091575BC060C9D686CC533F402F78A4694C5A5BC060C9D686CC533F40494B239B085D5BC060C9D686CC533F40830BA1CCC45F5BC060C9D686CC533F40E52F612580625BC060C9D686CC533F401EF0DE563C655BC060C9D686CC533F409F019EAFF7675BC060C9D686CC533F4001265E08B36A5BC060C9D686CC533F40F4949A12706D5BC060C9D686CC533F406EA6596B2B705BC060C9D686CC533F40D0CA19C4E6725BC060C9D686CC533F40C23956CEA3755BC060C9D686CC533F40235E16275F785BC060C9D686CC533F4017CD52311C7B5BC011C3D723C9533F4078F1128AD77D5BC04708DDC0C5533F40F802D2E292805BC04708DDC0C5533F4033C34F144F835BC04708DDC0C5533F40B3D40E6D0A865BC04708DDC0C5533F4034E6CDC5C5885BC04708DDC0C5533F404FB94CF7818B5BC04708DDC0C5533F40688CCB283E8E5BC04708DDC0C5533F40098B8981F9905BC04708DDC0C5533F40D50CC78BB6935BC04708DDC0C5533F4010CD44BD72965BC04708DDC0C5533F402BA0C3EE2E995BC04708DDC0C5533F408BC48347EA9B5BC04708DDC0C5533F402CC341A0A59E5BC04708DDC0C5533F404796C0D161A15BC04708DDC0C5533F40C8A77F2A1DA45BC04708DDC0C5533F4048B93E83D8A65BC04708DDC0C5533F40BEE31C2195A95BC04708DDC0C5533F409D4C3BE650AC5BC04708DDC0C5533F40336418840DAF5BC04708DDC0C5533F409488D8DCC8B15BC04708DDC0C5533F4072F1F6A184B45BC04708DDC0C5533F40E11BD53F41B75BC04708DDC0C5533F40C084F304FDB95BC04708DDC0C5533F404796B25DB8BC5BC0E001DE5DC2533F40ECBFBDB466C05BC0E001DE5DC2533F40CFD9EFA74BC45BC00F2F33B369553F4055C7EC8A0BC65BC030DDEA34B0573F4012549BD256C95BC0882AA5F0EB5B3F40A67C07F3A2CC5BC05871604924603F40C947F661EDCF5BC05F101E6863643F4085D4A4A938D35BC09718D386A2683F40476153F183D65BC0396C8CA5E16C3F407E3260A5CFD95BC0F0044B611D713F403BBF0EED1ADD5BC0C74B06BA55753F40F84BBD3466E05BC0AFA5BE3B98793F40B06897F596FA5BC070B51A68F7993F40C5DCD022C8145CC000D2745A5DBA3F40BA630B50F92E5CC078EECE4CC3DA3F40CFD7447D2A495CC087042ADC25FB3F406707203E5B635CC0701042E7C50D40405E8E5A6B8C7D5CC0304AAE07F81D404016AB342CBD975CC08458DB002B2E4040CEC70EEDEDB15CC0EF4006FA5D3E4040464F723646B45CC0088452F8CF3F40408E3EF29B70B45CC0D8DBFD22EB3F4040E0EC5A6B9DB45CC010A099D90740404098E56BFCCDB35CC0EC21EC117341404061AD903BEAB25CC004F7E457AF464040280C2638D4B25CC0402D54787C49404071369A125FB35CC07C976F7D184C4040C0F360255BB25CC0B06745047E4F4040E80437C904B25CC02C995B4F645040407EC8AF4090B05CC08055F3CB89524040FCFA2CF212B05CC00FAC7FF17B5340404A956E9953AF5CC0907453F8A3554040A04BF721CCAE5CC007160DB4E3574040F1E1F0E753AE5CC09C27190B135B4040571B66AC5AAE5CC080E0852F3E5B4040C0062E8021AE5CC06379B188BE5C4040C976C819B5AB5CC060D4E4BBC15F4040F0C0C61901A55CC0FC607E55735D404019F52D804BA25CC0C098B1887E5E40409F12C719ADA15CC03051B1886A604040DD60C8199BA15CC0FC2F4B22B46240403BE6C719A9A15CC060E4E5BB1565404071E52D806BA15CC074B749225067404090402E8097A05CC0D0A717EF0069404070F460B3369E5CC0DC7B7C55C76B4040BA3F61B37C9D5CC07FE3E2BB6D6D4040553E94E64F9D5CC098C94922387040405B8594E6519E5CC0787D17EF647840405962C7193D9E5CC0D4687F55FF79404027A8FA4C189E5CC0F080B2883E7B404035C9C719119E5CC0100AB2887E7C40405B8594E6519E5CC08C2A18EF1C7E40402D36FB4C1CA05CC0D4074C227C824040A8F760B356A25CC02C8F7C55878440404B53FA4C26A85CC04047E4BB3D8540402D03C719ADAA5CC03049B088EE8640408ED92D8097AC5CC0C0844C22708B4040B046FA4C60AC5CC098B4B288E28F4040DC4FFB4C68AB5CC030C94B22B0944040817960B312AB5CC0174E19EF3C9A40402EA3C719B9AB5CC0984AB288A2A14040C14BFB4C2AAC5CC0F839492260A3404001BFFA4C2AAE5CC0C8E616EF34A740406DD893E64DAE5CC0284CB1881EA94040743794E6B1AD5CC0A0667E55ABAC40407850FA4CECAC5CC098D0B0880EAE40405E0EFB4CAEAC5CC0B4B44B2228AF40400EF0C7190FAD5CC0AC9BAF8886B04040F28260B392AD5CC0284B7F558BB14040A52695E63BAE5CC0B04D7E552BB34040D3A32D8085AE5CC0F0217E55ABB44040DA022E80E9AD5CC0B02D7E5553B54040C44994E6C5AA5CC0B8CA7D55B7B54040D22B61B332A95CC044644B2280B640406D3C94E60DA85CC0B8CD4A22F4B74040C6C061B3AEA55CC0BC1C16EF6CBF40402AD293E613A55CC004477E5593C24040AEA82E806FA45CC01411B288E6C34040B99361B32AA35CC05C684A2204C6404019F52D804BA25CC01F8C7D55EBC74040396BFB4C16A25CC03807B188C6C84040C3B4C719DBA15CC01827E4BB75CA404008F0C71935A25CC0240D4B2240CD404008F0C71935A25CC0AC507E55F3CE4040D7B0C719A3A15CC00C1418EFB4CF404086D0C7196FA15CC03079492254D04040691B61B360A15CC060AD4A22C4D1404071E52D806BA15CC0AF997D5583D440402C032E801BA15CC068A0E5BBA5D740409D8C2D8067A05CC0D83518EF7CD94040CB7BC719A99F5CC0CC7B17EFECDA40408426FB4C3C9F5CC0F8EC16EFD0DC40404DFCC719EF9F5CC087B3E2BB21DF4040124D61B334A05CC028E24A228CE04040683561B3DE9F5CC04C597E552FE14040C401FA4CA69F5CC0C84CB088DEE14040C1E72D80939F5CC0FC20B0885EE34040C401FA4CA69F5CC038F5AF88DEE44040683561B3DE9F5CC018D7E3BB8DE54040FB3FFB4CA8A05CC0F07CE4BBEDE64040C53794E6E3A05CC00C6CB18806EA40401382FA4CE6A05CC0E4884A2250ED40401D6F94E605A15CC0E0F37D553FEF40400C7A2E80DB9F5CC0B08B7C55D3F040404731FA4C589F5CC0A0CEB288FEF140408F2D61B36E9F5CC0132F4C2224F34040EC1E2E80AFA05CC06FD64A2298F540404A8261B334A15CC0AFF8492204F7404071E52D806BA15CC0D00818EF80F84040DE06C71905A15CC0BCCA4B2258FB40405E012E8005A05CC0C8D17D551FFD4040BA3F61B37C9D5CC0005EAF88EEFF40401E8561B36E9C5CC0206618EFA8014140A7E793E66D9B5CC0787017EFB80341404E9EC719AF9A5CC088DC4B2234064140E4C0C619279A5CC0E08B18EFA80B41400B6261B37C995CC04C224C220C0E41405915C81975985CC0F06AE5BBD50F4140507E61B322965CC0C83B18EF0C114140BE7FC8199B8F5CC0F8C97E55CB1841402E97FA4C5A8E5CC0108FB1885A19414053862D80538C5CC0047EE3BBB91D41406620FB4C2E8A5CC088DA4A2238214140D2DFC61927885CC0C89E4A22CC23414019C160B39E875CC0889A4A2288254140426AC719FF875CC05816E4BB35284140CF1CFB4C02885CC0A7C417EFF4294140105AC7190D8A5CC080627D552B2C4140A80B61B3CC8A5CC0E849E5BB8D2D414071BE60B36A8B5CC020FA16EF6C2E414038C961B3828C5CC00074E4BB692F41401635C719D9915CC03C9D7E55DB3541408F7093E6CD925CC0749DB188BE37414052232E801F935CC0EC397E5533384140DC52FA4C66945CC04F21E6BB95394140D7F394E6B5945CC0D88D4922083A414049E961B334955CC0B8F64B22F43A414006C02D8077955CC0087CB0884E3B4140745594E6B9955CC008E0B188763B414065ED2D8007965CC0F820E6BB893B41400C3361B3DC965CC0E04F18EF983B4140C3DEFA4C48975CC02CAD4922C83B4140B255C7199D975CC05B847E555B3C4140594AFA4CDE975CC0CB4C7E55333D4140954861B310985CC0B43819EFBC3E4140CE592E8023985CC0AC5CB188F63F4140868094E621985CC0D46117EF0C4041408A1E2E80C9975CC05F6D7C55FB41414079EBF94C80975CC078A97D55DB434140C0E861B322985CC038A9E2BB2145414002BBFA4C3E985CC0A849E5BB354541408E6D93E68D985CC0A0F516EFD04741404261C7193F995CC050A216EF14494140F89194E6179A5CC0F097AF882E4A41403B49C719DD9A5CC00BBA4922484C4140524E2D80F39A5CC0F852E4BB214D41403B49C719DD9A5CC0C00616EF2C504140524E2D80F39A5CC0CCE54A2230514140B0A8FA4C2A9B5CC070ECE4BBC151414003ACC719739B5CC0E83AB2884A524140D89C94E6A19F5CC0386FE4BB756041408C27C8195DA15CC0040618EFE460414041F794E6B5A25CC08840E5BB496241408D7894E685A35CC074A67C55BB644140DD35C719A5A35CC0B0BA7D5553684140A0C594E6E1A35CC0B86A4A22E0694140EFAEFA4C64A45CC0608D17EFE86B4140E9CBC7191FA55CC050B2B088AE6D4140922BC71907A65CC03046E5BB716E41405213FB4C0AA75CC018947F550B6F4140F32CFB4C7CA75CC05C4A18EF8C704140A1A661B32AA85CC034474A22907F41409AFF61B334A85CC06CEB16EF748041405DB160B346A85CC038724A22F88141400F82C719E3A85CC02CECAF881E8641404F7561B362A75CC0A0FD16EF5C8941407E03FB4C24A75CC0687BE4BB918A41406457FA4C64A75CC0EF7018EF588C4140673494E697A85CC0C8AE7C559F8E41400F82C719E3A85CC0F4084A22D08F4140B027FA4CACA85CC038B77D558F914140FC95C71907A85CC0D8297E550B9241402298C71929A75CC0E80B17EF0C924140D5F3FA4C44A65CC0E0A3B0885A9241406F3061B382A55CC078D97C55FB9241409D6EFB4C3CA55CC0EC647E555F9341401DDC93E6A5A45CC08711B1887A98414095D960B39AA45CC02C6917EF349B41405883FA4CEAA45CC0E47AB18856A04140023AFA4CC0A55CC08CE8B18876A64140436E94E6E7A55CC0382F17EFB8A941406C39C719D1A55CC004217E552BAD41407BC560B370A65CC03CC3B18836B04140DD0E94E677A85CC0087316EFE0B64140B0A42D80A3A95CC0E81BB2880EBD41408417FA4CBAAA5CC0C06EAF882EC241403A9EFA4C60A95CC0571DE4BB61C841408C1494E6C5A95CC0C0724C22F0CD41409AEF61B348A95CC0E89916EFB8D041401AA4FA4CB4A95CC01B8119EFC8D24140A450FA4CF2AB5CC0F44117EF14DC41402E9BC71943AC5CC0A4477E55ABDE414069902D8073AC5CC0F0A97E552FE24140281795E661AC5CC0E0CC16EF44E941403826FB4C0AAC5CC0A30EB1882AEB4140F80361B3EAAA5CC040857F556FEE41402D03C719ADAA5CC08C8917EFDCEF4140C4A294E6CFAA5CC084A54A2254F14140676394E637AB5CC07853B08876F241403431C819BDAD5CC0A48C4A22D4F74140C1FE2D80ABAE5CC0C02918EFC8FA4140CAE3C71955AF5CC05C51B0882EFE4140BDE5C71971AF5CC0641EB188BE014240BC84FB4C5CAE5CC03890E3BB91034240318A2D8013AE5CC0487DE4BBF9044240F7D160B30AAE5CC0B0044B226C06424099FCC61941AE5CC0AC3CB1885A094240918BFA4C40AE5CC0EC70B288CA0A4240B37494E627AE5CC07C72B088DE0B42402135C819F5AD5CC03CDEB188760C424037422E8081AD5CC058104C227C0D4240D12695E641AD5CC0EC7CAF88EE0D4240CD6D2E80FBAC5CC070FC4B22580E4240304961B3D6AA5CC018E1E3BBF90F4240F0B294E6C1A85CC0C0B5B18816124240A8492E800BA55CC073DCE3BBA9134240F04C94E60BA45CC04459B08852144240701C2E8081A35CC0A82D4B228C144240D33661B3E8A25CC0F09318EF701442409D71FB4C7C9F5CC0587F17EFCC124240D97061B33E9F5CC04857E4BBA1124240A417FA4CE69E5CC00C077E554B12424055DE94E65B9E5CC0106118EF9811424099C993E6B19D5CC0042C7F55E7104240C8B62D80D79C5CC010BF17EF7010424057C160B3589C5CC0E0664C22581042404090C719DF9B5CC0F0D718EF5810424024B82E806F9B5CC09C714B227410424085B8FA4C109B5CC0ACC8B088AE104240279BFA4C6C995CC00C077E554B124240EBD0C61913995CC0B804B2888E124240E5AD94E6B1985CC084A34A22C0124240E62861B344985CC0BC0D18EFDC124240CA47C719D3975CC00437B188E61242400C2B61B366975CC010087F55D7124240B61E2E80CF965CC054F3E2BB791242408ADF2D803D965CC0E81619EFE4114240C97A2D808B955CC078A47D55BB1042404630FB4CEE945CC09CA418EF740F424041D8F94C74945CC0A8DF4A22380E42406E03C71905935CC08F3FB08806094240B9CA94E669925CC0B0544C2270074240DAE660B39E915CC0E0AA4B22D8054240D809C7196B905CC084BA7D5527044240D9ED93E6F38E5CC04CA64A222003424059742D804B8D5CC0D8A117EFF8024240C3822D80278A5CC03717B288CE034240553294E6ED875CC09C21B188DE05424065D62D80EF865CC0BC5E4B22740B4240E80D2E8017865CC06CD3E5BB31104240DF5EC71963855CC0C0547D552B14424015EAFA4C30845CC048C5E4BBCD164240BD9F2D80E5825CC0C41BE5BBA9194240BA6294E6BD825CC000877D55EB1A4240DD15FB4CB0825CC0D8E6E3BB211C4240D59B2D80AD825CC0E86C17EF8C214240CD2A61B3AC825CC0DCEB4A22A022424040F2FA4CAC825CC06876E3BBA12542408051C719AB825CC0A85C7D554F2A4240726F2E80A9825CC0EC3B7D555F304240EB2DC719A7825CC0CB407F558B3742401D1CC719A5825CC0C8904B22903F424000C961B3A2825CC05864E3BB21484240F84E94E69F825CC028E8E2BBF9504240AA042E809D825CC0645AE4BBD159424055BAC7199B825CC0681C7E55636242408DA8C71999825CC0536C4A22686A424046CF2D8097825CC0C4824A2294714240AAB42E8095825CC08832E5BBA5774240B11CFA4C94825CC0642A7D55537C4240A9AB2D8093825CC0E0E47E55577F42409C3A61B392825CC03840B2886680424069C794E695785CC0A81CB2886280424086952D80996E5CC00C6A7E555F804240CCE9FA4C9C645CC07FB74A225C804240617F2D809F5A5CC0EF934A225880424067742E80A3505CC060E116EF54804240FD0961B3A6465CC0D42EE3BB51804240C99694E6A93C5CC0A86AB1884E8042405E2CC719AD325CC01BB87D554B804240ACF160B3B0285CC08C054A2248804240C24E2D80B31E5CC0F0E149224480424089DB60B3B6145CC0D01D18EF408042405DD960B3BA0A5CC0446BE4BB3D804240296694E6BD005CC0A847E4BB3980424039C360B3C0F65BC01895B088368042408688FA4CC4EC5BC0ECD07E5533804240221E2D80C7E25BC0601E4B22308042406172FA4CCAD85BC0D06B17EF2C804240B63794E6CDCE5BC0344817EF288042407DC4C719D1C45BC01884E5BB25804240125AFA4CD4BA5BC088D1B18822804240661F94E6D7B05BC0ECADB1881E8042402DACC719DBA65BC060FB7D551B804240420994E6DD9C5BC03F374C2218804240C1C52E80E1925BC0449616EF14804240DD93C719E5885BC018D2E4BB11804240A920FB4CE87E5BC0931FB1880E804240B87DC719EB745BC05BEAB2880A8042408D7BC719EF6A5BC06C497D55078042405308FB4CF2605BC0DC96492204804240995CC819F5565BC0A4614B2200804240B02A61B3F84C5BC018AF17EFFC7F42407DB794E6FB425BC088FCE3BBF97F4240,-15.1%,-184,"1,036",373,663,Arizona,true
18,0106000020E610000001000000010300000001000000D1000000111494E68DA757C088FCE3BBF97F42401A222E8057B657C088FCE3BBF97F4240EA38C71921C557C088FCE3BBF97F4240727FC719EBD357C088FCE3BBF97F42407CFE2D80B5E257C088FCE3BBF97F4240CC4D2D807FF157C088FCE3BBF97F42400DC494E6490058C088FCE3BBF97F4240641394E6130F58C088FCE3BBF97F42407492FA4CDE1D58C088FCE3BBF97F4240FCD8FA4CA82C58C088FCE3BBF97F42404D28FA4C723B58C088FCE3BBF97F42408E9E61B33C4A58C088FCE3BBF97F42406626C719075958C088FCE3BBF97F4240ED6CC719D16758C088FCE3BBF97F424078B3C7199B7658C088FCE3BBF97F424047CA60B3648558C088FCE3BBF97F4240010862B32E9458C088FCE3BBF97F4240DA8FC719F9A258C088FCE3BBF97F4240DF9D61B3C2B158C088FCE3BBF97F4240B925C7198DC058C088FCE3BBF97F4240416CC71957CF58C088FCE3BBF97F424082E22E8021DE58C088FCE3BBF97F4240D8312E80EBEC58C088FCE3BBF97F4240E2B094E6B5FB58C088FCE3BBF97F42403A0094E67F0A59C088FCE3BBF97F4240BC4694E6491959C088FCE3BBF97F424094CEF94C142859C088FCE3BBF97F4240540CFB4CDE3659C088FCE3BBF97F42405D8B61B3A84559C088FCE3BBF97F42403C13C719735459C088FCE3BBF97F4240C359C7193D6359C088FCE3BBF97F4240947060B3067259C088FCE3BBF97F4240ED4DFB4C888259C088FCE3BBF97F42405083FB4C8E8259C0C48CE4BBF98B42403AF161B3948259C0882EE3BBF997424028C793E6998259C0C82FB088FAA3424092FC93E69F8259C004317D55FBAF42407D6AFA4CA68259C038C17D55FBBB42405A6794E6AB8259C004637C55FBC7424035642E80B18259C038F37C55FBD34240F0DA93E6B78259C06312B188FADF4240D348FA4CBE8259C014734C22FCEB4240B74594E6C38259C068B57C55FBF742401B7B94E6C98259C0A4457D55FB03434006E9FA4CD08259C0D4D57D55FB0F4340EA5661B3D68259C0833619EFFC1B4340461B95E6DB8259C044674B22FC274340795994E6E18259C0846818EFFC3343405DC7FA4CE88259C0C469E5BBFD3F4340483561B3EE8259C0F46AB288FE4B4340FA3AFA4CF48259C0C40CB188FE5743405E70FA4CFA8259C0F49CB188FE63434041DE60B3008359C0440F4B2200704340A61361B3068359C0642E7F55FF7B43400A4961B30C8359C03F414A2200884340B54EFA4C128359C074D14A2200944340A0BC60B3188359C0AF614B2200A04340842AC7191F8359C0EFD3E4BB01AC4340E0EEFA4C248359C01F64E5BB01B843404424FB4C2A8359C00077B08802C443402F9261B3308359C03007B18802D04340DA97FA4C368359C070087E5503DC43403DCDFA4C3C8359C0A0987E5503E84340A202FB4C428359C060C9B08802F4434085FF94E6478359C0A0CA7D55030044400DC8FA4C267459C0A0CA7D5503004440DDEE94E6BB6659C0A0CA7D5503004440FE5694E6515959C0A0CA7D55030044409D862D80E74B59C0A0CA7D5503004440F5E52D807D3E59C0A0CA7D55030044401C4E2D80133159C0A0CA7D5503004440A5A42E80A92359C0A0CA7D5503004440CB0C2E803F1659C0A0CA7D5503004440A233C819D50859C0A0CA7D5503004440C29BC7196BFB58C0A0CA7D5503004440E903C71901EE58C0A0CA7D55030044404163C71997E058C0A0CA7D550300444061CBC6192DD358C0A0CA7D5503004440715A2E80C3C558C0A0CA7D55030044400F8AC71959B858C0A0CA7D550300444067E9C719EFAA58C0A0CA7D55030044408851C719859D58C0A0CA7D5503004440E0B0C7191B9058C0A0CA7D55030044403D10C819B18258C0A0CA7D5503004440DD3F61B3467558C0A0CA7D5503004440359F61B3DC6758C0A0CA7D5503004440560761B3725A58C0A0CA7D5503004440AE6661B3084D58C0A0CA7D5503004440D4CE60B39E3F58C0A0CA7D550300444074FEF94C343258C0A0CA7D5503004440FC54FB4CCA2458C0A0CA7D550300444022BDFA4C601758C0A0CA7D55030044407A1CFB4CF60958C0A0CA7D5503004440A284FA4C8CFC57C0A0CA7D550300444072AB94E621EF57C0A0CA7D5503004440921394E6B7E157C0A0CA7D5503004440B87B93E64DD457C0A0CA7D55030044406AC42D80ABD057C0A01E7E55D7FA4340B30D2E80D5CF57C0CCB916EFDCF84340CE6A2E801DCF57C0BC4B492288F84340109361B34ECE57C070DC15EF54F843406DFD93E6BDCD57C03FECB088EEF74340A06F61B350CD57C020387F55D7F6434016CE93E611CD57C0409BE4BBC5F54340AEE82D80C7CC57C088F74A22D0F44340414A61B336CC57C0879FE4BB09F44340A6BD94E6A7CB57C0DCA1B088C6F34340CCE160B352CA57C0CCD97E558BF34340528C2D8097C957C0543DB28816F343407F4594E6E3C857C0A0CDB08846F24340F09094E62FC757C0209117EF30EF4340AC1795E6D5C557C020D049222CEE434002EDC71957C457C0FBA0B288CAEE4340D3C62D80FFC257C0D4C3E4BB25F043405E0E2E8013C157C024ED4B22C0F24340B4DB60B31EC057C08450E4BB91F34340484594E603BF57C06C29B288F2F34340107194E683BD57C0879FE4BB09F44340225BC819AFBC57C0583416EF60F343409C942D803FBC57C050964B22D8F14340CEDB2D8047BC57C0F0057F5517F043402A9861B3D6BC57C0FC117F55CBEE434050E860B3E4BB57C080AB7E5503ED434000D960B310B957C087ED4A2264EA4340EA2BFA4C78B857C094767C5513E943408622C81989B857C0804D7E55C3E7434002F3C719D7B857C0C0884B2240E54340F42AFB4CE8B857C0D7BF7D55CBE34340B262C719ABB857C0385D7D553BE2434095312E8031B857C04824E4BB51E1434062D8C619D9B757C080C17E556FE043404CC2FA4CFEB757C024C94B22FCDE4340AAC42D8003B957C048AE7E5563DD4340D093C7196DBA57C0842917EF90DD4340107194E683BD57C024C94B22FCDE4340744594E609BE57C06814B1888EDE4340F16E94E661BE57C0A06BB18882DD4340A52B94E691BE57C0A806E5BB35DC4340A25061B3C2BE57C0D42FE6BB15D94340C188FB4C22BF57C02CC0E4BB45D84340AEE560B3B0BF57C00B2F4A22DCD743405CD093E65FC057C0488FB0881ED7434052CCFA4C6AC257C0ACBE7D55F3D343402896C7196FC357C0ACEAE2BBC5D14340766561B3DEC357C054FFB08892CF4340D0FDC619CDC357C078604A22D0CC4340AE4A60B3DAC357C0285CB28862CB4340626961B316C457C06483492254CA4340083CC819CFC457C010437E5597C94340D24F94E681C657C08CCD7E556FC9434090C5FA4CF8C657C0A8F4B0880EC94340BE26C71913C757C03078E4BB71C64340A43CC71953C657C00C25B188DEC34340723BFA4C2CC557C0C490E4BBE5C14340626961B316C457C02CF716EF1CC14340166494E6B1C357C0640018EF24C0434098D9C71945C257C0D054E6BB95BB43405E562D80A5C157C068BB7D551FBA4340086DC71923C157C010D217EF9CB94340E48CC719F5BF57C0BB5C7D55C7B84340CDA860B346BD57C0903D18EFC0B54340349FC71909BD57C01498E5BBFDB4434093F893E6B3BC57C08857B188F6B24340A6D1C61967BC57C0EF6FE4BB41B24340CC9261B394B957C0B89CE5BB4DB1434046A2FA4C26BA57C038A6B088FAAE434054EE94E6A9B957C0AC6A4A22E0A943407AF894E641B857C010BE17EFC4A443408E3061B310B657C00C27B18872A2434005DD2D8071B557C088C1B18836A14340C65A94E65DB557C09C517D55839E43404ADA93E617B557C014D04A22D09B4340A2712E80E1B357C030ED15EF949A43404A2761B396B257C0FC1618EFF499434072DFFA4CC2AF57C09BF0AF88069743400A37C71957AE57C0574CE3BB21964340ADC061B35CAC57C0E4A4B2883E964340FE8D94E667AB57C0807016EF1496434092CCFA4CC2AA57C020B7E3BB2D9643404EEAFA4C72AA57C0574CE3BB219643407455C7191FAA57C0A89DE5BBBD9543408603C819FBA957C07C54E3BB9D9443406E8294E6C5A957C0788CB18862944340CC7894E63FA857C09C7C4C2230944340CDD893E633A757C098587E558F934340AD9894E611A757C02498E3BB7992434050F893E6F9A757C04CA0E3BBF5904340C02B94E6E3A757C0F04E17EFC0904340C02B94E6E3A757C0F8A5B28862904340562CC719D3A757C090EB7E55EF8F4340747FC71989A757C00F647D55C38F4340747FC71989A757C0C8307D55DF8E4340747FC71989A757C010A017EF80854340747FC71989A757C0C479E3BB29754340F4B72D8089A757C057004A22D06443403420FB4C8AA757C068574B22785443403420FB4C8AA757C09CEFAF881E4443403420FB4C8AA757C03CE7E2BBC53343404191C7198BA757C0503EE4BB6D234340C2C92D808BA757C05495E5BB15134340C2C92D808BA757C0F41B4C22BC024340C2C92D808BA757C097137F5563F24240490294E68BA757C03C7C7E550BE24240517360B38CA757C0ECE47D55B3D14240517360B38CA757C08CDCB0885AC14240517360B38CA757C0A0A47E5503B14240517360B38CA757C0342BE5BBA9A04240517360B38CA757C0E493E4BB51904240111494E68DA757C088FCE3BBF97F4240,-45.7%,-142,169,31,138,Kansas,true
16,0106000020E610000001000000010300000001000000AE0100006FE301BD963355C034D63FEC30D944406FE301BD963355C09C47DEEE05CF44406FE301BD963355C0709B8FF4BBC4444012BD15C0773355C0687BF6155BB9444012BD15C0773355C040DB961830AF44401A6DC719393355C090937F5597A54440FE2A2D80473355C03C7D16EF2C9B44404466C819553355C0C0254A22C4904440A2EBC719633355C04C5DB1885A8644400071C719713355C0CC9418EFF07B444064F6C6197F3355C0ECDD7D5587714440F472C7198D3355C06C86B1881E67444090EFC7199B3355C098CF16EFB45C4440EE74C719A93355C018784A224C52444084F1C719B73355C0A8AFB188E2474440E276C719C53355C0C469E3BB793D4440836494E6D33355C048A14A22103344409B19FB4CE23355C0C7D8B188A6284440FA9EFA4CF03355C0541019EF3C1E44408E1BFB4CFE3355C0F4F9AF88D2134440F2A0FA4C0C3455C0743117EF68094440C9ED93E6193455C010DA4A2200FF43401E9AFB4C283455C09011B28896F44340F4E694E6353455C0B05A17EF2CEA4340596C94E6433455C03C034B22C4DF43403E2AFA4C523455C0BC3AB2885AD543404C6E94E65F3455C04CE3E5BBF1CA43406A23FB4C6E3455C0FC3D492288C043403F7094E67B3455C08875B0881EB643405C25FB4C8A3455C00C1EE4BBB5AB4340BAAAFA4C983455C087E47E554BA143401830FA4CA63455C098BC17EFE09643406BDC61B3B43455C0C4764922788C43406A09FB4CF03555C07CC916EF448B4340FC1D61B3E03755C094364B22E4874340BA78FA4CB83755C06C86B088C6834340223061B3EE3555C0506CB188D68043405E6BFA4C003555C05090B188E67E434026AAC719A93455C018F8E4BBB57C4340926B61B34E3555C0405A7F557F7A4340D497C719953755C073454B22F8764340C677FB4C283855C0E45C7D55B7754340BE1694E65F3755C07C124B2220744340A0732D80593655C08C2BB1885A73434018CF2D80913355C05C8D4B22187343400C5CFA4C2C3255C028D07D554B7243405A5861B3423255C0004117EF6870434018FAFA4C1C3355C0D4A84A22386E4340A30695E6013455C0A0D04A22806C434024142E80773455C07C2F18EF006A43400AAE60B3983355C0FCDFB188C265434038A6C719713455C048044A2208654340F22A2E80AF3955C0F4134A22E8654340C857C719E53B55C0DB71E4BB6D654340A2D5C719F73F55C0AC6CB088C6624340E24E94E64D4955C04CDF17EFB059434038E0C619E74B55C0F73A4B22CC58434016992D80274D55C0FCED16EF045A43400AD22D80594F55C0106A19EFFC5D4340011B2E80775055C090A3E5BBD55E43401E69C719895455C0A01D18EF245F4340662761B3E85B55C0E8B6B2880A5E4340DA51C719195D55C0236D7D55FB5C4340C4C82E80215D55C0F07D4B22905A43406765FB4C9C5C55C023737E55E3574340F0BF2D80255C55C070B918EF18564340A27DC719995B55C0073E16EF384E4340EC1EC719415A55C0988AE4BB394943400C3494E68B5A55C090E2B288D646434026EA60B3725B55C0E811E5BBF1444340307AC819DB5E55C044F5B088FA404340E0FA94E6BB5F55C074DAE3BB613F434044A4C719B76055C0F0A7B188263D434066EE2D80B36155C0E02318EFFC3B4340A86994E6716455C024FEB0888E3B4340B1B9FA4CC26555C0001B17EF003B4340FEA4C719A96755C0E8C618EF483743401A6D60B32C6955C0440CE3BBF92B4340176FC719916A55C0F840B1889E274340BC802E80D56C55C06419E3BBD1244340CEE860B31C6E55C0188F7D55B323434070C694E6877055C08CC97C5587224340086F2D80457155C040E117EF90224340613CC719997155C0FCCA4B22B02343404242C719ED7155C0204F4A222C244340F84FC719B17255C0DF14B088AA2443409F5FC719917355C0F411B188FE244340D2C194E6377455C0F411B188FE2443402C872E80157555C0348B7D557B23434032F160B3787655C078454B22341E4340825694E6197755C0931417EF0C1D434041E7C7192F7855C0089A16EF201C4340DC0B2E800B7955C06891B088DE19434072802E80A37955C09840492208174340A8E860B3F07955C0E43B19EF64144340BE24FB4C887A55C0946018EF24084340B01EFB4C2E7B55C010AFB288D60443403EFD61B3947B55C0D88317EFB40343404C0D2E80157C55C0301016EFAC024340C6E693E6B17C55C0DC89B088C6014340C87D2E806F7D55C05002E5BB01014340497B93E68D8055C028B17D551F004340EB3494E60B8255C0E47D7D553BFF4240C2D22D80AD8255C0F09D7D5513FD42406C32C819498355C0288917EF1CFC424025C360B3AA8455C06855B288DAFD4240D41161B3168755C088D5E3BBF5014340EEBF2D80878855C0800517EF9002434052E6FA4CC28B55C04C8B7F55EF0243408ECB60B3068D55C06B627E551B04434032B02E800F8E55C050E5B18866054340F15394E6999055C04454E5BB8D0743403E742E809D9155C0C8FF7E55F3084340D550FA4C349255C0B8D618EFCC0A4340C1E12D804F9255C028BE4A22C80C4340DADD2D80179255C0FFFC7D552B124340D42E2E80AB9255C030EFE4BBA9134340CE21FB4CFC9555C014F87D55CF174340A0AE93E6259755C04849E5BBB1184340249060B3809855C0C05EE3BBE918434074A794E6359955C0881F7E550B184340F27E93E66D9855C0306BE3BBA9154340120561B3249755C0BC76B0886E144340BE6A94E6D19555C0D0174B22C4134340DCCEFA4C4C9555C0D0EA16EFD41243407232FA4C6C9655C043BCE4BBD110434026AB2D801F9955C0546819EFFC0E4340EAC094E6A19A55C05FE14A22C00E4340F689C719699B55C0F04EE5BB250F43401E6961B3BE9B55C0F85416EF601043400E51FA4C149C55C098C716EFDC104340D07FC719D19C55C0B0CD7D557F11434061B793E68D9D55C040917C559311434042C694E6E39D55C0F85416EF60104340375D2D80A59D55C01C504B22040F43405AA6C619819C55C0F06EE5BBFD0C4340F81761B3249C55C05F407D55930B43402045FA4C669C55C010544A22D4084340B658FA4C7E9D55C0B40918EF3C0743406EA494E6F59E55C06F1CB2888206434014E2C71955A055C07CC415EF54064340A09561B330A155C0FCF2AF882E0543402C48FA4C80A155C0B8FA17EF74024340DB67FA4C4CA155C0C40D4C220CFA4240505461B37CA155C02CF0E4BB19F842400B2C2E804BA255C0379CE3BBDDF642409EB5C719BDA555C08C12B188AEF54240560861B31EA655C02CAD16EFC4F3424000BEFA4C1CA655C040957E553FF14240A4F1C619A1A655C0801E4B22A8EE4240040661B3F6A755C098784A2248ED42408403FA4C80A955C0F0837C5553ED42400A6093E66DAA55C0708AB18892EE4240A0E493E6F1A955C0D84B17EFCCF0424014ADC71935A955C0089F4A2260F34240FA86FB4C6EAA55C080ED17EFE8F34240D93F2E8043AD55C04C2BE4BB05F342409C4BFA4C80AF55C0A85AE4BBB1F342404454FB4C76B155C02037B2883EF64240522FFA4CDAB255C0EC99E5BBB1F942403AD494E661B355C0F09D7D5513FD4240E6172D8067B455C0C8E17E5563FF42408B8294E6B5B655C098AD7D55F3FD42406E8961B32AB955C0F05D7C55FBFA4240EC6C2E80A1BA55C00C2018EFB4F842408C0261B37EBB55C038AFB08806F84240A9EE93E637BF55C0930818EF64F742400E6D94E65BC055C0FCFD7D559BF6424093702D803FC155C054CBB088A6F54240AC632E8001C255C0A05BE5BB3DF44240141EC719C1C255C0147BB28826F24240B11661B382C455C060134B2218EA4240B2AD60B38CC555C00CDC17EF18E7424028922E808FC755C0A890E4BBF5E442407A112E8043C855C06C3CE3BBADE5424040AA61B3CEC855C0D8F317EF74E6424096E2C719C9C955C058CFE4BB75E84240FE202E801DCA55C030F216EFD0E94240B21361B342CA55C09C5B16EF44EB42409A312D808DCA55C0906EE3BB6DEC424048CE60B350CB55C024FF4A22E8EC4240663D94E67DCC55C008E07D550BED4240002CC71965CD55C01C0CB1886EED4240D8932D8011CE55C0FC89E3BBF5ED4240124FC71957D055C0C4CC7E5567F0424062D3FA4CACD455C08495B18822F34240556CFA4CD2D555C00CDD492260F442408876C819FBD655C0F3F716EFF8F542406C2D94E66BD855C07C374A2274F74240AA7B61B3EED955C0C062E5BB95F8424019C293E64DDB55C0E3B64B2224F942400529C719FFDD55C038C1B2880AF8424022B42D80A3E055C0C34D4C22BCF542404473C71921E355C0909CE3BBE9F44240B0C360B35AE555C0301818EF44F84240FA3294E68DE555C0F8C417EF88F94240068A94E67BE555C05C8117EFACFB4240B61B62B3D4E555C084847F55A3FC424060F62D804FE655C0D0274B22FCFC424052D661B3E2E655C0C070E4BBD1FC4240C4C22D805FE755C08CD17D5503FC42401E14FA4C94E755C0A045E4BB69FA4240E87594E651E755C018EFE3BB8DF742405EB093E625E655C0000CB288D6F34240B61B62B3D4E555C06CB9B18832F14240C668C7197DE655C0B89818EFB0ED4240EA26FB4C22E855C0A48FE4BBD1EA42409C3EC7190DEA55C068C44A22A0E942408A7861B382EB55C0D0DF4A2228EB4240FE0BC819A9EB55C06CFDB1881AED4240BCBE60B3FEEA55C0EB9A17EF44F142403602C8191DEB55C04C2BE4BB05F3424065F12D80F3EB55C03027492214F44240200894E605ED55C094407D55EBF3424002F32D8003EE55C01419B38816F34240A0D8FA4C9CEE55C0147BB28826F24240442F94E635EF55C094874A2210F2424036CAFA4CC0F155C01CD04B22B0F0424072AF60B304F355C0C4CC7E5567F04240448493E673F455C0C898B088DAF04240A25B94E6A1F555C0481817EFDCF142403DBD93E6A5F655C0BF04E5BB55F3424084C361B396F755C06852E4BB35F54240B06D2E80CFF855C02C2B17EFDCF6424051AB61B32EFA55C02075B1883EF742408CC4FA4C4CFB55C0200880552FF6424044C994E6C1FB55C0D0BB4B2280F34240EB15C71981FB55C048F54922C8F14240261361B392F955C09B7D18EF34EA42404D21FB4C88FC55C0088B4B22F0E44240A8E593E6D9FC55C070E0B28816E442408E66C71909FE55C0C0B716EF94E442405E4561B3520056C0B38A4B22E4E64240CF55FB4C700156C0B030B18896E74240889894E6E50256C010937E5543E742408204C719650456C0643CB1883EE84240F4902E80A10556C04CCFE4BB75E842405E4261B3120656C0A8317C55BBE842409A90C7194D0656C0847F16EF54E94240A20194E64D0656C0D02C7F55EFE942401069C719110656C09B7D18EF34EA42408BE8FA4C360456C0C3CC7D55FFE94240283FC8193B0356C0F0C57E551BEA4240D206C7198D0256C04CC0AF88AEEA42406E56FA4CF40256C0F0D0B0881AEC42408A8060B3180656C04CBCB088DEF04240264461B3280756C0402BE4BB05F34240329793E64D0456C03FB0B0882AF24240B66D2E80A90356C0077BB28826F242406A4D94E6A50256C084B47E55FFF2424098342E80710256C094407D55EBF34240042195E6A10256C07823B28826F54240949694E6C90256C010E97C55EBF64240A23394E62D0356C05C24E6BB89F94240FE9EC719290356C06FD4B28816FB4240D206C7198D0256C060867D55C3FB4240BE1BC8193D0256C06813B388A2FC42401630FB4C4A0256C020847F5597FE42406669FB4C880256C0B0D57E55AF004340949694E6C90256C07CD5E3BBF50143400295FB4C020256C0475C17EF7803434056AA94E6E70256C02C27B1889E064340B62E2E801D0256C06C514B2234074340BC3E2E80090156C070E9E4BB81074340663AFB4CE8FF55C027297D554F084340F6F32D80D5FE55C0704216EF6C0943403088C719F1FD55C00B1F7F55B30A4340FCBDFA4CE0FE55C0E741B1880E0C4340898461B3E40056C0B86217EFB80B4340F4F760B3EA0156C0EF017E55870C43409720FB4C700056C0F4154C223C0E43402260FB4C0EFF55C0F85416EF60104340213C2D806DFE55C064E97D551311434000E760B306FD55C04FF6E3BB99114340A86961B36EFC55C0F4FC7D552B124340A8F593E6C5FB55C0E8BDB088761443407FD9C71991FC55C0D0F74A22EC1543402E4B2E80C9FD55C07C5EB0880617434084212E806BFE55C0D3FF7D553F184340EBE3C619A1FE55C0D08616EF141943408E06C81915FF55C078854B22E419434078F060B386FF55C0DC9F4A22E01A4340006F61B3B0FF55C0E027E4BB411C4340B08560B37AFF55C0BC137F55CB1D43402AC8C6190DFF55C010A64922AC1E4340CC1D95E681FE55C043A5B1886A1F43403088C719F1FD55C028E24A228C204340AA0061B378FD55C06B99E4BB9922434064C560B31EFD55C070C7E3BBAD244340383661B384FC55C0906B4B22402643402E98FB4C48FB55C04431B188BE264340F3862E8035FB55C07FF118EFF0254340502794E699FA55C06CE14A2274244340C6B994E6E7F955C09C527C55C72343400EEB2D8067F955C08F487E552B2643402CC260B3FEF855C068D316EF38274340E049C7197DF855C074E2E3BB29284340A09BFA4C06F855C034857C5593284340001894E6C5F755C0801F18EF042843406E31C8199DF755C0FCB918EFC82643405C0795E655F755C0086617EF8C25434077482E80BBF655C0F411B188FE2443403A642E804FF655C06CF417EF9C254340629BC71923F655C0B899E5BB0D274340FC4BFB4C0AF655C0DC3C16EFAC284340B4DCC719D7F555C060914A22D8294340FC302E806BF555C0549CB2883E2B43400FCBC719DBF455C0386FB188262E43406E8EFA4C54F455C064AF17EF902F4340D2CBFA4CD0F355C0DF917E552F30434078DA2D808FF255C084EA17EFE4304340BA6DC8191BF255C0B45D4B2250314340740EFA4C20F155C0A457B2883E334340A60EFA4C26F055C0CCFCE4BBF53543407D3861B3D2EF55C0FC4F18EF883843408B972D80CBF055C0C84718EF0C3A43408B972D80CBF055C0001B17EF003B43405C5FC719D7EE55C054E2B088FA3B4340D59860B3D2EC55C0084A17EFA03D434016002D8047EC55C0BB0718EF5C3E4340D46BC71997EB55C01449E4BBA53F43403602C8191DEB55C0E4967E553F404340AE0795E687EA55C0D8C5B0884E404340F81CC71925EA55C0A41EE5BBBD3F434000C461B3CEE955C07825E4BBA13F4340EE5394E65DE955C08C83B1880A4143403C9EFA4C60E955C0D8C87D558B424340368EFA4C74EA55C044F74A223C4543402A03C719ADEA55C0B4D217EF3C4743401818C8195DEA55C034FCE3BB29494340647D94E6B5E955C0AC65E3BB9D4A434082D894E6E1E855C000624C22B04B4340693C94E60DE855C0A8BF4B227C4C4340BEB22D8073E855C0A8BF4B227C4C434026A093E633E855C08CF27D55C34C43402ABAFA4CFAE755C05C487D551F4D4340601261B3C6E755C0A74F4A22A04D43401E14FA4C94E755C088317E554F4E43409AEDFA4CE4E755C01C61B188DE504340E83F61B35CE755C0304F7D556B5343401A4061B362E655C0232F7D5593554340B0C360B35AE555C0A8694A22F85643406E7FFA4CB2E455C054B57D55275743403D3794E6D1E355C044D3E4BB25574340C99161B30EE355C058AD18EF64574340EFFC2D80BBE255C0741BB08852584340A29E94E6B7E055C048A0B088B661434012EDC6198DE155C0C4477D55BB664340C0A4C719EFE255C0C02B4B22AC6B4340E035C719A5E355C0C40B19EF647043407A732E806FE355C0F86E4C22E47143406C2E2E8089E255C0940E4B22E87343409C8694E655E255C0B4DDE4BB517543409C8694E655E255C0346B4A22907A4340EA8260B3B8E255C0305C4B22307C4340366E2D809FE455C08073B088C67E4340B0C360B35AE555C048664A22348043407C0A95E6C1E555C0BC87B1885E824340BC6161B34AE655C0A813E3BB218743403094C719F1E655C07FF27C556B89434050EA94E6E3E855C0905216EF848C4340FC1361B3D6E955C05CD97F556F8D4340473CFB4C50EA55C00862B188128E43402A03C719ADEA55C0E8FE4B22248F4340FB252D8073EA55C02B5AB2880A944340B04094E651E655C0F44EB088529A4340D2F3FA4C44E655C004F8B088D29F434082C5C719B9E755C078884B2224A4434038F593E605E855C0DC6718EF5CA643406807FB4C5CE755C0ACC0E4BBF5A84340AECDC71935E655C09CC6B088DEAA43409C8694E655E255C018ACE4BBB9AD4340CA142E8017E255C0ABD0E5BB49AE434076CAC71915E255C03814B18826B343402E2761B308E255C0401419EFB0C543401DECC719FDE155C074377D553BD843405EF293E6F1E155C01049E3BBC5EA4340C87E94E6E5E155C018494B2250FD4340FF1394E6D9E155C0BCCB7D55DB0F4440F2D8FA4CCEE155C0C4CBE5BB65224440E19D61B3C2E155C060DD4B22F0344440143361B3B6E155C074BF4C227C4744404CC860B3AAE155C0AC537D55075A4440C3C52D809FE155C05465E3BB916C44407E9393E693E155C05BD617EF1C7F4440201795E687E155C0F4E77D55A791444057AC94E67BE155C0FCE7E5BB31A444400F7AFA4C70E155C0A46A18EFBCB644408877C71965E155C0DBFE482248C9444039D460B358E155C0E48DE4BBD1DB444039D460B358E155C0BF666B451FDD4440C18ACFC098DF55C0A82B681357D94440062E793E5DDD55C07B4C4275DAD644402C07568D4FDB55C0C715071F0FD844405E63D70387DB55C0DB500CA158D54440DE972D4413DB55C010BC9D37B0D344404FB43D7A18DA55C07FD8AD6DB5D24440F9A19E2CB1D855C068B444DEEAD144409CC66DAEAED255C07492C0645FD04440935A6579E8CC55C0702914E446D144401A24EE82E5C155C014A5014531D7444016B5F927F5B555C0143FF93C39E14440F62F94E611B455C058F017EF38E1444048D560B31AAF55C0E790492238E144405239C81923AA55C0D7AEB08836E1444074E793E62BA555C0BCCC17EF34E14440FE8361B334A055C0ACEA7E5533E14440DE6194E63D9B55C0ACEA7E5533E14440360761B3469655C0AC79B28832E14440C2A32E804F9155C02CA917EF30E14440E251FA4C588C55C02CA917EF30E144403CF7C619618755C01CC77E552FE14440C69394E6698255C0AC67B0882EE144401E3961B3727D55C0A0F6E3BB2DE14440AAD52E807B7855C090144B222CE14440D083FA4C847355C01044B0882AE144402A29C7198D6E55C010D3E3BB29E14440B4C594E6956955C0F36117EF28E144400E6B61B39E6455C0E40EB28826E144402D192D80A75F55C0E40EB28826E1444040EE60B3B05A55C0C82C19EF24E14440125BC719B95555C058CD4A2224E144409CF794E6C15055C058CD4A2224E14440FC0D2E80CB4B55C0535C7E5523E144409D8393E6D34655C0D88BE3BB21E144402E2061B3DC4155C0C8A94A2220E144407FC52D80E53C55C0B8387E551FE144405A3294E6ED3755C048D9AF881EE144406FE301BD963355C0805F1F240FE144406FE301BD963355C034D63FEC30D94440,-16.1%,-127,663,49,614,Indiana,true
29,0106000020E6100000010000000103000000010000007301000088C494E6E31E58C0F0EF18EF58424540B07C2E800F1C58C0687918EFA4414540CD9994E6871A58C040BC4A22D8404540B04D2E806F1958C013B07C55933F4540711A2E808B1858C04C88B1884A3A4540A16294E66B1958C0371CE5BBA5344540AEE5C719BD1958C0C4187C553B2F45402CCD61B3941758C06337E3BB512B45407AEBF94C801758C0F04A4B2240294540E0FCC619991658C08CCC4A221C28454023A1C719E91558C09FAC17EF6C264540AE27C819891558C0A05B4B224424454002F660B36C1558C0784DB1884E214540297CFA4CB81558C090C315EFD41E45405C62FA4C401658C09CD7B088B21C45401681FB4C7C1658C050A6E4BB551A45409E5F60B3E61558C0A4224B2238174540A6B5FA4CFC1458C0449AE3BB391545408158C719D71258C098437E550B134540315494E6B51158C094047E557F114540E23C60B3001158C0548A18EF4C0F4540D2E7FA4CE21058C0180CB388E20C4540042FFB4CEA1058C0A09B4B22400A45401CD2FA4CA81058C0B4684B2268074540143394E6DF0E58C0AC494B22B4034540C4602D80330C58C0A88F17EF4C0145403A9160B3E00958C0902719EF70FE4440FEA3FA4C260958C010CE4B2258F94440646F94E65D0958C02BEB16EF1CF84440427EFA4C000A58C0EC674B229CF5444020D494E60F0A58C030C3B0881AF44440CD9A94E6D10958C0AC807E55F3F24440481B2E80CF0858C0441D18EF90EF4440985C2E80830858C0ACC47E55DBEE4440EB64C719BD0458C0145CE4BBD1E84440562FFB4C1C0458C09853E3BBE1E54440F6A960B35A0458C0F4F317EF64E34440B64B95E6E70458C000B016EF14E14440BAC5C719370558C0340EB188A6DE444072D261B3220558C090837D55EBDC44403AB893E60D0558C0CC66B28832DC444052E0C619390558C00CDD49229CDB4440A09EFA4CE40558C0EC307D5547DA4440CAA061B34E0658C0B4AB7D553FD94440B0D193E6790658C07C55B08846D84440F0032E80850658C034887C55D3D24440CAF060B3560658C0083EE5BBF5CF4440A64EFB4CDC0558C08859B288A6CD4440F735FA4CFA0458C0DC26E5BBB1CC4440621BFB4CF80458C0243DB18892CB4440C4B261B3560558C0C8C54A220CC94440C28F94E6410558C0072C4A2260C644407E1695E6E70358C000ED4922D4C444401EF1F94C1A0358C0E75CB088F6C444408CC12D80D30158C0C03FE5BB31C64440FE1FFB4C480158C0B4D77E557FC644405883C719850058C02CF917EF18C64440702EC719B9FF57C0885AE4BB39C5444013D494E635FF57C0ECBBB0885AC4444029D9FA4C4CFF57C0C83C18EFF4C34440DAE7F94CA0FF57C0CF8916EF54C34440A6D52D80FDFF57C0D8F0B188E2C144400DC494E6490058C0446BE4BB3DC044405D81C719690058C05B0B7E5507BF44406E372D80070058C0D89C18EF7CBD4440686CFA4C24FF57C0302D17EFACBC444046C0C61987FC57C05C59E5BBC9BB444076BFC719FDFB57C0B06417EFD4BB4440562E2D8093FB57C02038B18882BB4440ACFC60B32AFB57C0705C7F552FBA44401E6EFB4CC8FB57C08CE017EFF0B4444081A3FB4CCEFB57C02359B1887EB3444048212E804FFD57C060877C5553AB44400F932D8045FC57C00C667E5573AA4440E2BCC61961F957C0F87317EFF4A84440DA0BFB4C44F857C0CCB74A22B4A844407C85FA4CAAF757C03CF2492288A744404EC42E809BF857C06C3F19EF08A544407EAB94E6FBF957C0946CE4BBB9A24440089361B3B0FA57C01CFB49221CA244408EF9FA4C30FB57C05F817F55AF9C4440246BFA4C20FB57C0C48E4A22949A4440825BFA4C40FA57C0E891E4BBF998444068EAFA4C62F757C0282E7E558B9744402D4B94E693F657C0F0A87E5583964440969CC71911F857C0A78FE5BB65954440B696C719BDF757C02C5417EF7493444010862D8099F757C0485C4922608F4440F6FD93E631F757C03CB518EF888D4440E4E62D8013F857C0707D17EFEC894440F1832D8077F857C06314E6BB15894440F1832D8077F857C04B39B1884A88444041C52D802BF857C0E4534B2200884440AC2E61B30AF857C0080AB1889E87444078C493E6EDF757C0C873B0881E87444042262E80ABF757C00768B088768644408B9460B352F757C0141E4C227C85444042AA60B38CF757C0548F7D55CF844440705CC819EFF757C03CE917EF1C844440969CC71911F857C0D8AB4B220C834440BC0794E6BDF757C0A84818EF8C8144400AE92D8035F757C05FF24A2294804440EC4CC81915F657C0B4BE7C55137F4440F0BE93E6A5F557C0F48FE5BBBD7D44408318C7199FF557C09B5FE4BB857C4440AADD94E6E1F557C0303117EFD47944406802FB4CC4F557C09C0B4B222078444087ADFA4CF8F457C034114C22FC744440D361C719C9F457C0886AE5BBC9714440926461B322F557C050DA7D555B6F44408A9294E6A1F557C0F437E5BBFD6C4440AADD94E6E1F557C0945F7C55FB694440849494E6BDF557C0A71417EF74684440ADF6FA4C1CF557C004FBAF88BA66444087ADFA4CF8F457C068F9B188A6654440C65C2D8047F657C0570AE5BB8D6244407636FA4C32F757C01CD6E3BB1D6144400031C8197BF757C0689BB1886660444042262E80ABF757C0B83CB1880E5F4440086E61B3A2F757C048CA4B224C5D444030D92D804FF757C0CCA9AF88465C4440B85F2E80EFF657C050E1AF886E5B4440CCB42E80C1F657C057BD17EF345A4440988894E60FF657C010667F5517584440C6482E80B1F257C0481B7F55E3554440A00F2E8079F157C044C217EF905444403AC861B3D6F057C0CB8EE4BBC9514440AE38FB4CE8F057C0A34316EFF84E444072B6C61921F157C0605D4A22DC4C4440A00F2E8079F157C0CCD5B08886494440EAD660B32AF157C0F4B817EF3C464440737F2D8053F057C0482FE5BB0D4544409EC6C61913EF57C05F5617EFAC444440E46961B38AED57C0C4B7E3BBCD43444082B72D808DEC57C0406C4B2258424440C676FB4C7CEC57C0BB317E55F340444068F160B3BAEC57C07C5D7E55733F44403B5A61B3AAEC57C000098055AF3D444002AA94E617EC57C03C38B288CA3B4440EC042E80F5EA57C058C97E55A33944404E9B2E807BEA57C074EEE4BB913744406C9593E673EA57C05CB4E5BBC9364440124D2D808DEA57C0505A7D55EB3444404E9B2E807BEA57C0435DB288FE3344404CE2C71935EA57C0B4DD4B22FC32444021C593E62BE957C034C4492294304440ECF8FA4C6AE857C0986B18EFB42C4440AA5394E641E857C06846E4BB352C4440D2322E8097E857C088EFE3BB4D2B4440283F61B32EE957C0EC50B0886E2A4440027394E601EA57C0D053E5BB812944409A1161B398E957C064F24A22D0274440D8D92D808DE857C0746B7C55932744403245FA4C40E757C068924922E02744408E9D60B312E657C090A5B188C22744403E992D80F1E457C0C827E4BB8D264440B4F5FA4C4AE457C094A1E3BBF9244440C16EC719C1E357C03494E5BB3D2344407FAE93E6F9E257C064564B22902144401E5560B306E257C00493B188CE2044408414C719B3DF57C05824B1888A2044406EC860B39ADE57C0145A18EFE41F4440B16C61B3EADD57C073BAE3BB791E44406CB694E6FDDD57C098404C22E41C444041D060B30ADF57C0EC0AB288B21944407299C71943DD57C0A4FAB08852164440A4BC94E65DDC57C00486E4BB25144440663195E6FBDB57C0E0D816EF441244404CDBC71909DA57C08872B188360F4440C20CC819D7D957C0BC95E3BB9D0E4440947E2E8015DA57C0EC72B188420D444032B4FA4CB6DA57C0A012B388D60A4440923195E601DB57C0C4C14B220008444098CD93E6D9DA57C0DC2F4B22C4054440F28960B320DA57C0D8A24B224C044440983DC71925D757C0B0337D556B034440262D2D8007D657C078607E5577024440B87B93E64DD457C0A0CA7D5503004440921394E6B7E157C0A0CA7D550300444072AB94E621EF57C0A0CA7D5503004440A284FA4C8CFC57C0A0CA7D55030044407A1CFB4CF60958C0A0CA7D550300444022BDFA4C601758C0A0CA7D5503004440FC54FB4CCA2458C0A0CA7D550300444074FEF94C343258C0A0CA7D5503004440D4CE60B39E3F58C0A0CA7D5503004440AE6661B3084D58C0A0CA7D5503004440560761B3725A58C0A0CA7D5503004440359F61B3DC6758C0A0CA7D5503004440DD3F61B3467558C0A0CA7D55030044403D10C819B18258C0A0CA7D5503004440E0B0C7191B9058C0A0CA7D55030044408851C719859D58C0A0CA7D550300444067E9C719EFAA58C0A0CA7D55030044400F8AC71959B858C0A0CA7D5503004440715A2E80C3C558C0A0CA7D550300444061CBC6192DD358C0A0CA7D55030044404163C71997E058C0A0CA7D5503004440E903C71901EE58C0A0CA7D5503004440C29BC7196BFB58C0A0CA7D5503004440A233C819D50859C0A0CA7D5503004440CB0C2E803F1659C0A0CA7D5503004440A5A42E80A92359C0A0CA7D55030044401C4E2D80133159C0A0CA7D5503004440F5E52D807D3E59C0A0CA7D55030044409D862D80E74B59C0A0CA7D5503004440FE5694E6515959C0A0CA7D5503004440DDEE94E6BB6659C0A0CA7D55030044400DC8FA4C267459C0A0CA7D550300444085FF94E6478359C0A0CA7D55030044408C7061B3488359C0F014B188020844408C7061B3488359C0305FE4BB0110444094E12D80498359C080384B2200184440D949FB4C4A8359C0B311B288FE1F4440D949FB4C4A8359C0035CE5BBFD27444062F32D804B8359C053A618EFFC2F44407064FA4C4C8359C0A46118EFFC374440F19C60B34C8359C0774C7D55FB3F444078D5C6194D8359C0C796B088FA474440B13D94E64D8359C0077017EFF84F4440B13D94E64D8359C047497E55F7574440EFA561B34E8359C09793B188F65F444077DEC7194F8359C0F8BF7D55F767444077DEC7194F8359C0382818EFF46F4440F8162E804F8359C07C724B22F4774440BEB761B3508359C0BC4BB288F27F444006F6FA4C7C8759C0BC4BB288F27F44406E6760B31A8F59C0BC4BB288F27F444038C7C719B99659C0CCBC7E55F37F4440D02F2E80579E59C0D89E17EFF47F4440EA5F2E80F5A559C0D89E17EFF47F44404BD193E693AD59C0D89E17EFF47F4440640194E631B559C0D89E17EFF47F444036D2C719D1BC59C0D89E17EFF47F4440C8C961B36EC459C0E880B088F67F44402F3BC7190DCC59C0F8F17C55F77F4440C8A32D80ABD359C0F8F17C55F77F44405C0C94E649DB59C0F8F17C55F77F4440AC3395E6E7E259C0F8F17C55F77F444095DD60B386EA59C0F8F17C55F77F4440B47E2D8025F259C068514B22F87F44404076C719C3F959C084A4B088FA7F4440E736FB4C70035AC084A4B088FA7F44409122C81963035AC0348C7C55FB8F44409122C81963035AC0B7504C22FC9F44406D4C94E65B035AC0743818EFFCAF44409F3A94E659035AC09F7FB288FEBF4440989394E663035AC044677E55FFCF444010EA61B362035AC0F44E4A2200E044401FCCFA4C64035AC03007B18802F044404A402D805F035AC0504E4B2204004540355E94E65D035AC0FCC44A22041045409119C71961035AC02C7DB188062045409119C71961035AC0ECD549220830454035AE93E665035AC08B4C492208404540355E94E65D035AC01C82E5BB095045409119C71961035AC0CCF8E4BB096045401FCCFA4C64035AC0F8B04B220C704540EDDDFA4C66035AC0A8274B220C80454044B12D80F1F659C0A8274B220C804540D42B2E8009EC59C0A8274B220C804540F1DE94E621E159C0A8274B220C8045405ED360B33AD659C0A8274B220C8045407486C71953CB59C0A8274B220C80454099AAFA4C6CC059C0A8274B220C804540BECE2D8085B559C0A8274B220C804540D58194E69DAA59C098B67E550B804540716D61B3B69F59C09845B2880A8045408F20C819CF9459C09845B2880A80454075DC2D80E78959C09845B2880A8045409A0061B3007F59C09845B2880A80454037EC2D80197459C09845B2880A804540D4D7FA4C326959C09845B2880A804540F28A61B34A5E59C09845B2880A804540093EC819635359C09845B2880A804540A72995E67B4859C09845B2880A8045405AEEF94C943D59C09845B2880A804540F9D9C619AD3259C09845B2880A8045401CFEF94CC62759C07C6319EF08804540BBE9C619DF1C59C09CA47C55078045408FCC94E6F71159C09CA47C55078045407588FA4C100759C09CA47C55078045408D3B61B328FC58C09CA47C55078045402A272E8041F158C09CA47C5507804540971BFA4C5AE658C09CA47C5507804540BC3F2D8073DB58C09CA47C5507804540592BFA4C8CD058C09CA47C5507804540EFA5FA4CA4C558C09CA47C55078045408D91C719BDBA58C09CA47C5507804540AA442E80D5AF58C09CA47C55078045404830FB4CEEA458C08C33B088068045406275FA4C6C9F58C08C33B0880680454032CC93E60B9F58C08C33B0880680454028C52D80D99E58C050247E55C37F45407F39FB4C8E9D58C03028B0886A7D45405E8E94E6119D58C0603A17EFC07C4540920261B3589658C078E816EF34764540527761B3F69558C0849617EF10764540A6DA2D80339558C0AC497E5503764540609F2D80D99458C0481B7F55E3754540D1FC2D802D9258C0CB994C223073454089F493E68B8F58C020494A22AC6F4540837993E6B38658C00BDD7D55076A45402B5394E6098658C0C463E3BBF968454060912E80C38558C068CBB18876674540D8C12D80058558C028CC4922B86645402E2261B3708058C04C6B18EF5C644540BAFFFA4CB67E58C054857F552364454045DD94E6FB7C58C04C6B18EF5C644540BC6694E6477C58C0E4EEE3BBE9644540EC042E80F57A58C088857C559F6645403CCA60B38A7A58C044294C22FC66454071C9C6194D7A58C0501DB1889A674540E3772E807D7958C03451B288FE6A45408E8E2D80477958C0CC767E55B36C45404CC694E6BD7858C078E94822C86D4540A6F32D80057858C0D49B17EF786E4540BAF72D80437758C0505BB188026F4540B2F761B3AE7558C0D8FCE3BB8D6F4540DA70FB4C4E7158C0A899B0880E6E4540E8B2C719AF6E58C0505BB188026F45405EC9FA4CDE6D58C03C817D55C36E4540FD0D61B3926C58C030FDE3BB996D4540665CC719D36B58C0F018E4BB2D6D45405E76C719516A58C063AC4A22546D45405852C819CF6758C03311B2884E6F4540229894E6616658C0F347E4BBCD6F45406A2EFB4CC26158C00828B1881E6E4540FE7360B3066058C0A899B0880E6E45405DB8FA4C465358C038854B228C71454026682D80A75158C05B2F4C2230714540DA472E80575058C0E0917E552F704540FE5A94E63D4F58C07405B288A66E4540941361B3524D58C06FD4AF88EE6A45402650FB4CFC4A58C0B4ABB188AA6745401C2DC7199F4958C09C3C19EF30664540488EC719254858C080D5AF881265454032C62E80A14658C07875E4BB896445408CC4C719494358C04C6B18EF5C6445407E2F2D80A74258C0A06DE4BB196445401B01C7193F4158C02C9C7E55F362454098FCC719833F58C0C0BE7D556B624540E62B61B3E63E58C0D47D7F55BF614540F5C7FA4C723E58C0AC9DE4BBDD60454024DA61B3C83D58C004FFB088FE5F4540154DC7199D3C58C0988D16EF605F454078BBFA4CD83658C063C37D55BB5E4540AAEF2D80B73558C0E4B4E3BBB95D45400851FA4CD83458C0344518EF505C4540E24E2E80213458C080007F55BF5A4540321461B3B63358C064E84B22805945404C812D807F3358C0ACE4B0889A5845405328C819293358C0A3AF17EFE8574540116894E6613258C0EFA317EF40574540CE5761B3923158C0B405B288FE564540868EFB4CE82E58C0EFA317EF4057454046B260B33E2E58C018A57D551F574540943194E65D2D58C078554A22B8564540974AFA4C982C58C008D3E4BB09564540310C94E6432C58C0C47C17EF10554540E360C819752C58C01864B188E2534540C006C719D92C58C0447E7D55FB5245408A2A2E802B2D58C0E0B17D55EB51454058E32D80232D58C010F7B18842504540B8C0C719632C58C044FFB188BE4E45409C3561B3BE2958C0B86217EFB84B4540A2E460B32A2958C070AB7D55AB49454052AB60B3EC2858C04CFEE5BB3147454090D593E6392858C00CC17E5573454540A3772D801F2758C0B8654B226444454088C494E6E31E58C0F0EF18EF58424540,-11.3%,-28,219,8,211,Nebraska,true
30,0106000020E610000001000000010300000001000000DC0000009C3A61B392825CC03840B28866804240A9AB2D8093825CC0E0E47E55577F4240B11CFA4C94825CC0642A7D55537C4240AAB42E8095825CC08832E5BBA577424046CF2D8097825CC0C4824A22947142408DA8C71999825CC0536C4A22686A424055BAC7199B825CC0681C7E5563624240AA042E809D825CC0645AE4BBD1594240F84E94E69F825CC028E8E2BBF950424000C961B3A2825CC05864E3BB214842401D1CC719A5825CC0C8904B22903F4240EB2DC719A7825CC0CB407F558B374240726F2E80A9825CC0EC3B7D555F3042408051C719AB825CC0A85C7D554F2A424040F2FA4CAC825CC06876E3BBA1254240CD2A61B3AC825CC0DCEB4A22A0224240D59B2D80AD825CC0E86C17EF8C214240DD15FB4CB0825CC0D8E6E3BB211C4240BA6294E6BD825CC000877D55EB1A4240BD9F2D80E5825CC0C41BE5BBA919424015EAFA4C30845CC048C5E4BBCD164240DF5EC71963855CC0C0547D552B144240E80D2E8017865CC06CD3E5BB3110424065D62D80EF865CC0BC5E4B22740B4240553294E6ED875CC09C21B188DE054240C3822D80278A5CC03717B288CE03424059742D804B8D5CC0D8A117EFF8024240D9ED93E6F38E5CC04CA64A2220034240D809C7196B905CC084BA7D5527044240DAE660B39E915CC0E0AA4B22D8054240B9CA94E669925CC0B0544C22700742406E03C71905935CC08F3FB0880609424041D8F94C74945CC0A8DF4A22380E42404630FB4CEE945CC09CA418EF740F4240C97A2D808B955CC078A47D55BB1042408ADF2D803D965CC0E81619EFE4114240B61E2E80CF965CC054F3E2BB791242400C2B61B366975CC010087F55D7124240CA47C719D3975CC00437B188E6124240E62861B344985CC0BC0D18EFDC124240E5AD94E6B1985CC084A34A22C0124240EBD0C61913995CC0B804B2888E124240279BFA4C6C995CC00C077E554B12424085B8FA4C109B5CC0ACC8B088AE10424024B82E806F9B5CC09C714B22741042404090C719DF9B5CC0F0D718EF5810424057C160B3589C5CC0E0664C2258104240C8B62D80D79C5CC010BF17EF7010424099C993E6B19D5CC0042C7F55E710424055DE94E65B9E5CC0106118EF98114240A417FA4CE69E5CC00C077E554B124240D97061B33E9F5CC04857E4BBA11242409D71FB4C7C9F5CC0587F17EFCC124240D33661B3E8A25CC0F09318EF70144240701C2E8081A35CC0A82D4B228C144240F04C94E60BA45CC04459B08852144240A8492E800BA55CC073DCE3BBA9134240F0B294E6C1A85CC0C0B5B18816124240304961B3D6AA5CC018E1E3BBF90F4240CD6D2E80FBAC5CC070FC4B22580E4240D12695E641AD5CC0EC7CAF88EE0D424037422E8081AD5CC058104C227C0D42402135C819F5AD5CC03CDEB188760C4240B37494E627AE5CC07C72B088DE0B4240918BFA4C40AE5CC0EC70B288CA0A424099FCC61941AE5CC0AC3CB1885A094240F7D160B30AAE5CC0B0044B226C064240318A2D8013AE5CC0487DE4BBF9044240BC84FB4C5CAE5CC03890E3BB91034240BDE5C71971AF5CC0641EB188BE014240CAE3C71955AF5CC05C51B0882EFE4140C1FE2D80ABAE5CC0C02918EFC8FA41403431C819BDAD5CC0A48C4A22D4F74140676394E637AB5CC07853B08876F24140C4A294E6CFAA5CC084A54A2254F141402D03C719ADAA5CC08C8917EFDCEF4140F80361B3EAAA5CC040857F556FEE41403826FB4C0AAC5CC0A30EB1882AEB4140281795E661AC5CC0E0CC16EF44E9414069902D8073AC5CC0F0A97E552FE241402E9BC71943AC5CC0A4477E55ABDE4140A450FA4CF2AB5CC0F44117EF14DC41401AA4FA4CB4A95CC01B8119EFC8D241409AEF61B348A95CC0E89916EFB8D041408C1494E6C5A95CC0C0724C22F0CD41403A9EFA4C60A95CC0571DE4BB61C841408417FA4CBAAA5CC0C06EAF882EC24140B0A42D80A3A95CC0E81BB2880EBD4140DD0E94E677A85CC0087316EFE0B641407BC560B370A65CC03CC3B18836B041406C39C719D1A55CC004217E552BAD4140436E94E6E7A55CC0382F17EFB8A94140023AFA4CC0A55CC08CE8B18876A641405883FA4CEAA45CC0E47AB18856A0414095D960B39AA45CC02C6917EF349B41401DDC93E6A5A45CC08711B1887A9841409D6EFB4C3CA55CC0EC647E555F9341406F3061B382A55CC078D97C55FB924140D5F3FA4C44A65CC0E0A3B0885A9241402298C71929A75CC0E80B17EF0C924140FC95C71907A85CC0D8297E550B924140B027FA4CACA85CC038B77D558F9141400F82C719E3A85CC0F4084A22D08F4140673494E697A85CC0C8AE7C559F8E41406457FA4C64A75CC0EF7018EF588C41407E03FB4C24A75CC0687BE4BB918A41404F7561B362A75CC0A0FD16EF5C8941400F82C719E3A85CC02CECAF881E8641405DB160B346A85CC038724A22F88141409AFF61B334A85CC06CEB16EF748041403CBA61B31CB45CC0602FB288BE9241409021FA4C00C05CC0A03D4B2200A54140A4D1C61967CC5CC07C567E550BB8414073A793E6F3D75CC08C18B1882ECA41400598FA4C3CE25CC0A02217EF54DA41409D8861B384EC5CC0288C4B227CEA4140FE81C719CDF65CC06496B188A2FA4140103AC81915015DC0E88E19EFC80A424072332E805D0B5DC00C997F55EF1A4240CD2C94E6A5155DC020A3E5BB152B4240ACED93E6ED1F5DC0D44D7D553B3B4240B9A594E6352A5DC0E857E3BB614B424084972D80F1355DC02C7217EF045D424005B92D80AD415DC0608C4B22A86E424081DA2D80694D5DC0988818EF4C8042407DC3C71925595DC0DCA24C22F0914240C27CFA4CE0645DC034E07C5593A34240439EFA4C9C705DC0686B7D5537B54240C6BFFA4C587C5DC0AC85B188DAC642408AB193E613885DC0E09FE5BB7DD84240DB9F2D8011975DC070E8B0886AED4240348EC7190FA65DC080904A2258024340568560B30CB55DC080C717EF44174340293B94E609C45DC098FEE4BB312C434049322D8007D35DC038B87C551F4143409D20C71905E25DC0A84E18EF0C564340F60E61B302F15DC05397E3BBF96A43401806FA4C00005EC054CEB088E67F434095D694E601005EC068E7E4BBB181434095D694E601005EC0D8DA17EFC8884340170FFB4C02005EC0C4297D553BA043401F80C71903005EC02CD8B088AEB743405EE894E603005EC0FCB5492220CF4340E420FB4C04005EC060F3B08892E64340665961B304005EC04C4216EF04FE434074CA2D8005005EC0B4F0492278154440FC7360B306005EC0F0BCE4BBE92C4440FC7360B306005EC0E80B4A225C44444042DC2D8007005EC044BA7D55CF5B44407B44FB4C08005EC090F7E4BB4173444081B5C71909005EC088464A22B48A444009EE2D8009005EC0D412E5BB25A24440912694E609005EC03CC118EF98B94440C88E61B30A005EC018107E550BD14440583894E60B005EC06F4DE5BB7DE84440DF70FA4C0C005EC0D8FB18EFF0FF4440836CC71911F45DC0D8FB18EFF0FF4440AF6AC71921E85DC0D8FB18EFF0FF4440E3D993E631DC5DC0D8FB18EFF0FF444016E194E643D05DC0D8FB18EFF0FF4440CF88C71955C45DC0D8FB18EFF0FF444003F893E665B85DC0D8FB18EFF0FF4440705E61B376AC5DC0D8FB18EFF0FF444062FD94E687A05DC0D8FB18EFF0FF44401CA5C71999945DC0D8FB18EFF0FF4440501494E6A9885DC0D8FB18EFF0FF4440848360B3BA7C5DC0D8FB18EFF0FF4440792294E6CB705DC0D8FB18EFF0FF4440EBF92D80DD645DC0D8FB18EFF0FF44405660FB4CEE585DC0D8FB18EFF0FF4440D19F60B3FE4C5DC0D8FB18EFF0FF44404477FA4C10415DC0CCFB18EFF0FF4440F80661B32A355DC0D06CE5BBF1FF44402CCF2D8045295DC0EC4E7E55F3FF44405A97FA4C601D5DC0F83017EFF4FF4440D52F60B37A115DC008A2E3BBF5FF4440317E61B394055DC07801B288F6FF4440ED7E94E6AFF95CC088E34A22F8FF4440214761B3CAED5CC088E34A22F8FF4440CED6C719E5E15CC098C5E3BBF9FF4440C236C719FFD55CC0A436B088FAFF44407C37FA4C1ACA5CC0A436B088FAFF4440E2F6C71935BE5CC0B4A77C55FBFF444094862E804FB25CC0946619EFFCFF44400A1F94E669A65CC0A448B288FEFF4440367694E6839A5CC0C02A4B220000454061CD94E69D8E5CC0C09B17EF00004540E5D6C619B9825CC0DC7DB088020045405E9E60B3B8825CC0D07317EF04EC4440C78361B3B6825CC04CABE5BB09D84440BA1295E6B5825CC0CCD0B1880AC444404242FA4CB4825CC0F3197E550FB044403AD12D80B3825CC0F480B188129C4440EDF793E6B1825CC0908816EF14884440E586C719B1825CC0FF4E18EF18744440D5A42E80AF825CC08F567D551B6044400F04FB4CAE825CC09CBDB0881E4C4440CD2A61B3AC825CC098B317EF2038444088C293E6AB825CC0B4FCE3BB2524444078E0FA4CAA825CC0A4817E5527104440726F2E80A9825CC0AF597E552BFC434072662D80A7825CC050D2AF882EE8434063F560B3A6825CC0B0B618EF30D443405D8494E6A5825CC0582F4A2234C043401D1CC719A5825CC064074A2238AC434015ABFA4CA4825CC058FDB0883A98434000C961B3A2825CC054F317EF3C844340C16094E6A1825CC0703CE4BB41704340F84E94E69F825CC060C17E55435C4340F0DDC7199F825CC00BAB7C5547484340AA042E809D825CC06C8FE5BB493443409C9361B39C825CC078F618EF4C20434055BAC7199B825CC0146F4A22500C4340951994E699825CC024474A2254F842404E40FA4C98825CC0203DB18856E4424046CF2D8097825CC020A4E4BB59D0424031ED94E695825CC02C7CE4BB5DBC4240F184C71995825CC0ACA1B0885EA84240A9AB2D8093825CC038D97E55639442409C3A61B392825CC03840B28866804240,-1.0%,-9,851,414,437,Nevada,true
36,0106000020E610000001000000010300000001000000E2000000405E2D3C784E58C0F031F4CB0F7F48404AE32D80AB4E58C0000E4B22FC7B4840DAED60B32C4E58C0732D18EFE47948406CDCC7197F4D58C0F4514B22E4774840AAA5FA4C4C4D58C06C0E18EF30764840B40D61B3FE4C58C077F0E2BBA17348400C9D60B39E4C58C0588AB08876724840F0C4C7192F4C58C0D858492260714840C07461B3D84B58C06487E3BB39704840EC1361B35E4B58C088E6B088C66B4840EE7BFB4C7C4958C0E4A318EFE46448402FFD93E6034958C0CCFB18EFF05F4840300E95E67B4858C0F8DF4A22CC5D48405B6694E6FF4658C0AB0217EF6C594840E2A6FA4C764658C0CCDC4922445348408A8B2D80CB4758C09804B288624E48400CCF60B37E4958C030DC7D55C3494840282CC8190F4A58C038BBB1885E444840EA57C8198F4858C09B7718EFF03C4840B18D94E6354858C0E4557E55E33848402682FB4CDC4758C03CA47D55DB36484004CF94E6E94758C0FC817E556F3548406CB4FA4C344858C0E823B1880634484084F7FA4CFE4858C08492E3BBB9314840427EC719394958C070834C22303048408023C719194858C06F954922D4274840423FC719AD4758C03CB8E3BB05264840C46EC7195F4758C01CD77D55FF23484058452E804F4858C0A4BEB188221B4840CA92FA4C4C4858C05F2516EFD4154840D064C719CD4758C0D46419EFFC104840A0A093E6CD4658C027B34A22640C4840B2CF94E6014458C0EC407F55F30248408CC4C719494358C09CC64B2230FE4740C68C94E63D4258C08BA1E4BBD9F947400AF294E6014058C0ECB0E3BB45F64740DE9894E6F14058C0177AE3BB35F347408697C719C54058C044897D554FF04740E21AFB4C223F58C0987618EF08EA47405368C7191F3F58C0B7F4E5BB49E947409F1494E6793F58C02C157E5557E847409727FA4C5A3F58C07C0EE4BBC5E74740E21AFB4C223F58C04CE14A2284E747402D05FB4CE83E58C014777D5567E74740909B60B3BA3E58C02B257E5543E7474014BAFA4CA83E58C08C874B22F0E647409A03C7196D3E58C0DB20B0886EE64740FC02C819E93C58C07B987E55D7E347409AEF93E66B3C58C0145AB1883AE24740FF7C2E80A33B58C0D89B4A22B8DD47403661C719C73A58C093F5B18822DB47405463C719E93958C0A4CC18EF24D947403C9C94E63D3958C0D08D7D55EBD647401664FA4CDE3858C064B87F5563D247406056FA4C1A3858C09C85E4BBDDCE4740BC7A2D80133758C0881FB288B2CD47409C6E61B3CA3658C0C7A2E5BB09CD474030C894E6C33658C004C217EF38CC4740C8282E80EF3658C0D0D4B1887ECB474068E2C719253758C0D8A47E55E3CA47403E7F60B33A3758C0D0E4B1886ACA4740FEFCC619273758C06CFB7D5557C7474038D860B3443758C0687E7E55CBC447400C4161B3343758C0D8C87D558BC24740DA3794E6973658C0C78316EF5CC047404A8E61B3963658C0A0777E557FBE47409F16C719993758C03CE97C5507B8474092F5F94CA03758C0F81F17EF5CB54740B0F8FA4C4E3758C064EA4A22BCB44740B8A7FA4CBA3658C00064E5BBD5B347401A1B2E802B3658C063DF18EFBCB247407A97C719EB3558C033627E5577B147401001C719653658C0CCF9AF882EA14740A8CD61B32E3658C0884AB1884A9E4740C0A393E6393558C0D04817EF14984740D22EC719013558C0009E4B2258954740368794E61B3558C0C8B84A2260944740E422C719533558C0C8457C5547934740BCEB2D807F3558C0E0D44A22009247405EBF2E807B3558C0B0004B2280904740B0AF2E809B3458C0BC1317EF408B4740034894E6893458C0A8B47E55B3884740D22EC719013558C0A8387F554B8047406C86FA4CDE3458C04CB97D559B7E4740F665FB4C883458C0BC057F55737D474006A02E80BB3358C03CB9E5BB717B4740122261B3803358C0607B4B22C47947406713C719793358C0D49BE3BBD178474006A02E80BB3358C0D40CB088D27847408F762E80633358C0A44B7D557B78474077FDFA4CA43258C02C847E552F7847409BE593E6FF3158C0ECA7E3BB85774740A678C7193D3158C003F2E2BB3977474084F02D80D53058C06C6E17EFAC7647403AB72D80973058C048B14922E07547407392C719B53058C0E8454C224C7547407EF22D80F13058C0C48019EFBC744740F6122D80473158C07C3A4C22B07247407F1FC7192D3258C03CEBE2BBED704740116894E6613258C09C807D559B6F474033C2FA4C4A3258C098DEE4BB496B4740116894E6613258C00351B288E269474046EC2D80913258C0DC7017EF006947408E8794E6273358C094197F55E366474082D993E64B3358C0BF0718EF98654740942E94E61D3358C05C0EE4BB99634740E454C719333258C0CCE449221C5F4740BEF1FA4CFC3158C0875818EF4C5C4740FA3F61B3363258C0F00D7D556B5947404CE22D80FF3258C024DE16EFF8544740E0C894E6DB3258C038CEE3BB3552474050FB93E6393258C09C974C2270504740E54094E6313058C0C0B049226C4C474050A161B3C22F58C000EC16EFE849474022F8FA4C622F58C04006B0882A4547405A8DFA4C562F58C098C04B227442474050A161B3C22F58C05C797D55DB3F47408624FA4C662F58C0DB107F55F33E47407E1C2E805B2E58C09C7316EF443D47408061C719F92D58C0C8F94822483C474062EB94E6E12D58C0909716EF543B474078CD2D80E32D58C01C497F55333A4740446C61B3C82D58C0503718EFE838474078DE2E805B2D58C0CBFC4A2284374740704561B3A42958C0CB204A222C2F47407B1562B3742758C02C5316EFAC2B47402995C619812658C047B5B088762947400E162E801B2658C040F216EFC0264740D0F3FA4C442658C08351B188761E47400E162E801B2658C0B869B188DE1B47407DCD60B3E62558C05C0518EF801A4740DEF9FA4C9E2558C0C0F117EF6819474025AE60B3262458C03C894B22F01547402C5E61B31E2458C0DCA2E4BB191547405A182E80432458C0188E7E5523144740F55EFB4C5C2458C0746CB288A612474016A9FA4C102458C0DC72E3BBED1147404A12C719A12358C09CEC4A22300D4740A0D6FA4CA62358C0A46C16EF900B4740DE0AFA4C1A2458C0D45819EFFC0747403ED794E6DD2458C0F396E5BB250547405A2AFA4CE02458C0CC657E551B02474015D4C7199B2358C0E8477E558BF84640E2662E80833258C0E8477E558BF8464042A3C7196D4158C0E8477E558BF846400C362E80555058C0E8477E558BF846406301FB4C3E5F58C0F42917EF8CF8464084D5C619276E58C073FAB1888EF84640089894E60F7D58C073FAB1888EF846405A6361B3F88B58C073FAB1888EF84640B12E2E80E19A58C073FAB1888EF846407CC194E6C9A958C073FAB1888EF846409D9560B3B2B858C073FAB1888EF8464026582E809BC758C073FAB1888EF846407823FB4C84D658C0736B7E558FF8464097F7C6196DE558C083DC4A2290F84640292B61B356F458C083DC4A2290F84640F4BDC7193F0359C083DC4A2290F84640468994E6271259C083DC4A2290F846409D5461B3102159C083DC4A2290F8464036F0C619F92F59C083DC4A2290F84640C82361B3E23E59C083DC4A2290F846401AEF2D80CB4D59C093BEE3BB91F846406CBAFA4CB45C59C0B0A07C5593F8464043BE2D809D6B59C0B0A07C5593F84640155194E6857A59C0B0A07C5593F84640671C61B36E8959C0B0A07C5593F84640B9E72D80579859C0B0A07C5593F846400BB3FA4C40A759C0B0A07C5593F846405C7EC71929B659C0B0A07C5593F84640B44994E611C559C0B0A07C5593F84640061561B3FAD359C0B0A07C5593F84640506F61B3E2E259C0B0A07C5593F84640287394E6CBF159C0B0A07C5593F846404AA12D80DF025AC0B011492294F84640929D94E6F5025AC024E14B22FC104740929D94E6F5025AC090C04A2258264740929D94E6F5025AC0571D7F55B33B4740929D94E6F5025AC0B48BB1880E514740929D94E6F5025AC010FAE3BB69664740929D94E6F5025AC06C6816EFC47B4740929D94E6F5025AC038C54A2220914740929D94E6F5025AC094337D557BA64740929D94E6F5025AC06090B188D6BB4740929D94E6F5025AC02CEDE5BB31D14740929D94E6F5025AC0885B18EF8CE64740929D94E6F5025AC0E4C94A22E8FB4740929D94E6F5025AC04CA9492244114840929D94E6F5025AC024774A22A0264840929D94E6F5025AC074E57C55FB3B4840929D94E6F5025AC04042B1885651484011652E80F5025AC00C9FE5BBB1664840429BB1750B035AC0CCD9741A0E7F4840623E231B0CFE59C05CF6741A0E7F4840A7A130CFFAEF59C05CF6741A0E7F484089ADDE16E9E159C05CF6741A0E7F4840C710ECCAD7D359C05CF6741A0E7F4840E686FA7EC6C559C05CF6741A0E7F4840713B495AB4B759C05CF6741A0E7F4840B19E560EA3A959C05CF6741A0E7F484093AA0456919B59C05CF6741A0E7F4840D70D120A808D59C08F79F4CB0F7F4840AF32DF966F7F59C08F79F4CB0F7F4840EE95EC4A5E7159C08F79F4CB0F7F48402DF9F9FE4C6359C08F79F4CB0F7F48403CE33C57515759C0F031F4CB0F7F48405656E96D3A5559C08F79F4CB0F7F484099B9F621294759C08F79F4CB0F7F484016876442183959C08F79F4CB0F7F4840FE92128A062B59C08F79F4CB0F7F4840994D7FAAF51C59C08F79F4CB0F7F48407A592DF2E30E59C08F79F4CB0F7F4840F7269B12D30059C08F79F4CB0F7F484092E10733C2F258C08F79F4CB0F7F4840B75716E7B0E458C08F79F4CB0F7F484014A8229B9FD658C08F79F4CB0F7F4840D8C6D1E28DC858C08F79F4CB0F7F4840172ADF967CBA58C08F79F4CB0F7F48405C8DEC4A6BAC58C08F79F4CB0F7F4840DF413B26599E58C08F79F4CB0F7F4840BA6608B3489058C08F79F4CB0F7F4840B35FB5FA368258C08F79F4CB0F7F4840DAD5C3AE257458C08F79F4CB0F7F48401839D162146658C08F79F4CB0F7F48403EAFDF16035858C08F79F4CB0F7F4840405E2D3C784E58C0F031F4CB0F7F4840,-15.3%,-21,116,53,63,North Dakota,true
37,0106000020E610000001000000010300000001000000D20100003B492E804B2154C02CBBE5BBC95244401F34C819492254C09C59B0885E524440780494E6252554C0DFF37D553F4F444072F493E6392654C09708E4BB35504440ECA32D80D72754C098E516EF2050444016D32D807D2954C00CAC4A22484F44405AB693E6A52A54C0C0CA7F55EF4D444030AD2D80512B54C0486BE3BB5D4B4440A225C719D92A54C074AF16EF28494440DA8CC719B92854C06079E4BBC14444406473C7194D2754C028304A227840444030C3FA4CBA2654C05CD47E55333E4440B60CC7197F2654C0E04AB188563C44401E4B2D80D32654C0B85FE4BB753944400CB9FA4C222854C030B817EF703444408E642D803F2854C0583318EF7431444027F293E6112854C094D9E2BB793144402FE72D80A72754C010E7B1885631444046FD94E6352754C01CC0E4BB0931444042442E80EF2654C034C4492294304440726861B3E22654C03841B188F62F444082FCFA4CF82654C0B018E6BB952E444042442E80EF2654C0B8F417EFF42D44401A42C719852654C020BC7E55172B444042A52E806F2654C094077F556329444053402E80B72654C038B5B188A228444096BAC719552754C074B6E4BBA9244440A807C819B12754C0785E7E55E32344402C0CC7196D2954C04C377E55B32144405533FB4C082A54C0BC464B22B02044408C3B2E80612B54C0C33FB088AA1B4440E44761B3F82B54C033E44922B8184440685EFB4C702C54C0AF1AB1882A144440B0A061B3FC2C54C01C54E5BBD9114440E687C7195D2E54C03830E4BB610D4440AA5D94E60F2F54C0D435E5BB3D0A4440BC2EC7194D2F54C0EC2E18EFC80744408F97C7193D2F54C0A4A77E557F02444068B02D80712F54C06075B18896FF4340516493E6ED2F54C0D87F7D55CFFD434084AC94E6813054C0501118EF44FC4340580D95E6FB3054C0C08A492214FA434042FF2D80E33054C034517D553BF943401C4361B3A23054C0D013B1882AF84340D14FFB4C8E3054C078F5B188F6F64340580D95E6FB3054C0D89B17EFB4F54340DCED60B3CA3154C02CD3B2888AF54340F0D960B3A63254C00CD216EF44F64340451262B3543354C0D7D0B08866F643409A0C2E809B3354C0100D7F556FF44340736A2D806D3354C00C25E4BB1DF34340EE5E94E6133354C0F4447F55A3F14340D41C95E6D53254C0640AB2883EF04340589294E6FD3254C0209117EF30EF43401A9694E62F3454C0D38218EFE8EC43403B1E2E80973454C054C27D55D3EB4340DEDE2D80FF3454C04053E5BB59EA4340D253FA4C383554C03C6B4A2208E94340008A94E67B3554C0DF114B2280E64340B61B62B3D43554C0DC29B0882EE54340D1672D80393754C04C0D4A22C8E343402ECB60B3BE3754C0D8CF7D55B7E24340C4CB2E80613754C0E0014A222CE14340F0722E805D3654C0C8FA17EF64DF434098432E80B13554C034BBE4BBE9DD43407A512E807B3554C0A89518EF34DC4340B61B62B3D43554C0A4ACB288BED94340EA9760B3DA3654C04B59E4BB71D843408203FB4C243754C0EF7BE3BBE9D74340E602C819353754C0B0D417EF58D74340909594E61D3754C0D48E18EFE8D543408203FB4C243754C0681D7E554BD54340A25EC719E53754C0B76DB188CAD14340A2DA94E6033854C0B4264C227CD043407C22C7196D3C54C048C2E4BB8DCC43400E7B61B38A4354C050AE4B22D8C343406F1494E6994554C0F446E5BB3DC04340364BC819154754C03CDFB08806BC4340840961B30C4854C094DFB08812BA43404AB6C719994A54C0ACA516EF9CB843405A5B2E80BB4B54C0ECA1B1881EB74340DB112E808B4D54C03F1E18EF00B44340B882FA4C864E54C0D0F116EF00B34340CAF32D80CF4F54C028F418EF24B2434024B1C719375154C04C947C5587B14340D206C7198D5254C0B89CE5BB4DB143407A9BFA4CDA5354C084FD7E557FB043406E24FA4C145654C0F4097F553FAD4340FA4B61B3985754C000D1AF88EEAC434028C0FA4CDC5854C0BC527D555BAE4340E6E7C619B35954C0B02A18EFC0B04340525961B3505A54C0D0F116EF00B34340767794E6E95A54C03F1E18EF00B4434021CFFA4CA45D54C078D6E4BB09B44340F01EFA4CA65E54C09C42B08846B34340F2F7C619796354C0C8207E550FAC4340B040FB4CFC6354C01C954922C8A94340EA74FA4C706454C0F40AB188D2A44340FA7C61B32E6554C01402E6BB3DA34340C22D61B3B06554C0300716EFECA3434000B960B3126654C0886AE4BB25A443407C3B61B3746654C030964922ECA343400A8D94E6F76654C01402E6BB3DA3434066CDFA4C686754C050D5E4BB31A44340B210C719CD6854C0D09B18EF58A34340A437FB4C626A54C0ECCBB08846A34340CC8AC719AD6B54C00C1F4C22B0A24340D2C8C619AD6C54C0EF8818EF589E4340AC7994E6BF6F54C034994A22C0984340505D61B33C7054C0B4DBE4BBBD964340EE9A2D80537054C064027F552795434000F02D80257054C0A31C18EF68904340B4E260B34A7054C03885E3BB798D4340742294E6CB7054C0083D18EF4C8C4340FC4BC719017454C0C4F64A22408A4340E32495E6617454C0875CE5BB358A4340D603C819697454C010C018EFC0894340B6EEFA4C1E7454C0B3B1E3BB118843402C4D2D80DF7354C09C77E4BB49874340D88694E6717354C0908BE4BB6D864340925EFA4CF87254C084564B22BC8543402F7794E6917254C02C537E557385434080C094E6BB7154C0E88BE4BB7984434038742E809D7154C09C5F7E553382434049F761B3EE7154C050A816EF947D43402866C719857154C06C2D7E55737B43401A2A2D80ED7054C0FCC27D557379434098A1C719E57054C068127E55F7774340803CC719277254C097B87E556377434042A1C719D97254C003D27C55D37743400A6D94E6F97354C0D8F5AF88BA7943401C36C719C17454C0A4FDAF882A7A43407465C7196D7554C06F3317EF84794340F25894E6CF7554C0A03B17EF00784340A2AD2D804D7654C020FF7D55EB74434025CD2D80137754C06B517D551B734340307494E6517854C0FC467E550B7143406CD5C719B57954C0A4C87D55E76F434076232E80E97A54C07CBF7C55DF704340EDBFFA4C5E7B54C07BCAE4BB457243406E0BC7193F7B54C0088FE4BBE5724340781A2D80E77A54C0BC3AE3BB9D734340B4EC60B3B67A54C0B4DDE4BB517543400E6BFA4C927A54C010754B22B0754340BC172E80417A54C004794B22E8754340B094FA4CF07954C044AB4A22407643408C4BFA4CCC7954C0134BE4BBFD76434036B394E6DD7954C02037E4BBD9774340F21694E6037A54C09BB9492288784340904AFB4C3C7A54C0782AB1883679434024FD93E68B7A54C014DCB1883E7B4340AA00C819237B54C0A09917EF407D434086F5C619FF7B54C08CF67E55CB7E43408412FB4C027E54C00C0E7F551B8043402E95C719FF7E54C0DC537E558B814340686061B3308054C06CB97D55C78243408428FA4CB48154C034247E55D382434020DAFA4CBC8354C00317E5BB69804340680461B3E68554C064ABB088FA7B4340C23D2D80B98754C0DCB5E4BB0977434000EDFA4CBC8854C0508D4B2218734340D3F4FA4C2C8954C06C82B088DA6D4340A00F61B37C8954C0C0694A22AC6C434040E4C719518A54C030B449226C6A43400A8461B30E8B54C06C23E5BB75674340F05494E6458C54C0D8B87F5523664340321E2E805B8D54C0FCAE7D559B644340E46961B38A8D54C01CB9B1889E6143406EC493E6138D54C0448C18EF685F43406602C7197F8C54C0740D4A22A85D43407B4560B3008C54C0D84A7E558F5B43409CBB2D80CB8B54C0741BB0885258434045EDF94C348C54C09338B1887E56434000902D80518C54C01021B1882E554340A1122E80B98B54C0AC41E4BBF55243402B0CFB4C768B54C0B0DF16EF54514340A907C8194F8B54C05F43E5BB994F4340F8AA2E805B8B54C088317E554F4E43404EE394E6558C54C05CBC7E55334C4340E24FFA4CC48D54C0AC78B088C64B43403CC861B3D69054C0A8BF4B227C4C434090DDFA4CBC9154C0984717EF4C4B4340283694E6719254C020F67C55874843403A59C819CF9354C03065E4BB453D434056FB2D80499454C0001B17EF003B43403813FA4C3A9554C09C3B4A22C83843401ECA60B35E9654C068BFB0880E3843402E35C7192B9B54C0E0FAB0886E3743403E412D8093A054C00BC4B0885E344340549860B35EA354C084454B22E8334340989794E6B1A554C0F0A6E5BB9935434012AF2D80B9A554C0009A4922AC354340EEC694E65DA654C0E81418EF3437434004492E806BA754C0B02916EF543B4340169693E613A854C0F0A7B188263D434061D32D80AFAC54C03751E5BB89444340D01261B324AF54C0146417EFF8464340167D61B31EB254C02BA87D559B4843409F922D80E7B454C02091E3BB114B4340476F60B3C6B654C0E42DB188FA4F4340C675FA4C52B854C0C87918EF74584340901D94E685B854C0DBC7E5BBF15A4340823BFB4C84B854C0D0624C227C5D434062C52D80B9B854C0DCAAB288565F43408829FB4C7CB954C0F7E917EF346043400A142E8025BB54C0C876E4BBC95F4340462894E609BF54C0ACA57E55AF5C43404C8A61B3AAC054C098087F554B5C4340D1122E80FBC154C0572CE4BBA15B4340341561B300C354C0EC2E4B22185A4340B2A72D80E3C354C07F1BB08852584340946FFA4CCCC454C0A8694A22F8564340002194E685C654C0FCB4E5BBF1554340FFBF93E605C754C074DEE3BB4D55434046FB93E65FC754C01F8816EF5454434094B9C7190BC854C034B917EFA4514340EAA22D808DC854C0F8AC492260504340D5CA60B3B2C954C090DBE3BB394F43404C3B61B30CCB54C0D841B1881E4F43400A9A2D80F9CD54C0E42DB188FA4F4340C8A693E679CF54C09CBE7D55C74F4340377A94E66FD054C010D3B088DA4E43400AE4FA4C38D154C07000E5BBD54D4340C027FA4C86D354C0F0554C22FC4C4340A27394E603D454C0B046E4BB514D4340C82761B3CED454C0189F18EFB44E434024D294E655D654C0C41A17EFA852434023A7C719CBD654C0781EB2888E5343401ADE60B398D754C0D8C27E557354434034B860B36CD954C0B045B288BE55434056DFF94C54DA54C070B918EF18564340F9F060B398DC54C08B78E4BB055643400A2DFB4C30DD54C0D8614A22885643401EAF94E63DDE54C0008849222C584340C617FA4C74DF54C0802E7D557B5943401EBBC719C9E054C0EF85B088525A4340002294E631E254C0485A4B228C5A434075B994E6B5E654C0E07518EF3C584340306E94E66FE754C084714A2268574340985CFB4CBCE754C00CF97D550355434000E160B386E854C0708917EFEC5243408062C719A5E954C0B002E4BB695143404A0362B3EEEA54C08C1AE4BBC5504340D4A761B3B6ED54C044BE7D55BB51434086DAFA4C40F054C0D8C27E5573544340DCCFFA4C96F454C0F0467E55575B4340B740C71991F554C0F003B1886A5D4340C4BBFA4C6CF654C0C85317EFB45F43402EDFFA4C6AF754C0E07D16EF90614340D2C594E623FA54C0C84E4922C86243401A752E80BBFC54C088A2E5BBB16443409822C8193DFE54C048044A2208654340ED102E80F50355C0684418EF486343401C5194E65F0555C01824E5BB8D634340E258FA4C840C55C0D4084B22C06743404A8760B3EC0D55C094E17D5567694340A80D61B3860E55C0F7C04A22A06B43401A7EFA4C980E55C0CCF74A22B06E4340C7222E80D10E55C0D0264B22507143406AE32D80390F55C0B8584A229C7343401CB494E6D50F55C0E45C7D55B7754340347BC719811055C0C8B07E55F3764340A422FA4C601155C0C0D416EF2C7843403CDD94E6211255C07CE517EF9879434093AA2E80751255C0946F18EF647B4340EBD82D80951255C008A24A22A07D4340783DC719F91255C0F0147E55FF7F4340C2FBFA4CA41355C07036E5BB29824340821061B39A1455C06C86B088C68343400221C7194D1755C050A7E4BB018643406695C719DF1855C0B42D4A22E8864340C48694E61F1A55C018C5B0884687434071CAC719D91A55C0D48B17EF50884340D7DB60B3861B55C064D5B188A68A43407259C7196D1C55C05C9B4A22088D4340F69394E6D11D55C0EC004A22448E4340A95CC7198D2055C050E5E4BB698D434018C1FA4C102655C0E00FB1887A89434076CEFA4CC82855C0041218EFE48943409CE5FA4C0C2C55C04876E4BB198F4340C6D660B3FE2C55C090EB7E55EF8F4340B4C7FA4C562D55C0FC93B0885E904340868160B3262E55C0E8997C55479243403AF9C619B92E55C018907E55B7924340F58094E67F2F55C0B0274A2268924340D1C52D80173055C0D0A517EFA891434043B3FA4C203155C090EB7E55EF8F43406BDC61B3B43455C0C4764922788C43401830FA4CA63455C098BC17EFE0964340BAAAFA4C983455C087E47E554BA143405C25FB4C8A3455C00C1EE4BBB5AB43403F7094E67B3455C08875B0881EB643406A23FB4C6E3455C0FC3D492288C043404C6E94E65F3455C04CE3E5BBF1CA43403E2AFA4C523455C0BC3AB2885AD54340596C94E6433455C03C034B22C4DF4340F4E694E6353455C0B05A17EF2CEA43401E9AFB4C283455C09011B28896F44340C9ED93E6193455C010DA4A2200FF4340F2A0FA4C0C3455C0743117EF680944408E1BFB4CFE3355C0F4F9AF88D2134440FA9EFA4CF03355C0541019EF3C1E44409B19FB4CE23355C0C7D8B188A6284440836494E6D33355C048A14A2210334440E276C719C53355C0C469E3BB793D444084F1C719B73355C0A8AFB188E2474440EE74C719A93355C018784A224C52444090EFC7199B3355C098CF16EFB45C4440F472C7198D3355C06C86B1881E67444064F6C6197F3355C0ECDD7D55877144400071C719713355C0CC9418EFF07B4440A2EBC719633355C04C5DB1885A8644404466C819553355C0C0254A22C4904440FE2A2D80473355C03C7D16EF2C9B44401A6DC719393355C090937F5597A5444012BD15C0773355C040DB961830AF444012BD15C0773355C0687BF6155BB944406FE301BD963355C0709B8FF4BBC444406FE301BD963355C09C47DEEE05CF44406FE301BD963355C034D63FEC30D944402258E7952A2F55C01BBEDEC879D94440B252B673092955C038A5F790DFD94440ADE1B06F9A2355C0CCA2547E01DA4440686509594D1E55C054A0B16B23DA444094EB0455DE1855C07087CA3389DA4440C4B6A8D5661355C07087CA3389DA444011AE0DA34C0E55C0906EE3FBEEDA444002B3B795EE0855C018589FD632DB4440FE41B2917F0355C08C19198CBADB44406049FF96FFFD54C0A814D366FEDB4440DEF2BCDFEDF854C09C00325420DC4440148D59EE5CF354C0C8E74A1C86DC44401EEFCB9F75EE54C0D8CE63E4EBDC444048FF17A5F5E854C0F4B57CAC51DD44407ECABB257EE354C0F4B57CAC51DD4440F0B8BDCAC1DD54C0F83F0C3CD3DD4440C066DBD4BBDD54C07406C48555DD44409284C89B62DD54C0E822D4BB5ADC44405AD923326ED854C0A0B6980DFBD94440366CE0FE70D754C028F711D3CAD94440EC28AD175ED654C0E8DCE6B204DA4440E2B6CAACDED454C000015042CFDA4440C655AAFE24D454C070B4B3F7BBDA44404C6D1BFDA7D254C060051A6E4DD94440C012AA90ABCF54C07B06556C84D4444040E140EBFBCD54C07FD8AD6DB5D244406C06E578FDC954C0B3ACEB8425D04440BA6CD7D7D2C754C05362345051CF44401428C75F1EC654C05362345051CF44406CA6FFC87AC454C09C4295EC04CD4440B42CC40436C154C03CE1D2ABE0C644402DB280BB53BF54C05CCB71B798C54440E36E4DD440BE54C0FC98008D4BC544402812F75105BC54C020839F9803C444406C0F3D30C2BA54C08B36034EF0C34440DE88D6619CB854C0140ED092A7C4444024923FC59CB754C09BE59CD75EC54440C4478890C8B654C04C62C53680C644404802709376B654C008DFED95A1C74440885952D22BB654C0B0E646EF66C9444060C0193D05B654C0345567B305CB44403E33042D22B654C0BC2C34F8BCCB444087B6DBCD00B554C0807BB5580FCB44406A92723E36B454C027A6CD2997C94440543152907CB354C0941F675B71C74440FCFEE0652FB354C01454BD9BFDC6444062E3D8B4C7B254C0B409066729C6444004688DE647B254C05CCB71B798C54440024BA8A43EB154C04C62C53680C644405A237D6E93B054C034D5AF269DC64440977D4C4825AE54C0B409066729C644401969C8E47EAD54C0BB7ED56C85C544400ED7139D19AD54C06FB510C350C444406CBB0BECB1AC54C03055F89934C24440FC01CE000CB154C02849D514F1C144401F12883834B354C0B8FE1DE01CC14440E69AD31C99B454C0A34361D16ABF4440869609F11AB654C0A8E6D7D595C044406832FCA784B754C0CF73EDE578C044401EA014E785BA54C0A34361D16ABF44409C0E35AB24BC54C080AA283C44BF44402223B90ECBBC54C0C4C4535C0ABF44409E74F49060BD54C08C1FF841A0BE4440FCEF3F5FE0BD54C04462561DAFBD444006BFABC534BE54C04CBFDF1884BC44401314A9EEAABE54C03BA7990EFDBB444034FB5A5F86BF54C074643B33EEBC4440592BE77394C054C0141A84FE19BC4440365E2DAAE5C254C0E7804B69F3BB4440387B12ECEEC354C0883694341FBB44400073E48625C054C0C850BF54E5BA444034FB5A5F86BF54C0C0449CCFA1BA44405002DFAC47BF54C0D822185616B944403E2750C1AFBE54C07CF0A62BC9B8444046D9D6E5FABD54C040E29E9046B944409E74F49060BD54C04079F20F2EBA44409E77E12B3DBB54C06C410DA25AB744406080758339B854C0B095024633B94440F4EFD0450FB554C044B3BC9340BC444008EE1EA969B254C074643B33EEBC4440FEC416E21CB154C04C288C999CBB4440A849CB139DB054C060A97E243CBB4440886219A3C1AF54C0883694341FBB4440BCEA8F7B22AF54C0A7CFCCC945BB44400AF4F8DE22AE54C05434AF1EE0BB4440A46C8A8B5FAD54C03BA7990EFDBB44404A11119AC5AB54C0208F530476BB44401643ADB80EAA54C0F852A46A24BA4440D088F82EFAA654C0CCDC2A4DC0B644408D4EFB314EA854C0D822185616B94440C176FB73FDAA54C06C5818AEAABC444028C1B2A8D1AB54C0A34361D16ABF4440F00F340924AB54C0C4C4535C0ABF4440E2BA36E0ADAA54C0ABA0EACC3FBE4440F178E0893CAA54C0334A101328BD4440E09D519EA4A954C03BA7990EFDBB444060D2A7DE30A954C0B0DBEF4E89BB444014CC2B160DA854C098B786BFBEBA44406B6749C172A754C04079F20F2EBA44406E244953F9A254C0D4A260C9ADB444405E0FF0E34EA054C0188FE4EAA4B24440CCB47E77529D54C01083C16561B2444012B2C4550F9C54C0985A8EAA18B344408ADDE4AB349954C0236C2573E2B544409346912C4D9854C04CA8D40C34B74440DD8CB1AE3C9754C0D78BC4D62EB8444070964D8BD69254C0E097E75B72B844407A0E0A2C0F9054C0E83A5E609DB944401E50BEEF158B54C02CD5400DCCBD4440B6A80EA69B8254C018318F0A6AC14440104719ECDD7F54C0F0A379FA86C144409CB02B5F297854C07092E231BDBE444088B8B731887654C08C1FF841A0BE4440206E00FDB37554C0789E05B700BF444040589F086C7454C09059C2C5B2C044402AF77E5AB27354C09F7108D039C1444062423E14247354C028B2819509C1444064087490117154C0A34361D16ABF44403083EA528D6F54C0AC4F8456AEBF4440E75F8948606D54C068630035B7C14440BE06F56C056B54C018E02894D8C24440DAC20E474C5654C0CC2C122B5FDD44404268BFA7AD4154C04C1B599537EC4440A75EB4B1423D54C0E40A6CE475ED444094664084A13B54C0CC2CF05D01EF44406CD0F489573954C05404BDA2B8EF44408451E714F73854C01CF6B40736F04440DEA32A1C2A3854C0B8F1EADBB7F14440C88BE411A33754C0B07C1BD65BF24440315F1AA4753654C0C09461E0E2F2444028939BD8FD3354C0D0ACA7EA69F34440747F1FFAF43154C0F37FAA03A3F544403B492E804B2154C0844255E002FE44403B492E804B2154C0F4A17C55D3F344403B492E804B2154C0E4DD7E5567E644403B492E804B2154C0043D7D55FBD844403B492E804B2154C0A4FB492290CB44403B492E804B2154C0A419E5BB25BE44403B492E804B2154C0C778E3BBB9B044403B492E804B2154C0C825B2884EA344403B492E804B2154C05873B288E29544403B492E804B2154C088B44922788844403B492E804B2154C0886118EF0C7B44403B492E804B2154C0A74F4A22A06D44403B492E804B2154C0380E17EF346044403B492E804B2154C02CBBE5BBC9524440,-21.4%,-253,930,85,845,Ohio,true
31,0106000020E61000000100000001030000000100000016010000EE96D1289FAF51C02F5FCF35BA8A454002D97CD349B051C0F4CB7AE08C874540CF7CD128E1AE51C06C0AD0351A884540FA4AD22869AD51C048D2258B578845404C947CD311AD51C0D393D0358A87454074A57CD357AD51C0DC93D035CA8545404406D228D1AD51C0945ECF351E8445402EEA7CD30FAE51C0F835248B87834540A8B67CD39DAE51C01C4FD03572814540F84AD22809B251C068557BE07C794540FA4AD22869B351C08CF7CE35FA74454060FB7CD3F5B351C0443CCF3552724540A228D2281DB451C0E8AF258B4B704540D25C192F1DB451C0B8C39B374B704540623294E665B651C028F2E4BB716F45400A20C819BDB751C078BDE3BBF56F4540BC262E80E3B951C0F00316EF5471454032CC60B3A6BA51C0976DB0888271454072F6FA4C3CBB51C060B5E3BB797145406A5761B370C151C0705E4B22686D4540349EFA4C24C251C020EE16EFA86C45402215C71979C251C0A8514A22346C4540EE53FB4C6AC351C010BBB1887E6A45407C4C2E80E3C351C0FC024A22C8694540A4CAC719B9C451C0448EE2BBE1684540D662C81955C551C020B5E5BB95684540849DFA4C0CC651C030977E55976845403A5BFB4CC8C651C0A4E84A22CC68454096062E80DFC751C0448EE2BBE1684540A60C95E681C851C030E97D55BB6845400AD893E605C951C0C80318EF706845407A90C7195DC951C0EF8FB18816684540B051FA4CB4C951C014A618EFA467454076432E8049CA51C040EB16EF946645406C82C7198DCA51C070204B2200664540749293E60DCB51C0888C4C22A4644540AE4B61B3A2CB51C09043E5BB3D6245401CE1C719E5CB51C014874A226061454024C661B38ECC51C0F8A2AF88466045405292FA4C50CD51C08066E4BBC15F4540AA12FB4C90CE51C068127E55335F45406C8FC71939CF51C0C83F7C55C75E4540157394E6B5CF51C088BB7D554B5E454035D961B394D051C0747717EFA85C454044DF2D8083D151C00CA2B1884A5B45409856C81975D251C04476E3BB395A4540AED760B3F6D251C058AF17EFDC594540D2BF60B39AD351C0D8AAE4BBB5594540B4D82D8017D551C0C8EB18EFC859454016DE94E6A1D951C0B060E5BB015A454044ECFA4C2CDE51C050587C553B5A4540AE622E80B7E251C0A84A7E55735A4540DC7094E641E751C0AC3017EFAC5A45400C7FFA4CCCEB51C00494E5BBE55A454074F52D8057F051C07CA9E3BB1D5B4540DE6B61B3E2F451C0EC0CB288565B45408C4161B36CF951C0E0F24A22905B4540B64FC719F7FD51C03CC7E5BBC95B45409E8D94E6810252C048AD7E55035C4540CC9BFA4C0C0752C0C051B0883A5C45402EA161B3960B52C018B57E55735C454026B8C619211052C0FF294B22AC5C454086BD2D80AB1452C0E82D4B22E45C4540F43361B3361952C0EC13E4BB1D5D45401D42C719C11D52C050E87E55575D4540A4832E80C31D52C050E87E55575D4540429E2D80C51D52C050E87E55575D454008B02D80C71D52C050E87E55575D45405689C719C91D52C050E87E55575D45401E9BC719CB1D52C050E87E55575D4540B4B5C619CD1D52C050E87E55575D45403AF72D80CF1D52C050E87E55575D454082D0C719D11D52C050E87E55575D454092B260B3D21D52C050E87E55575D45401EF4C719D51D52C050E87E55575D454064CD61B3D61D52C050E87E55575D45408220C719D91D52C050E87E55575D454042C1FA4CDA1D52C050E87E55575D454009D3FA4CDC1D52C050E87E55575D45405D1D61B3DE1D52C050E87E55575D45406DFFF94CE01D52C060CA17EF585D4540658E2D80DF1D52C00CD0B0885E5D45409E0161B34A1E52C010727F5517614540AE1994E6891F52C0B4A618EFBC634540288CFB4C482252C07CFC4A22F067454078C560B3D22252C09C5A18EF5869454028A72D80332352C03C964B229C6A4540088A60B3722352C0B87017EF106C454073ACFA4C982352C0A899B0880E6E45402E7A60B38C2352C0B83017EF60704540121E95E63B2352C0E80417EFE07145409A78C719C52252C088817E5537734540288CFB4C482252C0D8C34B220C7545400EAB61B3D62152C0E09B7E559B7A454001AC60B3662152C08BA4E4BBDD7C45401C4EFA4C4C2052C0ECAD18EFC87D45405577C719C11E52C0CC5218EF9C7E4540246EFA4C241E52C0937A4B22BC804540658E2D80DF1D52C0A0CCB0889A864540267594E6C11C52C0580C4A22D08D4540F240FA4C9A1C52C0C4917C55BB90454062C3FA4CFC1C52C038E417EF0C94454046B793E6FF1C52C0DC28B1889E954540F240FA4C9A1C52C068B616EFDC9A45408D8FC719291C52C0F49DE3BB919B4540589861B3DC1B52C097E5B188369C45404231FA4CBA1B52C088497D55F79C454034692D80CB1B52C0D89B4A22B89D4540E86461B3F21B52C0CCE5E4BB199E45402901C719191C52C0EC30E5BB599E4540D66861B32A1C52C0D7687D55B79E4540EAD72D800F1C52C087D0E3BB5DA045406C072E80C11B52C01059B088AEA14540495CC719451B52C070E9B288D6A24540C8B894E69D1A52C0040E7E55FFA34540768794E6D51952C0DC20B0886EA64540744AFB4CAE1952C0805FE6BB55A94540AAE860B3F01952C0F03D4A222CAE45400E7F61B3761952C06CEF17EF04C44540CFEA60B3121952C038BEB18862C745405C29C7196D1852C03483492238C945403DB2C719351652C0FC6B4A225CCC454064CC93E64D1552C07CFE7D5587CE4540CE0994E6C91452C0E8E6B0880ED1454056FAFA4C381452C0DCE4AF885ED645403CFFF94C001452C030F7B288D6DA4540EA8860B39A1352C0E0B47D552BDC454066F52D80DF1152C034DDE3BB39DE4540CE20C7190B1152C0141B7E55E7DF45402ECF60B3AA0D52C07C7FAF886EE44540C82E94E6FD0C52C098014B2278E6454048FE2D80730C52C064C67D55FBE845402D4061B3160C52C0D01718EFC0EB45408E38C819F50B52C078924B2290EE4540D2DC2D80910B52C070614A2240F145402E242E809F0A52C0C02AB088EAF3454052C294E66F0652C0D092E5BB95FC4540B622C7194D0652C060D117EF84FD4540E4242E80B70652C03071B18842FE4540C110C719450752C0D85DE4BB0DFF4540CC3AFA4C8C0752C03B9BB0881E0046400006C819290752C0D46A18EF240246403813C719730452C0987B7F554B094640D6C294E6810352C02867E4BB610D4640D0E660B3260352C0E892E5BB49124640C3C593E62D0352C05865E5BB8D1D4640A894FA4CB40252C084BDB1880E24464076E3C719490152C0F044B088AA2846407A6D2E80EFFE51C0B0017E556B2B46405CC7FA4CACFB51C0A03A17EF542C46408EE7FA4C8AF851C058CBE3BB212C4640642BC71901F751C030C218EF802C464085CB60B3CAF551C0180418EFB82D46403EFAFA4CAAF351C094D94B22A8314640B07A94E6A7F251C04F1AE5BB0133464071EA94E60FED51C0DBE47E551B384640EAF660B364EB51C0D0B1B1881A394640387FFA4CD2EA51C0A4EE4A223C3A4640CCE82D80B7E951C02F934A22043D46405AF194E687E751C028517E55A33F46405EBBFA4C4AE651C07FE24B22F0414640F1C42E803BE651C000A4B1882A44464042A52E806FE651C0E8D5B08876464640D2792E80FBE551C0F0A0AF88EE4846407C9A2D8057E551C01418E3BB91494640DC1EC7198DE451C0F4C47D558F494640491D2E80C5E351C0DBC87D55C7494640C843C81929E351C0D02D4A22144B4640D87560B332E351C07087E4BB554C4640D089C7199FE351C063E04B22A84D4640CCC961B36EE451C00C9AB188724F464018CFFA4C68E651C044DE7D55CF564640381AFB4CA8E651C05097B088AA5846402A7560B31AE751C0B8994A22F85A4640E86FFA4CFEE751C008487E55B75C4640533194E6A3E851C0CCBDB088C25E4640816F2E805DE851C09446B088F6614640266CFA4CCCE651C0605DE6BB956646406EEA60B3CAE351C0C411E3BBB96C46402AFC2D80EFE051C0147C16EF90724640F8BC2D805DE051C0E86417EFB4754640F8B42D80E7E051C084934922B8774640E02CFB4CC8E151C0300416EFAC794640AE132E803FE251C05424B288A67C4640FA77FB4C08E251C0A0B1E4BB01804640CC152E8061E151C093D57C553B814640A610DDD05FE051C040D99AF0C1814640E27B49DA42E051C030E3C235C2814640AE66DE566CE051C0484241E7BD8446409EB9FDDB4DE051C0E04A3373C7864640041EB917D3DF51C05C19F3CB8488464080EB18C438DD51C098DB3710358E46400EB272B6E0DC51C09F895595938F4640C88408338BDC51C068F1EF2EF59146402AC7903B43DC51C05023198B49934640BBA8A7066FDA51C000B104DDD4974640705D523105DA51C0E056198B3B9A46403A55495A0DDB51C09C0806DDCC9B46402CA11527BDDC51C04899C4350B9D46403E273E8315DC51C088106C43E29D4640B6F793D845D951C090E2606CEA9E4640E04E745366D851C04093AE8719A04640E17556CE88D651C0982FA213A0A346408EC47C8D65D551C07461CB6FF4A44640B2B3342CF0D351C08857973CA6A54640CAEF1FFEC6D251C0D05A53F86AA54640225B0B5066CD51C0E88BAAEA9BA046409A4BDB39D9CB51C00C1477B7D09F4640A86E75D342CA51C000FAD346759F4640C23AA80612C951C040717B544CA04640E6DF221B1BC751C044007FF1BFA446402CB6087318C651C0386A361084A6464058B207B379C551C080E7C96FF0A64640586059DA6FC551C0A44A270FF3A6464072B1FA4C30C551C0506E18EF24A046408A5DFB4CF0C451C0846617EF4C9946407212FB4CB0C451C018DC4B2274924640D28E94E66FC451C03781E5BB998B46403A7CFA4C30C451C044267F55BF844640D1EF94E6EFC351C080ADB188E67D46403ADDFA4CB0C351C0B4A5B0880E7746401A92FA4C70C351C0C84A4A22347046403A3EFB4C30C351C0ECEFE3BB596946401AF3FA4CF0C251C070F44B228062464002A8FA4CB0C251C0A00AB288A65B46401A54FB4C70C251C0B82018EFCC5446400209FB4C30C251C0E7367E55F34D4640E2BDFA4CF0C151C00C4DE4BB19474640CA72FA4CB0C151C0A0C218EF40404640E21EFB4C70C151C0C067B28866394640CAD3FA4C30C151C0D87D18EF8C324640AA88FA4CF0C051C007054B22B42B4640C234FB4CB0C051C0488C7D55DB244640322261B370C051C0503117EF001E4640929EFA4C30C051C080D6B08826174640AA4AFB4CF0BF51C0F8DA18EF4C1046409870C719B1BF51C037D317EF7409464072B4FA4C70BF51C05C78B1889A0246408A60FB4C30BF51C060AC7E55BFFB4540F24D61B3F0BE51C0A033B188E6F4454052CAFA4CB0BE51C0D0BAE3BB0DEE45403A7FFA4C70BE51C0484E7F5533E745405A9CC71931BE51C087467E555BE0454039E0FA4CF0BD51C0BCCDB08882D94540A2CD60B3B0BD51C0D0724A22A8D24540BA7961B370BD51C0F488B088CECB45401C69C7194DBD51C01418B188F6C74540B6452E8097BD51C0D0D77C55FBC345402893FA4C94BD51C0433DE4BB0DC24540F070C719BDBD51C000DDAF883AC045407225FB4CDCBD51C0E8777E559BBF4540AC2DC719EDBD51C0A849E4BBCDBE4540316F2E80EFBD51C078304B22B0BD4540BE82C719BFBD51C0E035B188D2BB45407E002E80ABBD51C0F8D87F55AFB945407225FB4CDCBD51C05CAA17EF44B8454090932D807DBE51C078DF7D551FB54540A89893E693BE51C0181CE4BB5DB44540AE1261B396BE51C0F0CA7C557BB34540B96961B384BE51C08CB07D557FB24540465A2D803FBE51C0F864E5BB09B14540D6AAFA4CEABD51C030AAE3BBF9AF4540CAB4FA4C7CBD51C06701E4BBEDAE4540FEDEC61981BB51C0686E18EF8CAB45408A63FB4C70B951C02CBC16EF04A745400DD82D8077B751C01838E5BBB1A24540883C94E6FDB451C008EF7D554BA04540821061B39AB451C0B8304A22A09F45403E2E61B34AB451C0B71518EFB49E45404AB994E611B451C068D34A22E09C454066BCFA4C0CB451C08F96B188BE9B4540765094E621B451C010174B22BC9A4540A8A960B3C6B451C0F8CF17EFDC964540DAC32E80DBB451C0A03C4C22709545400CE861B3CEB451C04067B088AA94454092B4FA4C9CB351C0CC967D557F91454092012D8067B151C06FDD17EFC08D4540EE96D1289FAF51C02F5FCF35BA8A4540,-10.9%,-15,123,4,119,New Hampshire,true
38,0106000020E610000001000000010300000001000000CD010000B6A860B392A757C087A4B088FA3F4240E8D32D8023A657C0149E17EF282E4240E307FA4CB4A457C0A0977E55571C42401033C71945A357C0C03117EF840A4240495E94E6D5A157C04B9C4A22B4F841404E032D8067A057C0E8067E55E3E64140792EFA4CF89E57C08471B18812D54140262161B3889D57C020DCE4BB41C34140A88D93E6199C57C0A0647F556FB14140740AFB4C769C57C0EC674B229C9541404E60FA4CD29C57C0BCAC7E55CB79414018DD61B32E9D57C0182117EFF85D4140F43261B38A9D57C0D383B1882642414056C1C619E79D57C0346916EF5426414018CD61B3429E57C0F0CBB088820A4140745BC7199F9E57C0B02E4B22B0EE40403FD82E80FB9E57C00C14B088DED24040BD69FA4C529F57C0607218EF00D340407EF22D80F1A057C01C9B7E551BD34040B86DC8191BA257C0F0024A2214D44040B86DC8191BA257C03C827D5533D34040EA06FB4C24A557C07B3C16EFECD440400C7E93E613A657C0A07CB288BED54040AB2CC719DFA557C0740A4A2278D64040C431C819A9A557C0EC29E5BBF1D64040E63695E607A757C0F0F116EF2CD7404084742D80B3A857C0DC4FB188B2D64040604FFB4C30A957C0EC214A22C8D74040B21EFA4CECA957C0BCC1E3BB85D84040592EFA4CCCAA57C060167D5503D940404A7094E6B7AB57C064AE16EF50D940407269FA4C20AC57C0707FE4BB41D94040C441FA4CDEAC57C030C616EFACD84040507961B34EAD57C0BCC1E3BB85D84040F9E060B3ACAD57C0EC5F4922C8D840403FB2FA4C38AE57C04C7F7F55EFD94040B4C294E655AF57C0F81017EFE0DA4040502494E659B057C068B916EFE0DD40406AE361B342B157C0539B4A2290DE40400456C7190BB257C0101716EFACDE40403CA694E6A9B357C08BFD7C5583DF404060E1C719DBB757C084A4E3BBC1E04040B96B94E641BA57C07038B088AEE440408E1294E631BB57C0A400B0887AE740407EFA2C8087BB57C010B8E4BB41E8404045B62D8027BC57C0707B7E5503E9404022ABC719B7BC57C010CBB1886AE940403E3361B31EBD57C0B8B7E4BB35EA4040CDA860B346BD57C0D404B18826EC4040E6D093E671BD57C0DC167D55C3EC404006622E80DBBD57C0676F16EF78ED4040564B94E65DBE57C0B428E4BB0DEE4040D4582D80D3BE57C09CAFB2884AEE4040C07060B30CC157C0800D17EF68EE40400E41FB4C08C257C0E8EA17EFF0EE4040D41F2E8009C357C08892B1881EF0404054C5C71915C557C000FB7D5597F340401420C81935C657C0CC8916EFDCF440401434FB4C36C857C0100B16EFACF54040109661B38EC857C0500A7E556BF6404038522E80CFC857C0883D7E554FF740407C842D8027C957C00472E4BB11F84040A48FFA4CE0C957C09C7C7E55DBF84040FA112E8019CE57C030D7E3BB41FB4040566460B326CF57C0C8F17D55F7FA404066BBC7195DD057C0307EB28856F940407158C719C1D057C0E0FAB0886EF74040D036C719D9D057C05CD4E3BB2DF54040C62761B330D157C03C8818EFC8F3404047F761B3EED157C0C4FE18EF7CF44040162C94E651D257C0A73D4B2278F34040F2FD60B3CCD257C0ECF416EFF4F24040B1EF94E661D357C0B804B2888EF24040335D94E613D457C0D8B1B188DEF140400C1EFB4CCAD457C02C81B0889AF24040A7C62E803BD557C0CC864922A0F2404080D693E66DD557C0474417EF78F1404082A060B378D557C0C8C4B08876F04040ACE960B39CD557C034237E55EBEF404022F994E6E1D557C080A3B28896EF40401F75C7194DD657C0E0F37D553FEF4040EFEF93E6D9D657C09C18E4BB21EF4040569D60B332DC57C02CE0E2BB6DEF40401E732D80E5DC57C0E0F37D553FEF40403AFBC6194DDD57C0B4D9B18826F0404078DFC619B9DD57C0CC2D18EFB4F04040CC812E8035DE57C034137E55FFF0404056CC60B3D2DE57C0C4D67C5513F1404066FF94E61BDF57C0D8C1B188CAF040405EB1FA4C7CDF57C017797D5547F040403DB7FA4CD0DF57C0F8CEB2880AF04040E43861B3F4DF57C0AC3417EF98F04040E077FA4C38E057C028F916EF38F14040C6612E805DE057C080D1B188AAF14040C0E760B35AE057C0D8B1B188DEF14040D357FA4C60E257C0244C17EFE8F140404A5F2E802FE357C0005D7D55A7F2404024C72D8093E257C0C4FE18EF7CF44040A69E93E613E357C01BE64A2278F640406E7D61B3C8E357C0FCEE4B2274F7404048A893E699E457C0B00B17EF2CF84040275694E66FE557C0307EB28856F940401DE62D8047E657C028FCE4BBDDF940401203FB4C02E757C0FFA67D55C3F8404056DDFA4CDCE757C0B452E4BB51F64040C258FA4C58E857C0FC7B7D555BF640405C1CFB4C68E957C0A016B18802F74040A68B2E809BE957C0C8D17C55B7F64040B4E2FA4C1EEB57C0082017EF5CF54040BEBE93E6C5EB57C0AF9F18EF18F5404056202E807DEC57C0FF63AF886EF44040BA67FA4C20ED57C06FD77D5593F34040E46961B38AED57C07FC1B188BEF24040F4BFC71935EE57C04CCCB088DAF24040AC6361B32AEF57C0E40918EFA4F24040B20B2E8041F157C07FC1B188BEF240409CF5C619B3F157C0B0FE4A22ECF14040526CC7196DF157C06097E4BB51EE4040AAEBC61921F257C090D47D557FED4040B65B94E691F257C05096E3BBC5ED40403BF660B3EAF257C02C73B1885EEE4040B21F61B342F357C0E0F37D553FEF404080D060B3C4F357C0887FE4BBF5EE4040284161B324F457C02C73B1885EEE4040E69CFB4C88F457C090D47D557FED40409C38FA4C54F657C0445CE4BBFDEC4040D52E61B310F757C0D4A6B1884EED404047F22D80AFFA57C0405918EF28F140406E332E805DFB57C0B4B9B1884EF2404036B0FA4C06FC57C04857E4BBA1F24040B41FFA4CD4FC57C03B1DE5BBD9F14040928760B380FD57C064BD7E55A3F040401B822E80C9FD57C00FEA7F55AFEF4040D6EE93E63DFE57C0138A7E55BFEF4040EA5661B338FF57C087CDE3BBE1EE40405D81C719690058C090D47D557FED40409E3A61B3920258C0604218EFF0EB4040F84FFA4C780358C0B0144C22C0EB4040F4E9C619BF0658C0B0144C22C0EB404052C0C619610758C077467D557BEB40400E4094E6B10858C0BCC8AF8846EA4040426C2E80630958C060D7E4BB01EA4040CABF61B3020A58C01CC24B221CE94040A0FCFA4C240B58C088BB7E55B3E440403832C719C50B58C0203C7D5503E3404047802D80F90C58C0E4EE4B22C0E1404082F2C619210E58C0183EB1888AE14040DF08C819DB1058C0D886E5BB0DE24040BEAE2D80871258C074DD7C55ABE1404098662E80EF1258C00C0C17EF84E04040AEF8C719E91258C017957E559BDE40405660C719471358C0C03CE5BBF1DB4040BB6A61B30A1558C0A038B288D6D94040A5702D80F31658C0687B17EFE0DC404028302E80C51858C0C4F54A22A4E14040E0CBC719451A58C07038B088AEE44040A8F094E66F1B58C07F76E5BB15E54040CDEE93E6C51F58C07038B088AEE440402291FB4C422058C03CED4A221CE5404084A393E67F2058C0CC4E4A2220E6404006A8C619A72058C0E8374B2250E740405691C719DD2058C010B8E4BB41E840400C2395E6352158C0985917EFCCE84040267861B39C2258C060D7E4BB01EA4040B42194E69D2258C060D7E4BB01EA40403CFAC6193F2558C020187E555BEB4040CE9394E6072658C05CE717EFC4EC4040263E61B3462658C0E0657D553BED4040A29B94E6772658C06C8A7E55CBED404078412E808F2658C010B4E5BB71EE404086B2FA4C902658C018E97E5523EF40403E6694E6712658C0C000E4BBC5EF40400A3AFA4CC02558C04F08E4BB29F2404022622D80EB2558C0B03C4A22ECF240404E482D80732658C084227E55D3F34040CCA7C719092858C0A065E3BBE9F440407C2894E6E92858C07C4A16EF44F5404068B1C7198F2958C024C2B2883EF54040502894E6E32958C0241817EFECF44040CBA894E6292A58C0F03317EF80F44040766994E6912A58C06391E3BB69F34040D6D52D80652B58C027F2E4BB71EF4040AE9E94E6912B58C03051E5BBD5EE404006F060B3C62B58C0A8914B224CEE404082A694E6012C58C014AE7E55CFED40408ED0C719492C58C0C83A4B2264ED4040F0DAFA4CC42C58C0F0D2492204ED4040727E2D806B2D58C0E8E74A22B4EC40405FC92D80A52E58C090674C2270EC40402F10C719592F58C08025B2887EEC4040358294E6E52F58C0207D4A22A8EC4040EE0A61B33C3058C0B438E4BBF9EC40407C6F61B3E83158C04F0DB28816EF4040BEB3C719913258C058F04B22A4EF4040A9C02D80173358C0CC12E6BBC9EF404034C62D805F3558C080F916EF44EF404066CFFA4CFC3558C0801CE4BB59EF4040AC7DC719733658C0B0497D559BEF4040E27D2E80C13658C03052B088FAEF4040A66DC719873758C0E0B0B08852F14040888D93E6ED3758C0A8DC7E5563F24040F07BFA4C3A3858C0C8657E55A3F3404044F293E69F3858C024CDE4BB3DF74040CEEC61B3E83858C0D079E4BB81F840405A9FFA4C383958C0E7FC7C551FF94040659EFB4CA83958C0272717EFB4F940409E4E2D80873A58C0DCC14A225CFA4040D057FA4C243B58C0782BE5BB89FA40405E022E80B13B58C0782BE5BB89FA40408A292E80E13D58C028FCE4BBDDF94040AC58C7193F3E58C0608DE4BB99F940400BA02E80953E58C0583119EF48F940401AE62D800B3F58C0880AB1884EF8404076F860B3FC3E58C02C9DB188A2F6404072C42D80233F58C028AEE4BB89F34040A9F92D80234058C0F8CEB2880AF040401A1D2E80214158C0084218EFE4ED4040CA95FA4C8C4258C00C3CB18842ED404070A761B3D04458C09CAFB2884AEE4040A07294E6B94458C0E44A4B2250EC4040D98B61B3424458C0481DE4BB71EB40408C0AC719BF4358C018A6B088CEEA404041D1C619814358C0DCD5B08886E940408C63C719C94358C0D02B4B229CE840407AAEC719034558C0A0EFE4BB69E74040121161B34A4558C03C79492208E64040F8FA94E66F4558C078907E554BE24040B2DAC619014658C0CC3717EF04DF4040250E2E80334758C0CC0918EFF0DC4040427EC719394958C0F8EC16EFD0DC40407A52C719B94A58C0D09617EF68DE4040E5B460B3FA4B58C06C527F554BE14040A45FFB4CD64C58C07038B088AEE44040B653FB4C284D58C08C277D55C7E74040C00B61B3E24C58C00C49E4BBF1E940406AE460B3AC4B58C0F0A717EF2CED4040EC1361B35E4B58C0E0F37D553FEF40408374FA4C8A4B58C0B00E4B22D8F040403CD294E6094C58C00825E5BB49F24040D42A2E80BF4C58C01CBA492284F34040D8D293E68D4D58C0C4FE18EF7CF440402B492D80F34D58C040024B2218F440409ADF94E6C14E58C0A8EF4B228CF34040E58260B31A4F58C0132F4C2224F34040E844C819634F58C02870E5BB89F24040429694E6974F58C080AEE4BB95F1404018DC2E80BB5058C0D4E4B0884EEE404072F9C719175158C090D47D557FED4040119060B3CC5258C01704B1880EF040408C3E94E6915358C0B8A1E3BB61F040405A9794E6955458C0E0F37D553FEF404048E993E6B95458C0D0C74A22DCEE40401466FB4C165558C0D8F1B1888EED40405ECC2D80475558C07CA3E4BB05ED40408C1C94E69D5558C0D87EE3BB75EC4040DCDAC719495658C0D0494A22C4EB4040841FFA4C925658C0688F16EF50EB4040AE442E80115758C07BEE16EFB4EA40405C8861B3CA5758C0488DE5BB4DEA40402AAF61B3EE5B58C0EC61E5BBD9E940404C52C819F55C58C060F216EFECEA4040764B2E805D5D58C0084218EFE4ED40407888C719855D58C038474C228CF040400CDAFA4C085E58C07C4FE4BB31F24040285A94E6F95E58C077F949221CF340400A1A61B36C6058C028AEE4BB89F34040F4D2FA4C8A6458C0245FE4BB11F340404EBB61B37C6558C04CDF7D5503F4404096DCFA4C106658C0B475B18866F64040B88F61B3026658C0803DB18826FB4040E4CE61B3946658C0848E7D554FFD4040A2F6F94C006958C0C8344C224CFF4040685361B3846B58C0A8D67E55E3FD4040E98E94E6C16D58C028BDB288E2FA40407CF62D803F7358C0E4CB18EFA4F1404056A6FA4CC67558C0F8A17E551BEF40403C0F2E80937858C09CAFB2884AEE40409F96FB4C4E7B58C0A4AD7E55C3EF4040515FC719C17C58C0F87D7E550BF140401A8C94E6617D58C0B4B9B1884EF24040E057FA4C3A7D58C0786C18EF34F440406C1D94E61D7D58C020594B2200F5404045DD94E6FB7C58C0B452E4BB51F640407A4661B38C7C58C04816B188F6F84040425861B38E7C58C0306AB28832FA404045DD94E6FB7C58C0346F7D558FFB40403A3794E6957C58C074B4492210FD4040C45C94E6B57C58C0F4DD4B2264FE404050E4FA4C2E7D58C0685DB28866FF4040F49394E6D17D58C0D45F7E5523FF40402A4F2E80178058C0585917EF74004140BE402E803B8358C0D807B088860141407600FB4CA88558C0F4894B229003414060912E80C38558C0E8974A22CC07414060EA93E6198658C0F0CBB088820A4140284C2E80D78558C0A4A24A22500E41402AF32D80CD8558C018777D55B31141403E1CC719D18658C0F43F4B222813414086DD60B3708858C0507F4B22C0124140AEB5C719718B58C0003119EFF0104140ECD8C719698D58C06C7019EF881041406859FA4CF89558C04C5318EF5C124140A2A9C719979758C0EC1EB2889A1141406888FA4C989858C0D4537D55BB0F41406CE060B35E9958C0C44B4A22680D414030A5C7194D9A58C07BF4B1884A0B4140BCB961B3A89A58C0DB4C18EF1C0A4140CCD1F94C349C58C0B81B7F55A3094140BEE02D80679F58C0C8097D559F094140BC5D61B35EA058C054E9E4BB910A414012A994E681A258C044F27D55B70E41405E2A94E651A358C060E3E3BBA90F41406A2995E6C1A358C0C0067F555B10414054D5FA4CC8A458C030DEB0886A13414049E9C61981A558C038134A221C14414042AFFA4C96A758C06012B288DA144140CC3FC7195DA858C0505F4B22E81441405AB52D80CDA958C04C104B227014414052252E8015AE58C0A44318EF7C114140D6442E80DBAE58C02C494C2230124140126E94E6E1B658C0001C4B2218154140B288FA4C2CB858C088324A22DC1541404E35C819FBBC58C06C3DE5BB191B4140A24261B36ABE58C0CC8BB288A21B41404D8FFA4C72BF58C0D44D7D553B1B414022DFF94C74C058C03066B088861A4140754C94E6D3C158C0D0ECB088261A4140BEABC7191BC358C09C4F4C22701A41402C9BFB4C88C558C0BCD84B22B01B4140889D93E6D9C658C0B4CFAF88FA1B41404BCF2D80D3C958C04B9C4A22C41B4140C962FB4C42CB58C0C04A19EF3C1C4140A8B760B35ACC58C0047EE3BBB91D414055B594E69DCC58C058A64922C81F4140646CFB4CC8CC58C028B3B088B626414070EE2D808DCC58C05816E4BB352841407C2061B34ACC58C004FBB1883E2941407D6060B366CD58C014E017EF7C2B4140F9EB2D805FCF58C084654A22682E414089602E80F7CF58C0906417EF6C304140DCD6C7195DD058C020AEB188C2324140750C94E6FDD058C02007E3BBAD344140C5DC93E645D258C054C4B0887A354140B13095E681D358C037A5E3BB9D35414034CBC61927D458C04C7F17EFDC3541406E2B94E6B1D458C0FCB0E3BB453641408B7FFA4C40D558C050C67C552B37414040EEFA4C84D558C0301118EF18384140BC422D80B3D558C090B5E4BBFD384140223A95E601D658C09C7E17EFC4394140D7C3C71931D758C0309B7D552B3B41405C7060B326D858C00859E3BB393B41403B88C719CBD858C09C9019EFC83941407913C7192DD958C0745AE3BB693341403E5CFB4CB0D958C0C8E916EF7431414006E22D80A7DA58C030624B22B0304140C5F794E629DC58C07C717D55F3304140AB3B94E67DDD58C0406316EFD4314140B8BF94E6EFDF58C0B4367E5513344140C6A560B306E358C0D8D07E55CB344140693B2E8097E358C0AC02B088863441405C1261B328E458C030324B22EC33414017412E80E5E458C010D47D5583324140C15A2E8057E558C030A44A22E831414010B861B382E658C00C3F19EF48314140A937FB4C62EA58C030A44A22E83141406432FA4C92EB58C020B616EF84324140A04B2E8063EC58C0A03118EFFC334140003DFB4CA4ED58C014AFE5BB25374140C40A61B372F858C0C4A97E554F484140C6252E8011F958C0D0317D55034941407D9EFA4C7CFA58C01C287F557349414086D193E611FB58C05BCF4A22044A4140614B61B30EFC58C0E05FB2887E4A414080C561B3EEFE58C014D1E3BBD14941402C09FA4CF4FF58C080EA17EFA84941402C09FA4CF4FF58C088A24922F84A4140AAD994E6F5FF58C06F71B188E65041400195C719F9FF58C0A87EB188725F414087D62E80FBFF58C0E08BB188FE6D4140AC9A60B3FEFF58C0180A7E558B7C4140724495E6010059C050177E55178B41409708C719050059C07CB3B188A299414024BBFA4C080059C05CD2AF882EA84140FB3DC7190B0059C09F507C55BBB64140102961B30E0059C0D85D7C5547C541406CE493E6110059C0843B17EFD4D34140F496C719150059C0AC667E555FE2414049E12D80170059C07014B088EAF04140A69C60B31A0059C034F24A2278FF4140344F94E61D0059C0508E7E55030E42408399FA4C200059C0987D17EF901C4240988494E6230059C0E88A17EF1C2B42406C0761B3260059C010274B22A8394240EE3FC719270059C0A0157D55FB3F4240B61E95E6DB0059C0B07AE4BB01404240100A2E80570459C0B07AE4BB01404240BB46C719730659C0B07AE4BB01404240CCC4FA4C680C59C0B07AE4BB0140424035A12E80A91559C0B07AE4BB01404240CAE360B3AA2159C0C05C7D550340424084C760B3DE2F59C0C05C7D55034042407F4B2D80B93F59C0DC3E16EF04404240C9832D80AD5059C0DC3E16EF04404240202EFB4C2E6259C0DC3E16EF04404240B8A861B3AE7359C0DC3E16EF044042409019C819A38459C0DC3E16EF04404240839D94E67D9459C0409EE4BB05404240448194E6B1A259C0409EE4BB054042404D8B60B3B2AE59C05C0FB1880640424042A0FA4CF4B759C05C0FB18806404240CCE5C719E9BD59C05C0FB1880640424070B194E603C059C04B0FB1880640424006CC93E605C059C0E0324B2204504240134661B308C059C0E4854A22006042406290C7190BC059C067C74B22FC6F424030A2C7190DC059C088FCE3BBF97F42403D3694E625B859C088FCE3BBF97F4240CC91FA4C3EB059C088FCE3BBF97F424059ED60B356A859C088FCE3BBF97F4240970762B36EA059C088FCE3BBF97F4240EC6BC719879859C088FCE3BBF97F42407BC72D809F9059C088FCE3BBF97F424081EA2D80B78859C088FCE3BBF97F4240ED4DFB4C888259C088FCE3BBF97F4240947060B3067259C088FCE3BBF97F4240C359C7193D6359C088FCE3BBF97F42403C13C719735459C088FCE3BBF97F42405D8B61B3A84559C088FCE3BBF97F4240540CFB4CDE3659C088FCE3BBF97F424094CEF94C142859C088FCE3BBF97F4240BC4694E6491959C088FCE3BBF97F42403A0094E67F0A59C088FCE3BBF97F4240E2B094E6B5FB58C088FCE3BBF97F4240D8312E80EBEC58C088FCE3BBF97F424082E22E8021DE58C088FCE3BBF97F4240416CC71957CF58C088FCE3BBF97F4240B925C7198DC058C088FCE3BBF97F4240DF9D61B3C2B158C088FCE3BBF97F4240DA8FC719F9A258C088FCE3BBF97F4240010862B32E9458C088FCE3BBF97F424047CA60B3648558C088FCE3BBF97F424078B3C7199B7658C088FCE3BBF97F4240ED6CC719D16758C088FCE3BBF97F42406626C719075958C088FCE3BBF97F42408E9E61B33C4A58C088FCE3BBF97F42404D28FA4C723B58C088FCE3BBF97F4240FCD8FA4CA82C58C088FCE3BBF97F42407492FA4CDE1D58C088FCE3BBF97F4240641394E6130F58C088FCE3BBF97F42400DC494E6490058C088FCE3BBF97F4240CC4D2D807FF157C088FCE3BBF97F42407CFE2D80B5E257C088FCE3BBF97F4240727FC719EBD357C088FCE3BBF97F4240EA38C71921C557C088FCE3BBF97F42401A222E8057B657C088FCE3BBF97F4240111494E68DA757C088FCE3BBF97F4240C943FB4C8EA757C0E885E4BBF96F42409855FB4C90A757C0D420E3BBF95F4240A6C6C71991A757C027AAE3BBF94F4240B6A860B392A757C087A4B088FA3F4240,2.0%,7,358,98,260,Oklahoma,true
40,0106000020E6100000010000000103000000010000004C0100007A6FFB4CBCAC52C00CA2E4BB99AD44405699C719B5AC52C0B43E16EF60AD44409AEFF94CFAAD52C077D37D551FAC4440C83861B366AF52C010C3E5BBFDAB44408A4461B30EB052C038CCB0889EAB4440A4A12D80EBB052C028D74A2274AA4440528C60B39AB152C0EC8AE4BB55AA44402C2194E6EDB152C0A046E3BBF9A944403628FA4C20B252C018287F5573A94440AC51FA4C78B252C088CEE4BB31A844408AC160B39AB252C0301917EFD4A74440AAFD2D800FB652C07CFF17EFF0A24440785E2E8089B652C0E4D94B223CA144404E3AFB4C96B652C07F53E6BB55A04440DEF5F94C34B752C01B09B088C69C4440EB55C719B9B852C00FAFE5BB259744402E222E800BBC52C06FEEE4BB559044400EC72D80DFBC52C027754A22488F4440408A60B352BD52C0FC47B188068F4440D6212E80FFBD52C080F47D55678E4440109CC7199DBE52C0B0367D55AB8D44408E13C719E1BE52C0C424B1880E8D4440A23494E6D9BE52C0940F7D557B8B44407E312E80DFBE52C0FFE216EF288B444050A394E61DBF52C08C4FB088028B44400AF0F94CBAC152C07096E5BBFD854440045CC719EDC252C06BF7E3BB818444402E9C2D8057C452C0105C7D55EB83444095F560B34AC552C014D9E4BB4D8344402A8E94E6CFC652C01C0BB188C2814440702A61B33EC852C07F4D4B22C07F4440DC44FB4CEEC852C0F40C17EFB87D4440AF8A2E80C9C852C0A0F77D55D37C444008112D8067C852C0E824B288CE7B444067F7C719A9C752C05FB0AF883A7A44401A4B60B39AC752C010C74922B8794440BEB2FA4CACC752C0B4CC18EF24794440D39493E6ADC752C04C8F16EFAC7844407AF3C71971C752C00491AF887A7844400100FB4C0EC752C047A97D557378444022A1FA4CB0C652C0ACC2B1884A784440D617FB4C6AC652C024737E55E3774440A2B62E804FC652C044DF4922207744409B672E80D7C552C0A84E18EF0C76444063322E80D7C452C080827D554F7444406E7FC719EBC352C0380818EF1C7244402AC094E6AFC352C0507217EFA86F44401649C81955C452C0882717EF746D4440BE58C81935C552C06036B188826C4440525160B3FAC552C07CE2AF88466B4440A2B62E804FC652C0679418EF3068444046C72D80BFC652C030277E55D7654440DB812D80CDC752C0003917EF906444404AB794E61BC952C0183517EF5864444028BEFA4C48CA52C0FCD916EF2C654440A84761B3DCCA52C00CDCAF8806634440C41FFA4C4CCB52C0FBBB17EF046244400AD7C719C5CB52C0BCD717EF986144400E51FA4C14CC52C070D04A221861444086F5C619FFCB52C08CD4E5BB09604440A6A1C719BFCB52C038AD4A22205F4440E4DBC6198DCB52C0B83CB1880E5F444094EBC6196DCC52C080354C22645B4440240762B3AECC52C0ECFD7D55AB59444046742E8077CC52C0FF0018EF10584440A6F0C71937CC52C028EFB088C6564440363094E669CC52C0802DB088D255444046742E8077CC52C054C217EF9054444002ACFA4C3ACC52C0AC8216EF84504440B8DBC61987CC52C0E0644A22404F4440204EFB4C68CC52C0B0D6E4BBE94D44406CDFFA4C24CC52C0000718EF904C444010D5C719A9CB52C0600AB288024944409ACD93E6D9CA52C0139E7D557B484440DC44FB4CEEC852C0C4A417EF0C494440DA8961B3AEC552C0683C7E5577474440360595E695C452C0907949221444444046982D801FC452C078FA17EF1C3A4440D9D693E679C352C010D5B088BA3744402EBE2D804BC252C0C4BD4B2224354440C415FA4CE0C052C078D74922A03344403E2A61B35EBE52C0D07C17EF1035444010ACC71989BD52C034084B22E4324440DAF294E6A7BC52C0B8F417EFF42D4440BA2994E64FB952C0C0CBB08866294440EB55C719B9B852C05C3CE5BB312844408C04FB4C84B852C0FC784B227027444011E393E659B652C014ECE2BBB9224440E2E060B35AB452C07B9817EFF01E4440829EC719F1B052C090F27E55671A4440C21594E651AF52C050E8E4BBA917444005BA94E6A1AE52C048F618EFE4144440F47660B36CAF52C0B4F517EF64124440728660B346B152C03871B0889E104440711661B366B352C054754B22900F44401CB4FA4C02B552C08872B188360F4440901C94E69DB552C04B6BE4BBB50E44404246C719D9B752C0F310E4BBA10B4440C6E9F94C80B852C0D0DF4A22280B4440070CFB4CE8BA52C098857D55F709444072B52D80E3BB52C0C01DB288FE08444078E22D8067BE52C0943419EFA4044440D2A7C71945BF52C0C04EE5BBBD03444044CD277E82C152C0A811D135160244409CDD267EFAC252C00081CF352A014440AE44277E1EC552C0B0C5CF3542FE4340362D7CD38DC652C0B8107BE0A4FD4340F84AD228A9C752C0244FD035B2FC4340DC0A7CD381C852C0D0B2CE3562FA4340D07CD128E1C852C0838D258B7FF7434004D97CD389C852C03C3CCF35D2F44340735AD12875C952C0F835248B87F343403CBB267E4ECD52C05F7479E054F143400E67277EEACF52C0B0C5CF3502EF43409ADD267E7AD152C06C0AD0359AEE4340061C7CD307D352C0687479E094EF434074A57CD3F7D652C030B6D03596EC434076A57CD317D852C0FC80CF352AEC43404C947CD311D952C064BF248B77EB434087DBDB642ADB52C0F449A81D3FE7434094F960B336DB52C008B1B1884EE7434028D8C7199DDB52C04847B288CEE743409F1394E691DC52C09816B1888AE843406020FA4C12DE52C0A86B18EFA4E94340F4DBFA4CACDF52C0B4A917EFA4EA4340842FFA4CE0E152C084F7B1883EEB4340EAD093E6ADE452C030AF4B2258EB4340CAFBC7197BE652C084F7B1883EEB4340CE432E8055E852C0C0824A2258EA4340E898FA4CBCE952C0A86B18EFA4E94340D3682E8063EB52C0B0957F5557E84340E889C719F1EC52C038B116EFA0E64340DE6061B3CAEE52C0776FB28822E443403EF12D808BF052C0C8F27C553BE043407840FA4C9EF152C0F498E5BB7DDC43407242FA4CBAF152C0AC9A7E554BDC4340D4C6FA4C38F252C09064492254DC434078117D2379F252C0F7694F2954DC43402A702E809BF952C090D515EF54DC43400849C719FD0053C090D515EF54DC434026FBF94C600853C090D515EF54DC43406C3361B3C20F53C090D515EF54DC43400AAD2D80251753C090D515EF54DC4340D81DFB4C881E53C07494B28856DC4340F55E61B3EA2553C09C764B2258DC4340141194E64D2D53C09C764B2258DC4340E18161B3B03453C09C764B2258DC4340409360B3123C53C09C764B2258DC43400D042E80754353C09C764B2258DC4340AB7DFA4CD84A53C0AC58E4BB59DC434000272E803B5253C0ACC9B0885ADC43409EA0FA4C9E5953C0ACC9B0885ADC43402DA9FA4C006153C0ACC9B0885ADC434082522E80636853C0ACC9B0885ADC43409A9394E6C56F53C0ACC9B0885ADC4340AFD4FA4C287753C02C9A4B225CDC4340CE862D808B7E53C0387CE4BB5DDC4340A2F7FA4CEE8553C0387CE4BB5DDC43403971C719518D53C0387CE4BB5DDC4340D6EA93E6B39453C0387CE4BB5DDC43409EEA94E6159C53C0387CE4BB5DDC4340346461B378A353C048EDB0885EDC43401046FB4CDCAA53C0485E7D555FDC4340EE1E94E63DB253C0485E7D555FDC43400CD1C619A1B953C0485E7D555FDC4340DA4194E603C153C0485E7D555FDC434078BB60B366C853C0485E7D555FDC4340462C2E80C9CF53C0584016EF60DC43405C6D94E62BD753C038FFB28862DC4340AAA5FB4C8EDE53C038FFB28862DC4340F24894E6E3E653C0584016EF60DC4340FA8C60B33AEF53C0485E7D555FDC4340AA1EFB4C90F753C03CEDB0885EDC4340F0C193E6E5FF53C02C7CE4BB5DDC4340A7C4FA4C3C0854C01C9A4B225CDC4340285F94E6911054C0A0C9B0885ADC434070022D80E71854C0A0C9B0885ADC43402E0594E63D2154C09C58E4BB59DC4340EEA5C7193F2154C0E04C7D5543E543407C4FFA4C402154C02CB2E2BB2DEE434074E72E80412154C04F6518EF18F74340FC9061B3422154C0A0CA7D5503004440FC9061B3422154C08C2F19EF480A44401173FA4C442154C0A846E4BB8D144440D8132E80452154C0342E4A22D41E444060BD60B3462154C03093E5BB19294440585595E6472154C0588C492260334440E7FEC719492154C053F1E4BBA53D4440FCE060B34A2154C0E0677E55EB4744403B492E804B2154C0DCAEB288325244403B492E804B2154C0F0A116EF445244403B492E804B2154C0E0E24A22585244403B492E804B2154C070357D556B5244403B492E804B2154C05376B1887E5244403B492E804B2154C0E4C8E3BB915244403B492E804B2154C0C8984B22A45244403B492E804B2154C0487AB188B65244403B492E804B2154C02CBBE5BBC95244403B492E804B2154C0380E17EF346044403B492E804B2154C0A74F4A22A06D44403B492E804B2154C0886118EF0C7B44403B492E804B2154C088B44922788844403B492E804B2154C05873B288E29544403B492E804B2154C0C825B2884EA344403B492E804B2154C0C778E3BBB9B044403B492E804B2154C0A419E5BB25BE44403B492E804B2154C0A4FB492290CB44403B492E804B2154C0043D7D55FBD844403B492E804B2154C0E4DD7E5567E644403B492E804B2154C0F4A17C55D3F344403B492E804B2154C0844255E002FE4440AF22EB44171E54C0042390219FFF4440D818ADD5121D54C0E438F115E70045406E4864DE1C1C54C098A9F6EFC401454098AABF8A0D1854C03099093F030345400FB69EEA7B0D54C034997858D40B454066EBFCAFA50B54C08C05B406340E454008AD6800150B54C09411D78B770E4540C8FBE960670A54C0C4C2552B250F454068B1322C930954C0706D25891512454078CC65D1F60754C0648FA902A11345407CAF808FED0654C0DCFDC9C63F154540BE6F0F4FBB0554C00C2E56DB4D164540444AC92E4F0454C00C97025C66154540ECAEAB83E90454C007F48B573B14454096D6D6B9940554C08828E297C7134540A80B0206250754C0F8DB454DB413454022511A03770754C05C83867D5D1345405D882A65460854C048C8C96EAB1145406A1ADFACAB0854C0E48935BF1A1145406A1ADFACAB0854C054A645F51F10454058E5B3601B0754C0DB7D123AD71045401668B6F5F50354C06C9BCC87E4134540049014A53A0154C00C97025C66154540C41E3ABF58FE53C0ECF25059041945406EA6DB8BB5FB53C0D808B24D4C1A4540C6819DF0E6F853C0A84CBA40631D45404C78C819D5F053C0D4C050A05E2245404C78C819D5F053C0F4A4E4BB252245404C78C819D5F053C0CFAFB0886A1E45404C78C819D5F053C02B8B17EFB01A45404C78C819D5F053C078F5B188F61645408D4861B3D4F053C0D05F4C223C13454056E093E6D3F053C0BBDBE4BB810F454056E093E6D3F053C098E6B088C60B454056E093E6D3F053C0E4DF7E550B08454056E093E6D3F053C0D0CCE3BB51044540CEA72D80D3F053C0C0A77C55FBFF4440366794E67FEE53C0C0A77C55FBFF4440CE8B61B3CAE553C0B036B088FAFF4440E6E894E615DD53C088E34A22F8FF4440CB4EC71961D453C008A2E3BBF5FF4440E3ABFA4CACCB53C0EC4E7E55F3FF4440FB082E80F7C253C0D8FB18EFF0FF44409A9EC71943BA53C0D05AE3BBEDFF4440FACB93E68DB153C0CC077E55EBFF44401229C719D9A853C034C616EFE8FF4440B2BE60B324A053C02073B188E6FF444048E32D806F9753C0F81F4C22E4FF4440A810FA4CBA8E53C008F0E2BBE1FF4440FAD5FA4C068653C0E82BB188DEFF444090FAC719517D53C068EA4922DCFF4440A857FB4C9C7453C04097E4BBD9FF444048ED94E6E76B53C03B447F55D7FF4440B68B2D80336353C0401416EFD4FF4440C07794E67D5A53C014DF17EFD0FF4440E64594E6C95153C09F0E7D55CFFF4440BE3AFA4C144953C0674A4B22CCFF4440D6972D805F4053C05768B288CAFF4440FB652D80AB3753C068C77C55C7FF44408E8AFA4CF62E53C058E5E3BBC5FF4440EEB7C619412653C0B0C1E3BBC1FF4440447DC7198D1D53C0A0DF4A22C0FF4440DCA194E6D71453C0801B19EFBCFF44406CC661B3220C53C0A05C7C55BBFF4440929461B36E0353C080984A22B8FF44406C89C719B9FA52C058B6B188B6FF444089E6FA4C04F252C0C892B188B2FF4440AAB4FA4C50E952C0BCB018EFB0FF44403AD9C7199BE052C0C80FE3BBADFF4440A87760B3E6D752C0B09E16EFACFF4440A2BD2E807BD652C0904BB188AAFF444010B394E6B1D552C0904BB188AAFF44408ACA2D80B9D552C07CE47D55F3FD44409876C71931D452C0F08F7F552FFC4440229BFA4C30D252C05C7F7E55C3FA444056E994E6D5D052C010CE4B2258F944409E07C81975D052C0F060B188FEF64440724DFB4C50D052C017F618EFC8F3444010B694E6F1CF52C048A5B188F2F04440BCCB2D80E3CE52C0F4E57C55BBEF4440D9D460B35ACB52C09884B0889AF04440965361B38ACA52C068237F5533F044403C96C71923C952C0A7E64A2264EE4440BAF993E665C752C078A27F556FED44408AE760B37AC652C06C5918EF08EB4440167FC719DFC552C0E04619EF7CEA44404C2D2D800DC552C0B092B188FEE944408063C71951C552C094A9B088CEE84440B8E7C719C9C652C09728B1880AE64440EC8561B376C552C0885618EFF4E444406C04FB4C58C452C0A097B1885AE44440788E2D8093C352C09CA24B2230E34440D549FB4C4AC352C090BCE4BB65E044406889C7197DC352C0BCCD4A2230DF44400828FB4C5CC452C0AC8AE5BB19DE444052972E808FC452C000607D55E7DC44402AC094E6AFC352C00340B2880ED844403AA22D80B1C352C0F08DE3BB69D544404C482E8017C452C0307E7D55CFCE444058942D80E7C352C0901318EF7CCD44401C84FA4C18C352C0C8954A2248CC4440621CC819DDBF52C0B786E4BBC5C14440D65F2D80FFBE52C0586F4922C8BF4440BA13C719E7BD52C0E0947D5553BE4440FC5DFA4C0CBB52C088C87D5543BD44405671C71941BA52C0331B4B2210BC44408C44FA4CA0B952C0E8E64922A0BA4440EB55C719B9B852C058107E5563B94440DEA5FA4C2CB752C0B04A18EFE4B844401E37C7190BB452C0A8537E5533B94440DA3094E6CDB252C0985E18EF08B84440C29493E6F9B152C0C0217F55E7B64440646593E64DB152C0248DB288E2B64440C4BEFA4CACB052C09B297F5557B7444052DA93E6F1AF52C084DF7F55A3B7444026C761B376AF52C0E47D4A2238B74440CCF0C61921AF52C0E43F4B2238B6444005BA94E6A1AE52C0F0F3E4BB25B44440B0FD60B312AE52C0D4DBB188E6B24440067B94E615AD52C004AE17EF24B044407A6FFB4CBCAC52C00CA2E4BB99AD4440,-17.4%,-239,"1,136",48,"1,088",Pennsylvania,true
33,0106000020E6100000010000000103000000010000004001000070B194E603C059C04B0FB18806404240CD6594E6B1C259C0C74BB288F23F42408C3CFB4CA8C259C0742BB188A63D4240E9F72D80ABC259C0E8C1E3BBA1394240B0622E80B7C259C0A020B288D627424040D62D80C3C259C0D8907E550B16424016B2FA4CD0C259C0247217EF40044240645561B3DCC259C0687117EF74F241402CC061B3E8C259C0A07017EFA8E04140FB9B2E80F5C259C0E751B088DECE4140910F2E8001C359C030C27C5513BD4140A14AC7190DC359C06C32492248AB4140EEED2D8019C359C014204B227C9941403D9194E625C359C0CCEFE5BBB1874140DC7560B332C359C014D17E55E77541401BA8FA4C3EC359C04C5FB2881A6441406B4B61B34AC359C078CF7E554F5241403F272E8057C359C0406FB088824041404962C71963C359C0F83E4B22B82E41409E052E806FC359C04CAF17EFEC1C414064702E807BC359C0771FE4BB210B4140F5E32D8087C359C0307EB28856F940409AC8F94C94C359C05C0CE6BB89E740406133FA4CA0C359C0A07CB288BED54040299EFA4CACC359C0DB7BB288F2C34040F879C719B9C359C0245D4B2228B24040C6E4C719C5C359C0783EE4BB5DA040405658C719D1C359C0B03DE4BB918E4040A4FB2D80DDC359C0EC3CE4BBC57C40406C662E80E9C359C018ADB088FA6A40407BA1C719F5C359C0D07C4B2230594040C9442E8001C459C024ED17EF64474040DFF093E60DC459C0407B4B2298354040F62B2D8019C459C098CDB088CE234040C507FA4C26C459C0EC3D7D550312404014AB60B332C459C0183D7D5537004040EA79FA4C6AD259C0FCE917EF34004040F13F95E6A1E059C0E896B28832004040D7E7C619D9EE59C050554B2230004040DEAD61B310FD59C0BF314B222C0040402D4495E6470B5AC0300E4B2228004040D21B2E807F195AC008BBE5BB250040406882FA4CB6275AC088797E5523004040F080FB4CEE355AC0F8C64A22200040408EE7C71925445AC07885E3BB1D004040E4EEC7195D525AC050327E551B0040407B5594E693605AC034DF18EF180040405995FA4CCC6E5AC0B49DB188160040402F6494E6037D5AC030EB7D551300404005332E803B8B5AC0B41AE3BB110040401DD260B372995AC09456B1880E004040F3A0FA4CAAA75AC068927F550B00404065A994E651A95AC0E8C1E4BB09004040900DC71961AA5AC0E8C1E4BB09004040736161B354AA5AC0F0229444C0FB3F407C32C819FDA85AC0DFAE2FDE81F23F40CF11C719A5A85AC0988231DE11ED3F40284061B378A85AC09F53C87733E73F4062502D80FFA75AC05FC5CA77B3E23F40E9F993E66BA65AC0A1029944E0DA3F40BD5A94E6E5A65AC0807F9744F8D83F40D467FA4C72A65AC0281E984400D63F40AF52C819DBA55AC0F04FC577C3D33F40F994C7191FA55AC0A0BCF9AA56D23F407502FB4C3CA45AC03F802EDED1D13F40BDDB94E63DA45AC03F802EDED1D13F408EE32D8065A35AC0D8BBC977EBCF3F404796A52963A05AC088248EA52FC53F40879D8C9E19A15AC0AF4A9F5319C63F4049393B26C6A35AC00F519EB61CC63F40232850546EA55AC0F70B991920C63F405E55A5A915A75AC06012987C23C63F405731B9D7BDA85AC090D391422AC63F403120CE0566AA5AC010DA90A52DC63F406B4D235B0DAC5AC0BF4F866B34C63F4064293789B5AD5AC0BF4F866B34C63F403E184CB75DAF5AC0A00A81CE37C63F405A58A20C05B15AC0F0CB7A943EC63F405434B63AADB25AC040D279F741C63F402E23CB6855B45AC01F8D745A45C63F4028FFDE96FDB55AC0889373BD48C63F40622C34ECA4B75AC0684E6E204CC63F403C1B491A4DB95AC02FC463E652C63F4036F75C48F5BA5AC02FC463E652C63F400AE671769DBC5AC098CA624956C63F40E4D486A445BE5AC0CF8B5C0F5DC63F40DDB09AD2EDBF5AC031925B7260C63F40B89FAF0096C15AC0184D56D563C63F40AB7BC32E3EC35AC07F53553867C63F40EBA81884E5C45AC0470E509B6AC63F40BF972DB28DC65AC02784456171C63F40B97341E035C85AC02784456171C63F40DAB39735DDC95AC08F8A44C474C63F40AEA2AC6385CB5AC028523DED7EC63F40A87EC0912DCD5AC028523DED7EC63F40826DD5BFD5CE5AC0100D385082C63F40C29A2A157DD05AC0601337B385C63F40B6763E4325D25AC058CE311689C63F4090655371CDD35AC0204427DC8FC63F40CA92A8C674D55AC0704A263F93C63F40C46EBCF41CD75AC0B80B20059AC63F409E5DD122C5D85AC0B80B20059AC63F401CF586E46CDA5AC09FC61A689DC63F400ED19A1215DC5AC071D3182EA4C63F4007ADAE40BDDD5AC0508E1391A7C63F40E29BC36E65DF5AC0FF030957AEC63F40FEDB19C40CE15AC0680A08BAB1C63F40F7B72DF2B4E25AC048C5021DB5C63F40D1A642205DE45AC0AFCB0180B8C63F40CB82564E05E65AC08086FCE2BBC63F409E716B7CADE75AC0C747F6A8C2C63F40786080AA55E95AC0304EF50BC6C63F40723C94D8FDEA5AC0304EF50BC6C63F40472BA906A6EC5AC0F7C3EAD1CCC63F408758FE5B4DEE5AC05FCAE934D0C63F407A34128AF5EF5AC04085E497D3C63F40542327B89DF15AC0908BE3FAD6C63F404DFF3AE645F35AC07046DE5DDAC63F408F2C903BEDF45AC0BF07D823E1C63F40631BA56995F65AC0280ED786E4C63F405CF7B8973DF85AC0280ED786E4C63F407D370FEDE4F95AC0F083CC4CEBC63F405826241B8DFB5AC0CF3EC7AFEEC63F404B02384935FD5AC01F45C612F2C63F408B2F8D9EDCFE5AC0874BC575F5C63F405F1EA2CC84005BC06806C0D8F8C63F4059FAB5FA2C025BC0A0C7B99EFFC63F4033E9CA28D5035BC020CEB80103C73F4092031F7E7C055BC020CEB80103C73F4067F233AC24075BC0B0FEA82A0DC73F4041E148DACC085BC0B0FEA82A0DC73F40820E9E2F740A5BC0F7BFA2F013C73F400FAC71361D0C5BC060C6A15317C73F4030ECC78BC40D5BC0AFCCA0B61AC73F4030ECC78BC40D5BC0381E70204EC53F4030ECC78BC40D5BC0E06F3F8A81C33F4030ECC78BC40D5BC067C10EF4B4C13F4030ECC78BC40D5BC0F012DE5DE8BF3F4030ECC78BC40D5BC098A9B26418BE3F4030ECC78BC40D5BC0880181314FBC3F4030ECC78BC40D5BC01053509B82BA3F4030ECC78BC40D5BC04F9E20A2B2B83F4030ECC78BC40D5BC0D734F5A8E2B63F4030ECC78BC40D5BC0C78CC37519B53F4030ECC78BC40D5BC070DE92DF4CB33F4030ECC78BC40D5BC0187567E67CB13F4030ECC78BC40D5BC020123B50B0AF3F4030ECC78BC40D5BC0A7630ABAE3AD3F4030ECC78BC40D5BC0D0AEDAC013AC3F40952A08B3C30D5BC0D84BAE2A47AA3F40E37B49DAC20D5BC0475878F77DA83F40E37B49DAC20D5BC008EF4CFEADA63F40E37B49DAC20D5BC078401C68E1A43F40E37B49DAC20D5BC01F92EBD114A33F40E37B49DAC20D5BC0A8E3BA3B48A13F40E37B49DAC20D5BC0B0808EA57B9F3F40E37B49DAC20D5BC040D25D0FAF9D3F40E37B49DAC20D5BC0601D2E16DF9B3F40E37B49DAC20D5BC06FBA0180129A3F40E37B49DAC20D5BC0100CD1E945983F40E37B49DAC20D5BC0995DA05379963F40E37B49DAC20D5BC029AF6FBDAC943F40E37B49DAC20D5BC0B0003F27E0923F40E37B49DAC20D5BC0D9E2172E10913F40E37B49DAC20D5BC06034E797438F3F4043BA8901C20D5BC0E985B601778D3F4043BA8901C20D5BC090D7856BAA8B3F4043BA8901C20D5BC0186E5A72DA893F4043BA8901C20D5BC0BFBF29DC0D883F4043BA8901C20D5BC0B117F8A844863F4043BA8901C20D5BC057AECCAF74843F4043BA8901C20D5BC0E0FF9B19A8823F4043BA8901C20D5BC04F0C66E6DE803F4043BA8901C20D5BC0F0A23AED0E7F3F4043BA8901C20D5BC098390FF43E7D3F4043BA8901C20D5BC03F8BDE5D727B3F4043BA8901C20D5BC02FE3AC2AA9793F4043BA8901C20D5BC04F2E7D31D9773F4043BA8901C20D5BC0D87F4C9B0C763F4043BA8901C20D5BC0E71C200540743F4043BA8901C20D5BC0706EEF6E73723F408A0BCB28C10D5BC0F7BFBED8A6703F40F7490B50C00D5BC027A297DFD66E3F40F7490B50C00D5BC0B0F366490A6D3F40F7490B50C00D5BC0504536B33D6B3F40F7490B50C00D5BC0D796051D71693F40F7490B50C00D5BC0802DDA23A1673F40F7490B50C00D5BC0F039A4F0D7653F40F7490B50C00D5BC0FFD6775A0B643F40F7490B50C00D5BC0202248613B623F40F7490B50C00D5BC0DFB81C686B603F40F7490B50C00D5BC0D010EB34A25E3F40F7490B50C00D5BC04062BA9ED55C3F40F7490B50C00D5BC07FAD8AA5055B3F40F7490B50C00D5BC0874A5E0F39593F40F7490B50C00D5BC0F85628DC6F573F40F7490B50C00D5BC0A0EDFCE29F553F403E9B4C77BF0D5BC0273FCC4CD3533F40CDB229157C105BC03F84D1E9CF533F404ADD07B338135BC03F84D1E9CF533F40C6EEC60BF4155BC03F84D1E9CF533F40846AE6D0AF185BC03F84D1E9CF533F4067D304966B1B5BC03F84D1E9CF533F403D3C235B271E5BC03F84D1E9CF533F40BF4DE2B3E2205BC03F84D1E9CF533F409CB600799E235BC03F84D1E9CF533F4012E1DE165B265BC03F84D1E9CF533F40F049FDDB16295BC03F84D1E9CF533F400B1D7C0DD32B5BC03F84D1E9CF533F40E8859AD28E2E5BC03F84D1E9CF533F40A601BA974A315BC03F84D1E9CF533F40C1D438C906345BC03F84D1E9CF533F409E3D578EC2365BC03F84D1E9CF533F407BA675537E395BC03F84D1E9CF533F40520F94183A3C5BC03F84D1E9CF533F40345CED54F83D5BC0E060D2E9CF533F40D9205371F53E5BC03F84D1E9CF533F40494B310FB2415BC03F84D1E9CF533F4052D3C71909435BC0E060D2E9CF533F40DACBC71909435BC060B7CA77E3533F40DACBC71909435BC0983F2EDEE9533F40DACBC71909435BC0D0862EDEF1533F40DACBC71909435BC0F06E6411FD533F40DACBC71909435BC05F7A964408543F40DACBC71909435BC0B8E4924410543F40DACBC71909435BC0D8CCC8771B543F40DACBC71909435BC028D8FAAA26543F40DACBC71909435BC047DE974430543F40DACBC71909435BC0B72A2DDE39543F40DACBC71909435BC0EF12631145543F40DACBC71909435BC0283CFCAA4E543F40DACBC71909435BC068472EDE59543F40DACBC71909435BC0804DCB7763543F40DACBC71909435BC0109A60116D543F40DACBC71909435BC047C3F9AA76543F40DACBC71909435BC068AB2FDE81543F40DACBC71909435BC0B8D4C8778B543F40DACBC71909435BC0D9BCFEAA96543F40DACBC71909435BC050099444A0543F40DACBC71909435BC087322DDEA9543F40DACBC71909435BC0A038CA77B3543F40DACBC71909435BC0F843FCAABE543F40DACBC71909435BC02F6D9544C8543F40DACBC71909435BC08878C777D3543F40DACBC71909435BC0E0A16011DD543F40DACBC71909435BC0E0A7FDAAE6543F40DACBC71909435BC050B32FDEF1543F40DACBC71909435BC088DCC877FB543F40DACBC71909435BC0DFE7FAAA06553F40DACBC71909435BC01811944410553F40DACBC71909435BC0371731DE19553F40DACBC71909435BC0A763C67723553F40DACBC71909435BC02F4C2FDE79823F40CB5AFB4C08435BC0E7579444D0AF3F40CB5AFB4C08435BC0AF45924428DD3F40CB5AFB4C08435BC024977D553F0540405BFB2C8007435BC0F3ABE3BBE91B4040CD51FA4C06435BC0B4F0B28896324040CD51FA4C06435BC0301717EF40494040461994E605435BC0049D4922EC5F4040C5E02D8005435BC044117E5597764040C5E02D8005435BC03097B088428D4040BD6F61B304435BC0108EAF88EEA340407E0794E603435BC06002E4BB99BA40407E0794E603435BC030174A2244D14040F7CE2D8003435BC080FC4A22F0E740407696C71903435BC05011B1889AFE40407696C71903435BC03097E3BB451541406825FB4C02435BC0709A4B22F02B4140A884C71901435BC04C207E559B424140A884C71901435BC03C88492248594140A884C71901435BC07C8BB188F26F4140691CFA4C00435BC05C11E4BB9D864140691CFA4C00435BC0ACF6E4BB499D414061AB2D80FF425BC07C7C17EFF4B34140533A61B3FE425BC05C917D559FCA4140533A61B3FE425BC09C05B2884AE14140CC01FB4CFE425BC07C8BE4BBF5F741404BC994E6FD425BC06882E3BBA10E42404BC994E6FD425BC0A8854B224C2542400C61C719FD425BC0779AB188F63B424004F0FA4CFC425BC0D8F07E55A352424004F0FA4CFC425BC0B476B1884E6942407DB794E6FB425BC088FCE3BBF97F4240EF4894E6E3365BC088FCE3BBF97F4240994261B3CC2A5BC088FCE3BBF97F4240C103C819B51E5BC088FCE3BBF97F42403B0694E69D125BC088FCE3BBF97F4240E6FF60B386065BC088FCE3BBF97F424096F92D806FFA5AC088FCE3BBF97F4240C0BA94E657EE5AC088FCE3BBF97F4240B284FA4C40E25AC088FCE3BBF97F4240540DFB4C28D65AC088FCE3BBF97F42404CD760B310CA5AC088FCE3BBF97F4240F7D02D80F9BD5AC088FCE3BBF97F4240A1CAFA4CE2B15AC088FCE3BBF97F424051C4C719CBA55AC088FCE3BBF97F4240438E2D80B3995AC088FCE3BBF97F4240257FFB4C9C8D5AC088FCE3BBF97F42409010FB4C84815AC088FCE3BBF97F424001A2FA4C6C755AC088FCE3BBF97F4240B29BC71955695AC088FCE3BBF97F42405C9594E63D5D5AC088FCE3BBF97F4240D59760B326515AC088FCE3BBF97F4240B7882E800F455AC088FCE3BBF97F4240A95294E6F7385AC088FCE3BBF97F4240DA84C719E12C5AC088FCE3BBF97F4240FBD461B3C8205AC088FCE3BBF97F42406D6661B3B0145AC088FCE3BBF97F4240E5682D8099085AC088FCE3BBF97F4240C259FB4C82FC59C088FCE3BBF97F42403A5CC7196BF059C088FCE3BBF97F42402C262D8053E459C088FCE3BBF97F42401517FB4C3CD859C088FCE3BBF97F424007E160B324CC59C088FCE3BBF97F424030A2C7190DC059C088FCE3BBF97F42406290C7190BC059C067C74B22FC6F4240134661B308C059C0E4854A220060424006CC93E605C059C0E0324B220450424070B194E603C059C04B0FB18806404240,-23.0%,-64,214,64,150,New Mexico,true
32,0106000020E61000000300000001030000000100000013000000A4B67CD3FD9652C0CC2CD03566B34340329FD1282D9952C02004258BCFB14340AEF97BD33B9B52C0C02CD03566B243403DBB267EAE9C52C08C71D035BEB54340643E7CD3939B52C0334FD03572B643409D28D228FD9A52C0A85ECF355EB5434078A57CD3779A52C02C04258BCFB343405EFB7CD3959952C0985ECF351EB34340B244277EBE9852C00436248B07B443400A67277ECA9752C0E4B2CE35E2B743406689277EF69652C078557BE03CB94340F2717CD3859752C0E019CF3586BB4340CE7CD128819652C01417268B2FBC43405EFB7CD3559352C06F557BE07CBB4340D0C77CD3839352C0740AD035DABA4340362D7CD30D9452C0C4C5CF3542BA434076A57CD3579452C098427AE01CBA4340382D7CD32D9552C0E493D0358AB64340A4B67CD3FD9652C0CC2CD03566B3434001030000000100000010000000D238CA10D38E52C03891CE6AC8C64340FE4AD228699052C058D2258BD7C24340B044277E5E9052C018E8CF35CEC34340FC4AD228499052C033D5CE356EC443403AE65D044C9052C0C4799FF40FC64340FE525B575D8F52C0CF25684FA6C94340634C5B383D8A52C0F03CCF44BDD74340CE7CD128818852C094F7CE357ADB43404C947CD3918752C060A3CF3576DE4340D80A7CD3018752C094427AE0DCDF4340081C7CD3478652C088F7CE35BAE04340E8E3D128C58652C0687479E054DD4340C2F73CB44C8852C0E89E85DCC3D943405FA7B237778952C0ACC403113CD54340AA4645B5CB8B52C0F306287FCACE4340D238CA10D38E52C03891CE6AC8C643400103000000010000009E0100005AB3248C7B7F52C0283603EF3366444085251471668052C0F7022428EB6344402CCADC77EA8052C0100EA727076244407A5D8548318152C04C686F2337604440C82993DD568152C07CB55D87FB5E4440642ED336CB8152C0F0C7396D2A5D44406127AA210B8252C0880596476A5B4440623E7CD3138352C03CD5CE35AE5944401A837CD38B8452C058A3CF35F657444074A57CD3B78552C00481CF35AA5544407ACE82F5248652C098A1951BCF534440AD576F0C158752C0D03C050F3F534440EE28F2AA628852C09314102895524440784175ED178952C0AB5EFAB5BA524440BE258C3BE58852C08CA4405A34544440EAA928A0C18652C058F19CC0435A4440D2065624328752C09363E1EEE35B4440207195A8108852C0FC93C67C015A44401059B347888852C068B10F7D7A5844407BF0E2A9198952C0245455218B564440ED33AEE5998952C0F4DB3AF30355444002D97CD3498A52C0F0AF258BCB5444405CFB7CD3758B52C0C82CD035A65344401E8AB3362E8C52C0684B14031F534440C46F4CDA6A8D52C0802A34782E51444046D9C13FC78D52C08CBE6971BB4B444032EA7CD32F8E52C090F7CE353A494440E270D7BFE98E52C0B8DB124C84484440024A6B55F08F52C09C97398D0F484440EE7F1CD4AB9052C068773E06A24644401E8FD8D5A19052C003B4889DB3444440625A013CE49052C0606AD27AB3414440100918F0419152C0E0C2683AA1404440C8E3158D179252C030D42D24A83F4440176A754E409152C0F8F742DDD43D4440081C7CD3679052C0D0B2CE35E23A4440623E7CD3338E52C050D2258BD73944403A2D7CD32D8D52C0284FD035B2384440A6B67CD39D8C52C030D5CE356E3844406A89277E568952C014E8CF354E394440309FD128AD8752C08B71D035FE3844404C947CD3118252C070BF248BF7354440309FD1288D7F52C0C0C5CF3582334440501A78883B7F52C060AD75E433344440D6D5942CB37F52C004F4A344FF354440C4AB277EE27F52C050A3CF35763844400A67277E2A8152C0C4C5CF35823D4440705AD128557F52C038D5CE35EE3B44400E67277EAA7E52C0BBC5CF358239444096A03EE3717E52C0F829A254F236444056708AB7237E52C0683F0221873244402254F8B23B7E52C03083ED71F029444015E93D7CB67E52C024228D35DC234440AAB67CD37D7F52C0E093D0350A1D444085D61529B08052C0A0CEA875721544406CFD87962A8152C0ACC353D4081244404ABA1286A38152C028E4F73B360E44406E9422B0F48152C0F4F806D8270A44400A736F9C598252C03064020C38064440820C7016968252C023FA4E1098034440AA4772DDFA8252C0948C75BBA8FF43407A2559B2C38352C0CCEA2D972DFA4340DAE83707008452C0302C0BAF6FF743408B8623AD508452C0105994819FF343401C763D36A18452C02FC7B26D0CF043405E3642EBF38552C0D0AF45035FE34340806554956D8652C054BD39F940E443408299D6D62A8552C060A93BE420F6434056E997839E8452C0B8C8A4F68AFC43409AC702083A8452C054CD460A0CFF4340B257D782AD8352C08C72FC398D014440423DE9E9488352C008DDF8C98704444076A57CD3378352C0E893D0350A074440C0AB277EE28352C040877AE0F4074440E0E7B796268552C0B0EC1FDE8F064440A88AD608FF8452C050C834989B0544409A9553B94B8452C0A038F81D5E0544404445E66E108452C0A80D46ADEF034440F03B9DF6D78452C02780800139034440588D8920508552C0E80A4D516F0144401E4B96C8A28652C0F0E8BC89CB014440D80A7CD3018752C097427AE05C0044402EEA7CD3CF8752C0DF48258BA7FF43404C947CD3118852C0C4107BE0A4FD4340F0717CD3C58652C0D42CD03526FE434018837CD38B8652C0FF35248B47FC43404206D228318752C02C04258B8FF94340CE7CD128818852C0E419CF3586F74340FC269E5D458752C02F137C822DF74340F0CDF81C0A8752C07059669AFBF543401A025777218852C0006A8350F4F34340D2801A54C18852C0748DC1370BF24340F2A8268B728852C048202B53A7EF43403EBB267E0E8852C0D0FD79E084ED4340EAE3D128258852C0780AD0359AEC43406A89277E568952C038B6D03556EA4340EABE34899D8A52C0D056FA7D3DE743401687F2ECEF8B52C080F47686D4E24340DD85752F2C8C52C007C9BBBD40DF4340643E7CD3738A52C07C0AD0351ADE434038D84F1D508A52C044BBB06D45DC4340961C0BF89F8A52C028C4B1E21FDA43408CC1D128B98A52C0E4FD79E084D9434056702C46A28B52C0DC4D6F1493D84340DADCB285B88C52C0A4EA8DBD8BD643405E3BB7877F8D52C0F80CC6D452D34340FE60B482978F52C09443FCBE5DD2434076EB7EA6229052C04438A63BD0D0434079A57CD3D78F52C0E493D0358ACF4340FE4AD228699052C0EC93D0354ACE4340053D7F00B09152C08866108CB4CD434092896A309E9252C06C2032C676CD434048DD606BA09352C0C43FE28725CC43401E22B2FE059552C06C63B76CC0C9434044D21EF7199552C0FFACD572F5C74340329FD1286D9352C0737479E054C543405622277E929252C064A3CF35F6C24340081C7CD3079352C0740AD0351AC14340F1717CD3E59352C0780AD035DAC04340A8B67CD33D9452C098427AE0DCC143409C28D2285D9452C0D448258B27C343402EEA7CD38F9452C018E8CF35CEC343406689277EF69652C020B979E06CC6434004D97CD3E99752C02004258B8FC54340D27CD128C19852C00C17268BAFC5434089C1D128799952C0E048258B67C643402EEA7CD30F9A52C0F8CB7AE04CC74340CFC77CD3039A52C0503CCF3592C2434041BB267EAE9952C02C04258B4FC0434004D97CD3E99852C07B0AD0355ABF4340603E7CD3539852C0C02CD03566BE434040BB267E8E9852C004CC7AE04CBC4340A6B67CD35D9952C078557BE03CB943404C947CD3519A52C0BB7A248B9FB94340D6C77CD3039B52C0C4C5CF3542BA434060FB7CD3B59B52C0C0107BE064BA43403DBB267EAE9C52C078557BE03CB94340A028D2281D9D52C02C4FD03532B843405122277E929D52C0707479E094B643401E837CD3EB9D52C0908D258BBFB44340B244277EFE9D52C0985ECF351EB343404A947CD3D19C52C0F419CF3506B443402C9FD128CD9B52C01C04258B8FB24340AE44277EFE9A52C0FC35248B07B0434060FB7CD3759A52C058A3CF35B6AD43404506D228719C52C034D5CE356EAC434042BB267E2EA052C09CF7CE35BAA84340382D7CD3EDA152C0B0C5CF35C2A74340382D7CD3EDA152C088F7CE357AA84340914F7CD359A152C0E893D0354AAA43404406D22891A052C060A3CF35F6AB4340705AD128D59E52C01BB979E0ACAE4340A4B67CD39DA052C08C71D0357EB043405DFB7CD3B5A252C04F877AE074AC4340FA4AD22889A352C0C32CD03526AA4340A4B67CD33DA352C088F7CE357AA84340A4B67CD33DA352C0B0C5CF35C2A74340643E7CD353A752C06B557BE0FCA743407AA57CD317A952C0B0C5CF3542A74340EAE3D12845AA52C017E8CF350EA54340C0607CD31FA952C08871D035FEA4434004D97CD349A852C0C02CD03566A443402EEA7CD38FA752C028D5CE35AEA34340A8F97BD3BBA652C094F7CE353AA34340A4B67CD33DA352C017E8CF350EA54340A4B67CD33DA352C028D5CE352EA44340382D7CD30DA552C0F419CF3546A24340AEF97BD3BBA752C0503CCF35929C4340081C7CD327A952C0A85ECF355E9B4340D07CD128E1A952C0E419CF35C6994340E9E3D128E5AC52C018B979E0EC8F43403EBB267E8EAD52C0DCFD79E0C4904340C6AB277E42AE52C0B77A248BDF904340362D7CD3EDAE52C02804258B4F904340D4C77CD383AF52C0B47A248B1F8F4340653E7CD333AF52C0503CCF35128F4340F8FF267E26AF52C0284FD035F28E43400867277E2AAF52C030D5CE35AE8E4340623E7CD313AF52C0B0C5CF35428E43400967277E6AAE52C058D2258BD78E43408AC1D128D9AD52C05FA3CF35B68E4340623E7CD373AD52C028B979E0EC8D4340745AD12855AD52C0B8C5CF35828C4340382D7CD3ADAD52C0F880CF35AA8B4340362D7CD32DAF52C08071D035FE884340944F7CD3B9AF52C090F7CE35FA864340AB44277E3EB052C08871D0353E864340F6FF267EE6B052C00C81CF35AA8543402CEA7CD36FB252C0888D258BFF844340E7E3D12885B252C07871D035FE834340D80A7CD341B252C04C3CCF35D2824340C4AB277E22B252C00717268BEF814340FA4AD22869B352C00B81CF356A7E4340C4AB277E82B552C0543CCF35527B4340DA0A7CD301B852C0C82CD035E678434076A57CD3B7BB52C04F3CCF35927643403DBB267E6EBC52C04C3CCF3552764340904F7CD319BD52C0707479E094764340342D7CD3EDBD52C0FC35248BC77743407E008D9009BE52C0A7D3EF6C1679434026E2D605C5BD52C0A4AFB2537F7A43403F65981A8EBD52C0FCEA36C4127C4340A88CA6B03BBD52C09090A7707A7E434037328CD7F6BC52C03FC39656F78043402EEA7CD36FBC52C00081CF352A834340B044277E3EB952C0DF19CF35C68D4340F84AD228C9B852C0E893D035CA924340D07CD12801BA52C08C71D035FE964340ED717CD305BB52C0E4B2CE352298434049947CD311BC52C0C4107BE0A4984340EC717CD3A5BE52C08471D035BE984340DC0A7CD321BF52C0975ECF359E984340A028D2283DC052C0483CCF35129843405CFB7CD3D5C052C0204FD035F297434018837CD36BC152C094F7CE353A984340BD607CD37FC152C02C4FD035F29843406689277E76C152C00881CF35EA994340765AD128B5C152C068BF248BF79A4340623E7CD393C252C058A3CF35769B434004D97CD3E9C352C06C7479E0549B43400A67277EEAC552C0543CCF35929A43405422277ED2C652C0985ECF359E994340BD607CD37FC752C034D5CE35AE984340BE607CD33FC852C0EC19CF3506984340C0607CD35FC952C0204FD035F29743400A1C7CD347C952C0B8C5CF35829843405422277E32CA52C028B979E06C9943402BEA7CD3AFCA52C0543CCF35929A4340382D7CD3CDCA52C0CF2CD035A69B4340964F7CD399CA52C098F7CE353A9D43402BEA7CD3AFCA52C068557BE0FC9D4340C0607CD33FCB52C090F7CE35FA9E43401C837CD38BCD52C044B6D035D6A143405EFB7CD375CE52C030D5CE356EA243409C28D228FDCE52C08B71D035FEA24340AB44277E7ECF52C04C877AE074A5434074A57CD3F7CF52C0B8C5CF3502A64340EAE3D12865D252C0B8C5CF3502A6434040BB267E6ED352C0403CCF35D2A643401C837CD30BD452C030D5CE35AEA8434004D97CD389D452C050A3CF35B6AA43405EFB7CD335D552C000CC7AE00CAC43401A837CD3CBD552C00881CF352AAC4340FA4AD22849D652C0F735248BC7AB43402EEA7CD3AFD652C038B6D03556AB4340C2607CD3FFD652C0978D258B3FAB4340C0607CD37FD752C0680AD035DAAB4340362D7CD3CDD752C0B4C5CF3582AC4340F84AD22809D852C0CC2CD03526AD43404E947CD391DE52C034D5CE356EB84340EE717CD385E052C0EC93D0358ABA4340F2717CD305E252C028D5CE352EBD4340E6E3D128A5E252C0E0B2CE3522C14340D0C77CD363E252C0DB48258B67C04340FAFF267E06E252C010E8CF35CEBF4340F4FF267E86E152C07B0AD0355ABF4340D07CD12861E152C01BE8CF35CEC143400867277EAAE052C0D8B2CE35A2C74340C0607CD3DFE052C0204FD03572C9434002D97CD309E352C00717268BEFCC4340924F7CD3B9E352C0F419CF3586CE43402C9FD128ADE352C0E0FD79E084CF4340D4C77CD343E252C0F835248BC7D1434042BB267E0EE152C0FF80CF35EAD24340071C7CD3A7E052C0EC93D0358AD34340705AD12875E052C0F319CF35C6D443404C947CD351E052C0FC35248B87D643405422277E12E052C0680AD0351AD84340623E7CD333DF52C02F4FD03532D943401A837CD3EBDE52C0E0B2CE3522DA4340D80A7CD381DE52C014E8CF350EDB4340F0717CD3C5DD52C094F7CE357ADB4340031C7CD3A7DD52C0707479E014DC434040BB267E8EDD52C0F419CF35C6DF43401E837CD32BDC52C04B877AE074E34340A6B67CD3FDD952C0E019CF35C6E64340D80A7CD381D752C0344FD03572E94340F0717CD3E5D352C030D5CE35EEEB43401B837CD32BD152C0D02CD035E6EC4340BC607CD3BFCF52C0EC93D0350AED4340F84AD228A9CE52C0D4B2CE3562ED43408CC1D12859CC52C0E893D0350AEF434040BB267ECECA52C054877AE0B4EF4340924F7CD3B9CA52C010E8CF35CEEF4340D6C77CD3A3CA52C0E093D035CAEF434002D97CD349CA52C04C877AE074F04340944F7CD339C952C078557BE0FCEF4340031C7CD347C852C0E0B2CE3522F143408AC1D12859C752C030B6D035D6F243404406D22851C652C0F419CF3506F44340F5FF267E46C752C0F019CF3506F643404E947CD3B1C752C00081CF356AF8434019837CD36BC752C030D5CE35EEF943404406D22851C652C0F419CF3546F943404206D22871C552C0DCFD79E004FB43400767277E0AC552C02B04258B0FFA4340F2717CD385C252C03CB6D0355600444044CD277E82C152C0A811D13516024440D2A7C71945BF52C0C04EE5BBBD03444078E22D8067BE52C0943419EFA404444072B52D80E3BB52C0C01DB288FE084440070CFB4CE8BA52C098857D55F7094440C6E9F94C80B852C0D0DF4A22280B44404246C719D9B752C0F310E4BBA10B4440901C94E69DB552C04B6BE4BBB50E44401CB4FA4C02B552C08872B188360F4440711661B366B352C054754B22900F4440728660B346B152C03871B0889E104440F47660B36CAF52C0B4F517EF6412444005BA94E6A1AE52C048F618EFE4144440C21594E651AF52C050E8E4BBA9174440829EC719F1B052C090F27E55671A4440E2E060B35AB452C07B9817EFF01E444011E393E659B652C014ECE2BBB92244408C04FB4C84B852C0FC784B2270274440EB55C719B9B852C05C3CE5BB31284440BA2994E64FB952C0C0CBB08866294440DAF294E6A7BC52C0B8F417EFF42D444010ACC71989BD52C034084B22E43244403E2A61B35EBE52C0D07C17EF10354440C415FA4CE0C052C078D74922A03344402EBE2D804BC252C0C4BD4B2224354440D9D693E679C352C010D5B088BA37444046982D801FC452C078FA17EF1C3A4440360595E695C452C09079492214444440DA8961B3AEC552C0683C7E5577474440DC44FB4CEEC852C0C4A417EF0C4944409ACD93E6D9CA52C0139E7D557B48444010D5C719A9CB52C0600AB288024944406CDFFA4C24CC52C0000718EF904C4440204EFB4C68CC52C0B0D6E4BBE94D4440B8DBC61987CC52C0E0644A22404F444002ACFA4C3ACC52C0AC8216EF8450444046742E8077CC52C054C217EF90544440363094E669CC52C0802DB088D2554440A6F0C71937CC52C028EFB088C656444046742E8077CC52C0FF0018EF10584440240762B3AECC52C0ECFD7D55AB59444094EBC6196DCC52C080354C22645B4440E4DBC6198DCB52C0B83CB1880E5F4440A6A1C719BFCB52C038AD4A22205F444086F5C619FFCB52C08CD4E5BB096044400E51FA4C14CC52C070D04A22186144400AD7C719C5CB52C0BCD717EF98614440C41FFA4C4CCB52C0FBBB17EF04624440A84761B3DCCA52C00CDCAF880663444028BEFA4C48CA52C0FCD916EF2C6544404AB794E61BC952C0183517EF58644440DB812D80CDC752C0003917EF9064444046C72D80BFC652C030277E55D7654440A2B62E804FC652C0679418EF30684440525160B3FAC552C07CE2AF88466B4440BE58C81935C552C06036B188826C44401649C81955C452C0882717EF746D44402AC094E6AFC352C0507217EFA86F44406E7FC719EBC352C0380818EF1C72444063322E80D7C452C080827D554F7444409B672E80D7C552C0A84E18EF0C764440A2B62E804FC652C044DF492220774440D617FB4C6AC652C024737E55E377444022A1FA4CB0C652C0ACC2B1884A7844400100FB4C0EC752C047A97D55737844407AF3C71971C752C00491AF887A784440D39493E6ADC752C04C8F16EFAC784440BEB2FA4CACC752C0B4CC18EF247944401A4B60B39AC752C010C74922B879444067F7C719A9C752C05FB0AF883A7A444008112D8067C852C0E824B288CE7B4440AF8A2E80C9C852C0A0F77D55D37C4440DC44FB4CEEC852C0F40C17EFB87D4440702A61B33EC852C07F4D4B22C07F44402A8E94E6CFC652C01C0BB188C281444095F560B34AC552C014D9E4BB4D8344402E9C2D8057C452C0105C7D55EB834440045CC719EDC252C06BF7E3BB818444400AF0F94CBAC152C07096E5BBFD85444050A394E61DBF52C08C4FB088028B44407E312E80DFBE52C0FFE216EF288B4440A23494E6D9BE52C0940F7D557B8B44408E13C719E1BE52C0C424B1880E8D4440109CC7199DBE52C0B0367D55AB8D4440D6212E80FFBD52C080F47D55678E4440408A60B352BD52C0FC47B188068F44400EC72D80DFBC52C027754A22488F44402E222E800BBC52C06FEEE4BB55904440EB55C719B9B852C00FAFE5BB25974440DEF5F94C34B752C01B09B088C69C44404E3AFB4C96B652C07F53E6BB55A04440785E2E8089B652C0E4D94B223CA14440AAFD2D800FB652C07CFF17EFF0A244408AC160B39AB252C0301917EFD4A74440AC51FA4C78B252C088CEE4BB31A844403628FA4C20B252C018287F5573A944402C2194E6EDB152C0A046E3BBF9A94440528C60B39AB152C0EC8AE4BB55AA4440A4A12D80EBB052C028D74A2274AA44408A4461B30EB052C038CCB0889EAB4440C83861B366AF52C010C3E5BBFDAB44409AEFF94CFAAD52C077D37D551FAC44405699C719B5AC52C0B43E16EF60AD44407A6FFB4CBCAC52C00CA2E4BB99AD4440085160B366A652C08FE44B22C0A74440F2AFFA4C10A052C0D0A97D55E7A144402A50FA4CBA9952C064ECE4BB0D9C444094E7FA4C649352C0F810E5BB359644408BB761B30E8D52C038D616EF5C9044403E1FFB4CB88652C0CC187E55838A44407CBFFA4C628052C054CCB188AA844440E886497B0E7A52C0747193F2D27E44403EBB267E0E7A52C0483CCF35D27E444076A57CD3177A52C0CB2CD035667C4440DE0A7CD3C17A52C088F7CE353A7744409ADD267E1A7D52C0C02CD035E66D44405AB3248C7B7F52C0283603EF33664440,-20.1%,-140,556,71,485,New Jersey,true
48,0106000020E610000001000000010300000001000000250100006DFFF94CE01D52C060CA17EF585D4540CA912D80052152C08C6317EF845D4540262461B32A2452C028CDB188B25D45400AEFFA4C502752C04866B188DE5D4540D848C819752A52C0D85E7F550B5E45408A1C61B39A2D52C0244BE4BB395E454036F0F94CC03052C0B443B288665E45400A4AC719E53352C070EEAF88925E4540ED1461B30A3752C000584A22C05E4540BC6E2E802F3A52C01FF14922EC5E45407E1D56E4E63C52C060532BA5E15E4540F46D32A1044052C060532BA5E15E4540D0DA7852324352C0A87A018E015F4540A217EA1A404652C030C9AD5F415F4540838430CC6D4952C030C9AD5F415F4540CA230927234D52C0BC8A247F675F454042AC8635FE5052C030DA8FDC6F5F454076C727DFAD5152C0889C6297805F4540525E6FA7705252C0084BB06112664540627C93E6ED5152C017AF7E55F367454081CD2E803B5152C074A2E3BB796C454029CC61B30E5152C0F4A07D558F6E4540C8FE2C80075152C0686A7E55F36F4540A43AFB4C045152C078EA17EFE47045402A1A61B3FA5052C0D042B1888E7345400BF42D80EB5052C098F8E4BBB1774540541BC719D95052C060D2B0880E7D4540BCDDFA4CC25052C0708518EF6883454090EDFA4CA85052C0EC784B22808A4540A65CC7198D5052C0807FB08812924540AAE9FA4C705052C0A430E4BBE59945407EF0F94C545052C0E052E4BBB9A14540441E61B3385052C0F429E4BB4DA94540269F2D801F5052C0543B7E5563B045400229FB4C085052C0607D19EFBCB645404EDFC719F54F52C038397E551BBC4540F2C193E6E54F52C0F07DE5BB3DC04540EA00C819DD4F52C034D67E55E7C245401CE6C619D94F52C06838B188DAC345400CB42E80CF4F52C000D14B22A8C64540355694E6495052C020E57E55AFC745402AF793E6E55052C04830492288C845407C5361B3385152C0582D4A22DCC84540D8B694E6BD5152C094D516EFF8C94540888760B3A65252C060DA4A2294CE4540041162B3EE5252C06792B2884ACF4540E56661B34A5352C08CE618EFD8CF4540FC97FA4CC45352C0A042E4BB29D0454090882D80C75452C0C0B0B1887ED0454072D4C719455552C0782717EF84D04540AC08C719B95552C094F8E4BB75D04540A21C2E80255652C083417E554BD04540DA3661B3865652C020AF7D5503D04540FF15FB4CDC5652C0E059B18896CF4540751C2E801F5752C090BE4A2200CF45407241FB4C505752C0C0D0B18856CE45401A00FB4C9C5752C0E8204A221CCC4540548494E6CB5752C0CF984B2268CB4540929CC719115852C0A0C116EFD4CA454008FCFA4C5E5852C060BA492254CA4540D24294E6115952C0F485E3BB91C9454028CB94E6C75952C05C25E5BB19C945408AE62D80075A52C0CCDE17EF00C94540DAA360B3265A52C0B00D4A2210C94540FEEC60B34A5A52C088527E555BC9454076892D80BF5A52C050824C22A4CA45404A6E60B31A5B52C0E8204A221CCC45406EED93E6335B52C0A8D6AF88AECD4540C4B1C719395B52C0F845B18872D04540420695E61B5B52C0D41AE4BBE1D14540DEFBC619ED5A52C08075E4BB01D3454018362E80915752C0C83A7E55B3DF4540E3B194E6615752C030047F5517E14540548C94E6415752C02862B188C6E34540080CFB4C4A5752C04C0E7E551BE54540248B2E80635752C0F8C2E2BB21E645403BB361B38E5752C0CF2EE4BBB9E64540A2F22D80BB5852C0E08E7D55D3E9454023D493E6CD5852C0DC044B2298EA4540F03C94E6BD5852C0D85CB1885EEB454080C394E65D5852C0D8D8AF885EED45400C302E80375852C018054C220CEF454062EB60B33A5852C018D27E550BF04540C67961B34A5852C05CE2B188DAF04540E44894E66B5852C058654A2278F1454060A6C7199D5852C0E824E4BB01F24540BBB0FA4C185952C060B515EF14F34540800194E65D5952C0CF04E4BB29F44540D19394E6A55952C04843B188C6F5454075EA2D803F5A52C0ECAFB0885AFB45405AB194E64F5A52C0903EE4BB4DFD454021A0C7193D5A52C0082A7F55CB004640303461B3525A52C04FD24B22E8014640B13894E6795A52C0C09A4B22C0024640BC3FFA4CAC5A52C0E4EEB1884E034640809194E67D5B52C0C07A4B22E804464028DFC719C95B52C068B57D559F054640407AC719115C52C03FF216EFC0064640407AC719115C52C068437E55A3074640BE7594E6E95B52C09C7D7D556B084640981AC819295B52C088D7E5BB490A4640481D94E6F15852C0D035B188961446402AD293E6B15852C0107F7D554F16464034ADC619815852C01CB3E3BB051946409E16FA4C605852C0B0ACB288BE194640E809FB4C285852C0E8D515EF601A4640349BFA4CE45752C0B4D04A22F81A4640C5D960B33E5752C0342DE4BBE51B464068E994E6895652C03C147E55AB1C4640567061B3CA5552C060FC7D554F1D4640621D61B31A5552C0179C17EF0C1E4640811761B3C65452C030B74922F81E4640703D2D80875452C0784B4C22582046404ADA60B3505452C0A055E6BB152346401D9C61B34A5452C00CBB4A2298254640E8172D80675452C0F0AE4A22E42646401EDA60B34A5552C0300216EFA02C46406603FA4C545552C0C07517EFA82D46401EDA60B34A5552C0B0AEB088922E46400E2CFB4C225552C09C42E5BB552F4640BC42FA4CEC5452C0545FB0880E3046409E09FA4CB45352C0102E4A226C3346403C2294E64D5352C07B494A22F4344640E25DFB4CFC5252C05CE2492214374640EE382E80CB5252C0688F17EFF4384640B48061B3C25252C0B43C4A22283A4640AED060B3CA5252C078494B225C3B4640DA7061B3DC5252C0E87DB1881E3C464082D860B33A5352C0845AE4BBFD3D4640129D60B3DA5352C0C81DE3BB05404640B083FA4C945652C030D417EFA8464640F4B6FA4C785752C0E44E4B227849464006BE60B3AA5752C074624B22904A464062C893E6255852C0E86C18EF304F4640E82CC8193D5852C0A0C9E4BB01524640940F94E62D5852C070F8B188BE524640A00D94E6115852C008F1492284534640E2462D80075752C0246A17EF68584640C880FB4CE85652C060CD4A22E85946403AABFA4CD05652C0E817E6BBC95C4640D9502D80995652C0F0C7B288565E4640ADCA2E80015652C068447F55F360464073C3C619CD5552C0988C4A22206246403EEF2D80955552C0E75D4B22F4634640701361B3885552C0581EE6BB096546408C6FC7198D5552C090CE17EFE86546407EA7FA4C9E5552C0C4454B228C664640242961B3C25552C0789F4A2220674640DEEE61B3F45552C0A8E74B22B4674640706C2D80275752C0975EE4BB9D694640DE5A94E6735752C084AC7E55376A4640B296C719BD5752C0B899E4BBF16A46409FBD94E6095852C0E45F18EF0C6C46405A57C719255852C06F7B7D55E76C4640940F94E62D5852C0088617EFB06D4640EE57FA4C145852C0B8A7E3BB2D6F4640F455FA4CF85752C098ACE4BBF16F46401A00FB4C9C5752C078A94A228C714640D537C7195F5752C0C88A4B224C724640F23261B34E5652C0C013B088D2744640AA112D80075652C0306BE3BBA9754640567061B3CA5552C078554A22B87646405A81C7198F5552C0E0D44B226878464061A294E6875552C000D77C556B7946407E57FB4C965552C018C37C55477A4640A62D94E6E95552C0308EB188267C46407251FB4C3C5652C0D8CBB0881A7F4640D6FF5E5E7C5652C07853D5D5978046400A40FABE295352C0538F66A6A0804640C287E9ADC74C52C068F25695B18046408EBCD79C654652C070D2C7D2C0804640FAB28564044052C060B23810D0804640F24BB67AA13952C0C0EF26FFE08046400CD2E5903E3352C0C8CF973CF0804640BD19D57FDC2C52C0B8AF087AFF804640281083477B2652C018EDF668108146404896B25D182052C0942AE55721814640F4DDA14CB61952C0800A5695308146401264D162531352C0B0C4C4D23F814640BDABC051F10C52C050853273528146402AA26E19900652C04065A3B061814640FAD65C082E0052C0484514EE70814640B41E4CF7CBF951C068A804DD81814640C6A47B0D69F351C07088751A918146407EEC6AFC06ED51C0D4C56309A28146402A345AEBA4E651C0400352F8B2814640A610DDD05FE051C040D99AF0C1814640CC152E8061E151C093D57C553B814640FA77FB4C08E251C0A0B1E4BB01804640AE132E803FE251C05424B288A67C4640E02CFB4CC8E151C0300416EFAC794640F8B42D80E7E051C084934922B8774640F8BC2D805DE051C0E86417EFB47546402AFC2D80EFE051C0147C16EF907246406EEA60B3CAE351C0C411E3BBB96C4640266CFA4CCCE651C0605DE6BB95664640816F2E805DE851C09446B088F6614640533194E6A3E851C0CCBDB088C25E4640E86FFA4CFEE751C008487E55B75C46402A7560B31AE751C0B8994A22F85A4640381AFB4CA8E651C05097B088AA58464018CFFA4C68E651C044DE7D55CF564640CCC961B36EE451C00C9AB188724F4640D089C7199FE351C063E04B22A84D4640D87560B332E351C07087E4BB554C4640C843C81929E351C0D02D4A22144B4640491D2E80C5E351C0DBC87D55C7494640DC1EC7198DE451C0F4C47D558F4946407C9A2D8057E551C01418E3BB91494640D2792E80FBE551C0F0A0AF88EE48464042A52E806FE651C0E8D5B08876464640F1C42E803BE651C000A4B1882A4446405EBBFA4C4AE651C07FE24B22F04146405AF194E687E751C028517E55A33F4640CCE82D80B7E951C02F934A22043D4640387FFA4CD2EA51C0A4EE4A223C3A4640EAF660B364EB51C0D0B1B1881A39464071EA94E60FED51C0DBE47E551B384640B07A94E6A7F251C04F1AE5BB013346403EFAFA4CAAF351C094D94B22A831464085CB60B3CAF551C0180418EFB82D4640642BC71901F751C030C218EF802C46408EE7FA4C8AF851C058CBE3BB212C46405CC7FA4CACFB51C0A03A17EF542C46407A6D2E80EFFE51C0B0017E556B2B464076E3C719490152C0F044B088AA284640A894FA4CB40252C084BDB1880E244640C3C593E62D0352C05865E5BB8D1D4640D0E660B3260352C0E892E5BB49124640D6C294E6810352C02867E4BB610D46403813C719730452C0987B7F554B0946400006C819290752C0D46A18EF24024640CC3AFA4C8C0752C03B9BB0881E004640C110C719450752C0D85DE4BB0DFF4540E4242E80B70652C03071B18842FE4540B622C7194D0652C060D117EF84FD454052C294E66F0652C0D092E5BB95FC45402E242E809F0A52C0C02AB088EAF34540D2DC2D80910B52C070614A2240F145408E38C819F50B52C078924B2290EE45402D4061B3160C52C0D01718EFC0EB454048FE2D80730C52C064C67D55FBE84540C82E94E6FD0C52C098014B2278E645402ECF60B3AA0D52C07C7FAF886EE44540CE20C7190B1152C0141B7E55E7DF454066F52D80DF1152C034DDE3BB39DE4540EA8860B39A1352C0E0B47D552BDC45403CFFF94C001452C030F7B288D6DA454056FAFA4C381452C0DCE4AF885ED64540CE0994E6C91452C0E8E6B0880ED1454064CC93E64D1552C07CFE7D5587CE45403DB2C719351652C0FC6B4A225CCC45405C29C7196D1852C03483492238C94540CFEA60B3121952C038BEB18862C745400E7F61B3761952C06CEF17EF04C44540AAE860B3F01952C0F03D4A222CAE4540744AFB4CAE1952C0805FE6BB55A94540768794E6D51952C0DC20B0886EA64540C8B894E69D1A52C0040E7E55FFA34540495CC719451B52C070E9B288D6A245406C072E80C11B52C01059B088AEA14540EAD72D800F1C52C087D0E3BB5DA04540D66861B32A1C52C0D7687D55B79E45402901C719191C52C0EC30E5BB599E4540E86461B3F21B52C0CCE5E4BB199E454034692D80CB1B52C0D89B4A22B89D45404231FA4CBA1B52C088497D55F79C4540589861B3DC1B52C097E5B188369C45408D8FC719291C52C0F49DE3BB919B4540F240FA4C9A1C52C068B616EFDC9A454046B793E6FF1C52C0DC28B1889E95454062C3FA4CFC1C52C038E417EF0C944540F240FA4C9A1C52C0C4917C55BB904540267594E6C11C52C0580C4A22D08D4540658E2D80DF1D52C0A0CCB0889A864540246EFA4C241E52C0937A4B22BC8045405577C719C11E52C0CC5218EF9C7E45401C4EFA4C4C2052C0ECAD18EFC87D454001AC60B3662152C08BA4E4BBDD7C45400EAB61B3D62152C0E09B7E559B7A4540288CFB4C482252C0D8C34B220C7545409A78C719C52252C088817E5537734540121E95E63B2352C0E80417EFE07145402E7A60B38C2352C0B83017EF6070454073ACFA4C982352C0A899B0880E6E4540088A60B3722352C0B87017EF106C454028A72D80332352C03C964B229C6A454078C560B3D22252C09C5A18EF58694540288CFB4C482252C07CFC4A22F0674540AE1994E6891F52C0B4A618EFBC6345409E0161B34A1E52C010727F5517614540658E2D80DF1D52C00CD0B0885E5D45406DFFF94CE01D52C060CA17EF585D4540,-7.6%,-9,110,13,97,Vermont,true
44,0106000020E6100000010000000103000000010000005801000015D4C7199B2358C0E8477E558BF84640006E61B3042458C0D47D4A2238F7464060BF2D80392458C0249A7D55BBF646408E9CC719732458C0B81718EF0CF646401C1BC8199D2458C06859E4BB61F54640485AC8192F2558C0EF1E16EF94ED4640952061B39C2558C028F27C555FEB46403644C819E92658C0141D17EF0CE84640342C2D80D32858C034227C55BBE14640F0BBFA4C102958C0D4B67E5527E14640CCDDC619932958C044C64B2224E04640B816FB4C302A58C0F49EB0883ADF46401D4EC719E72B58C0BBEC7C5543DD46404D49C719913058C0CC8D7F556FD9464018C693E6393158C097DC16EF9CD8464008002E80AF3258C02FC9B1883ED646403EF860B31C3558C03CCE4922C4D34640BE81C719B13558C04C8D4B2218D346401A1B2E802B3658C0982F4C224CD24640C10761B3F63658C0AC30E4BB99CF4640B64FFB4C3C3758C0243EE5BBE5CC4640360CC819893558C04F3217EFACC94640445694E65F3258C040A47E557FC4464086DFC719113158C00C96E4BB89C1464084B92D80BF2E58C0B04FB188C2B9464096D893E6532D58C033CC7C55F7B54640BC5E61B30A2C58C01C9A18EF58B44640704C94E6F92658C0A453B08892B34640DAD6C619412458C068A67D555FB2464078D32D80632258C0C0A67D556BB04640769E94E6B12158C0573A7F554BAF464022652D802B2058C0DC217E556FAD46409911FA4C8C1F58C034607D557BAC464039812D80CB1D58C000B717EFA8A74640AE52C7195D1D58C00CC317EF5CA646403EA394E6071D58C07873E4BBF5A546403EA394E6071D58C03BBB17EFECA546403EA394E6071D58C0A8427D55F7A04640043BC719071D58C0EBDD18EFD8844640043BC719071D58C0D36C4B22BC684640043BC719071D58C03BBA16EF9C4C4640043BC719071D58C074E4E5BB7D304640043BC719071D58C0F8A27D555F144640043BC719071D58C0D04F17EF40F84540043BC719071D58C018EBB28822DC4540043BC719071D58C07FA94A2204C04540BACBC719192658C0FC334B22DCBF4540528561B34E2658C0E8484C228CBF4540B374C7192B2658C0D05C4C22B0BE45404CA92D80F32558C0E4094C2200BE4540D815C719CD2558C09C884C2230BD4540A05DFA4CC42558C0B03DB18842BC45408CB8FA4CEA2558C01C9217EFDCBA4540D95B61B3F62558C01C7F4A22B4B94540DA9194E6EB2558C0A8D0B188A2B845400E772E809B2558C06C944B2270B745405AAF2D804D2558C057DCE3BBB9B6454034CF2D801F2458C0CBBE7C55C7B445406E8FFA4C9E2358C08457E4BBBDB3454007F92D80832258C0840F7E55E3B1454086D12D80472258C09B73E4BB5DB14540B48294E61D2258C05F62B08802B0454098F0FA4C242258C00F23E5BB69A9454000B393E6592258C030584B2244A6454007F92D80832258C0E37FB088D2A5454020442E80C32258C078D77E5563A545401EA694E61B2358C0F48CB18812A54540FA1E61B38C2358C090EDE5BBF1A44540CE5494E67B2458C05898E3BB1DA54540C6D9C719E92458C09CFEB08802A54540C2F593E6172558C050634A226CA44540DC2E2D80072558C008424C228CA345402410C7197F2458C094E917EF28A24540A4F92C80072458C070B318EF98A14540107DC719AD2358C01447E4BB11A14540909260B3982358C07C57B2889AA04540047FC719C92358C004BBE5BB25A04540A20B94E6572458C0884C4A22349F454040C52D808D2458C0C8E6E5BBA59E4540F40E61B3A02458C0E804B288F69D45408745C719852458C0501DE5BB419D45404AB1C619212458C09C82B1889A9C4540CA532E80A32358C054617D55539C45401EA694E61B2358C0F061B088429C4540A611C8191D2258C04F02B388569C454006A8C619A72058C0F8584A22F49B4540D4ED94E6352058C0F8584A22F49B4540205361B38E1F58C024C317EF109C4540F050FA4C241F58C0CFA5E3BB019C45400E812D80C51E58C08384AF88BA9B4540628CFA4C841E58C0D0D04B22409B4540D09C2D80591E58C0D4BE7F55A39A4540B2AA2D80231E58C07048E4BB41994540EAA02D80971D58C060EDE2BBAD9345402EE42D80671D58C0780BE5BB65924540F2EEC719371D58C0BCF67E556F914540E15A2E80211D58C06CF2B0889A904540C04EC719251D58C050C016EF948F4540E68FC719D31D58C070EA4A22708A4540C572FA4C121E58C038B74A228C89454042F3FA4C581E58C02B11E5BBD988454018FDC619792058C068BC7D55CB854540A89393E6992058C0EC5CE5BB3185454020EA60B3982058C0E4A47D557B844540E442FA4C542058C09F464B22C08345409712FB4C182058C00CC8E5BB49834540989F2E80FB1F58C0A43CE4BBE58245404AF3C619ED1F58C054A17D554F824540B61E62B3142058C010FDB0886A814540BC0B61B3802058C0A46CE4BBA97F45408565FB4CC82058C08CF5B088067F454070D361B3CE2058C018624A22E07E4540E4E1F94CD42058C05700E6BB897E4540A4B860B3CA2058C0FF274B22187E45404E4B2D80B32058C04045B188967B45406C9F2E80F52058C09C23E5BB197A454085E12D80332158C0CCD14A224879454078D32D80632258C0A490E3BB51774540002F61B3782258C0BC6916EF04774540C2F261B38E2258C0949B7D5527764540EE3261B3B02258C0642D18EFA872454062C6C719D72258C0000117EFA87145407A95FA4CF82258C0B077B28816714540B6EC61B3342358C0C750E5BBC970454032BD61B3822358C0344FB1884E704540C2E261B3A22358C0206C17EFC06F454083ED60B3BE2358C013A3E4BBF96E45406043FB4CCE2358C01C12E5BB496D454005F293E6E52358C010FBB288966C454080FFC7190F2458C0EFB717EF186C454092D0FA4C4C2458C094664B22E46B45405AAF2D804D2558C0549CB2883E6B4540384261B3842558C00C1B7D55076B4540E03694E6C52558C040364A22AC6A4540008294E6052658C01C05B188326A454012FAC619392658C0781019EFA4694540522E61B3602658C0B40419EFFC684540A86561B3822658C02C7C16EF44684540B913C719AB2658C05C8E7D559B674540F6112E80DD2658C038C94A220C674540D8FCC719DB2758C0D40C4B22E8644540988CFA4C642858C0ACA0B1881A63454014932D80A72858C0C8404B22E46145406E94FA4CD42858C0683FB28822604540396060B3AC2858C0B0784B22185F4540A033FA4C5A2858C010FCE3BBC15D45400F43C719572758C070D0B0886A5B45403B6FFA4CC02658C00CE649225C5A454001682D803F2658C058C97E55A3594540544CFA4CD42258C014CFE4BBD155454051932E80412258C0449BB188FE544540CBB2C719BF2158C00068B1881A544540097CFA4C8C2158C0D0427D559B5345404A32C719792158C0F03517EF14534540769E94E6B12158C0CCE1B08886524540F191C619612258C093317F55A7514540AA732E80752258C0945CB1887E5145401FC860B3A42258C044734B22FC50454089FD60B3AA2258C05058E3BBA9504540261F61B3922258C03C3EB2884A504540B217C819772158C07335B1884E4F4540FCDEFA4C282158C0B8A3E3BBF54E4540904994E6E52058C0FC7D7C55874E45404C8A61B3AA2058C080D0E4BB014E4540DCAE60B33E2058C044947E55CF4C4540E09294E60F2058C074F4E4BB114C454098962D80F91F58C088EFE3BB4D4B454060012E80052058C0D0287D55434A4540494CC719F71F58C0283C4A22784945408C1CFB4CAA1F58C09C547D55C3484540CE1961B3501F58C04FB1B1886A484540567D94E6DB1E58C058E37D55DF46454088C494E6E31E58C0F0EF18EF58424540A3772D801F2758C0B8654B226444454090D593E6392858C00CC17E557345454052AB60B3EC2858C04CFEE5BB31474540A2E460B32A2958C070AB7D55AB4945409C3561B3BE2958C0B86217EFB84B4540B8C0C719632C58C044FFB188BE4E454058E32D80232D58C010F7B188425045408A2A2E802B2D58C0E0B17D55EB514540C006C719D92C58C0447E7D55FB524540E360C819752C58C01864B188E2534540310C94E6432C58C0C47C17EF10554540974AFA4C982C58C008D3E4BB09564540943194E65D2D58C078554A22B856454046B260B33E2E58C018A57D551F574540868EFB4CE82E58C0EFA317EF40574540CE5761B3923158C0B405B288FE564540116894E6613258C0EFA317EF405745405328C819293358C0A3AF17EFE85745404C812D807F3358C0ACE4B0889A584540321461B3B63358C064E84B2280594540E24E2E80213458C080007F55BF5A45400851FA4CD83458C0344518EF505C4540AAEF2D80B73558C0E4B4E3BBB95D454078BBFA4CD83658C063C37D55BB5E4540154DC7199D3C58C0988D16EF605F454024DA61B3C83D58C004FFB088FE5F4540F5C7FA4C723E58C0AC9DE4BBDD604540E62B61B3E63E58C0D47D7F55BF61454098FCC719833F58C0C0BE7D556B6245401B01C7193F4158C02C9C7E55F36245407E2F2D80A74258C0A06DE4BB196445408CC4C719494358C04C6B18EF5C64454032C62E80A14658C07875E4BB89644540488EC719254858C080D5AF88126545401C2DC7199F4958C09C3C19EF306645402650FB4CFC4A58C0B4ABB188AA674540941361B3524D58C06FD4AF88EE6A4540FE5A94E63D4F58C07405B288A66E4540DA472E80575058C0E0917E552F70454026682D80A75158C05B2F4C22307145405DB8FA4C465358C038854B228C714540FE7360B3066058C0A899B0880E6E45406A2EFB4CC26158C00828B1881E6E4540229894E6616658C0F347E4BBCD6F45405852C819CF6758C03311B2884E6F45405E76C719516A58C063AC4A22546D4540665CC719D36B58C0F018E4BB2D6D4540FD0D61B3926C58C030FDE3BB996D45405EC9FA4CDE6D58C03C817D55C36E4540E8B2C719AF6E58C0505BB188026F4540DA70FB4C4E7158C0A899B0880E6E4540B2F761B3AE7558C0D8FCE3BB8D6F4540BAF72D80437758C0505BB188026F4540A6F32D80057858C0D49B17EF786E45404CC694E6BD7858C078E94822C86D45408E8E2D80477958C0CC767E55B36C4540E3772E807D7958C03451B288FE6A454071C9C6194D7A58C0501DB1889A6745403CCA60B38A7A58C044294C22FC664540EC042E80F57A58C088857C559F664540BC6694E6477C58C0E4EEE3BBE964454045DD94E6FB7C58C04C6B18EF5C644540BAFFFA4CB67E58C054857F55236445402E2261B3708058C04C6B18EF5C644540D8C12D80058558C028CC4922B866454060912E80C38558C068CBB188766745402B5394E6098658C0C463E3BBF9684540837993E6B38658C00BDD7D55076A454089F493E68B8F58C020494A22AC6F4540D1FC2D802D9258C0CB994C2230734540609F2D80D99458C0481B7F55E3754540A6DA2D80339558C0AC497E5503764540527761B3F69558C0849617EF10764540920261B3589658C078E816EF347645405E8E94E6119D58C0603A17EFC07C45407F39FB4C8E9D58C03028B0886A7D454028C52D80D99E58C050247E55C37F454032CC93E60B9F58C08C33B088068045406275FA4C6C9F58C08C33B088068045404830FB4CEEA458C08C33B08806804540AA442E80D5AF58C09CA47C55078045408D91C719BDBA58C09CA47C5507804540EFA5FA4CA4C558C09CA47C5507804540592BFA4C8CD058C09CA47C5507804540BC3F2D8073DB58C09CA47C5507804540971BFA4C5AE658C09CA47C55078045402A272E8041F158C09CA47C55078045408D3B61B328FC58C09CA47C55078045407588FA4C100759C09CA47C55078045408FCC94E6F71159C09CA47C5507804540BBE9C619DF1C59C09CA47C55078045401CFEF94CC62759C07C6319EF08804540F9D9C619AD3259C09845B2880A8045405AEEF94C943D59C09845B2880A804540A72995E67B4859C09845B2880A804540093EC819635359C09845B2880A804540F28A61B34A5E59C09845B2880A804540D4D7FA4C326959C09845B2880A80454037EC2D80197459C09845B2880A8045409A0061B3007F59C09845B2880A80454075DC2D80E78959C09845B2880A8045408F20C819CF9459C09845B2880A804540716D61B3B69F59C09845B2880A804540D58194E69DAA59C098B67E550B804540BECE2D8085B559C0A8274B220C80454099AAFA4C6CC059C0A8274B220C8045407486C71953CB59C0A8274B220C8045405ED360B33AD659C0A8274B220C804540F1DE94E621E159C0A8274B220C804540D42B2E8009EC59C0A8274B220C80454044B12D80F1F659C0A8274B220C804540EDDDFA4C66035AC0A8274B220C8045401A1CFA4C6C035AC0539E4A220C904540C32A94E673035AC0687418EF0CA045405A9E93E67F035AC008097F550BB04540E1DFFA4C82035AC0A80EB2880AC04540AFF1FA4C84035AC03CA318EF08D0454005AD2D8087035AC06CBA492208E045401A98C7198B035AC01C31492208F045405A9E93E67F035AC01C257E55070046404BBCFA4C7E035AC0CC9B7D5507104640A1D02D808B035AC07C127D550720464037F42D808F035AC01B897C5507304640595094E693035AC0BB1DE3BB054046407ECDC71991035AC0DC167E551B50464094AF60B392035AC0F8F4B088DE5F4640693B2E8097035AC0001D7E550370464071FCF94CA0035AC0AC937D5503804640F68394E683025AC0048EE4BBFD7F4640AF51FA4C78025AC0EC8A4A22988146406FF22D8079025AC0989FB188F6884640699B2D808B025AC06C8A17EF5C974640A9CDC71997025AC0C438B2883EA54640F8702E80A3025AC048AB7E5523B346408FE42D80AF025AC04B4DB08806C14640564F2E80BB025AC0C0DDE3BBE9CE4640EBC22D80C7025AC0346E17EFCCDC4640036F93E6D3025AC00C5E19EFB0EA46404AA12D80DF025AC0B011492294F84640287394E6CBF159C0B0A07C5593F84640506F61B3E2E259C0B0A07C5593F84640061561B3FAD359C0B0A07C5593F84640B44994E611C559C0B0A07C5593F846405C7EC71929B659C0B0A07C5593F846400BB3FA4C40A759C0B0A07C5593F84640B9E72D80579859C0B0A07C5593F84640671C61B36E8959C0B0A07C5593F84640155194E6857A59C0B0A07C5593F8464043BE2D809D6B59C0B0A07C5593F846406CBAFA4CB45C59C0B0A07C5593F846401AEF2D80CB4D59C093BEE3BB91F84640C82361B3E23E59C083DC4A2290F8464036F0C619F92F59C083DC4A2290F846409D5461B3102159C083DC4A2290F84640468994E6271259C083DC4A2290F84640F4BDC7193F0359C083DC4A2290F84640292B61B356F458C083DC4A2290F8464097F7C6196DE558C083DC4A2290F846407823FB4C84D658C0736B7E558FF8464026582E809BC758C073FAB1888EF846409D9560B3B2B858C073FAB1888EF846407CC194E6C9A958C073FAB1888EF84640B12E2E80E19A58C073FAB1888EF846405A6361B3F88B58C073FAB1888EF84640089894E60F7D58C073FAB1888EF8464084D5C619276E58C073FAB1888EF846406301FB4C3E5F58C0F42917EF8CF846400C362E80555058C0E8477E558BF8464042A3C7196D4158C0E8477E558BF84640E2662E80833258C0E8477E558BF8464015D4C7199B2358C0E8477E558BF84640,-32.2%,-57,120,11,109,South Dakota,true
45,0106000020E610000001000000010300000001000000E9010000F2A894E6B7EA54C0F3514A22504D42400ADBC6190DE454C00094E4BB414D42401A3461B362DD54C038B817EF344D42405CECC719B7D654C054FAB188264D4240344E61B30CD054C0603C4C22184D424004B0FA4C62C954C098607F550B4D4240D3A0C719B7C254C0C013E6BBFD4C424024CAFA4C0CBC54C060677E55EF4C42402C2395E661B554C018BB16EFE04C4240CC8D2D80B7AE54C0446E7D55D34C42401CB760B30CA854C068B017EFC44C42402C10FB4C62A154C078F2B188B64C4240FC7194E6B79A54C034B716EFA84C42404C9BC7190D9454C05C6A7D559B4C42402AFD60B3628D54C068AC17EF8C4C4240F4ED2D80B78654C090EEB1887E4C4240C44FC7190D8054C0BCA118EF704C4240F6C8C719F57C54C090CBE4BB694C4240F620C719737C54C068B017EFC44C4240F82761B3107B54C024037D55BB4E4240549B94E6817A54C088D717EFF44E4240B094FA4CF07954C0986BB1880A4F4240C22BFB4C8E7554C05C4A7D55C34E42400E6AFB4C287054C080654A22684E42403E6C61B32A6A54C08CAAE3BB054E4240045FC7192D6D54C0571317EFF84542404A8961B3C26D54C07C497E555F434240189060B3A66D54C000D8E3BBC1424240E7862E80BD6C54C0D3B318EFA43F4240ADCE61B3B46C54C0E382E4BB7D3E4240DAD993E6B96D54C0E896B188CA3942402265FA4C646F54C0203A17EF6834424048D1C7199D6F54C0F46218EF3C334240D6D3FA4CA86F54C0CC11B1885A324240DCD1FA4C8C6F54C0A82E17EFCC314240046A94E6DF6E54C060C016EF942F4240DC92FA4C006E54C0DF6718EF982D4240F0E7FA4CD26D54C0DC727C55072D42407C1E61B3B66D54C0FC1317EF5C2C42405A8EC719D96D54C014CA7C55FB2B42400A4DC719256E54C0D871B188E22B4240AC9CC619217054C0C0EA7D55532C42405A68FA4C847354C0209E17EF282E42401D1294E6D37354C010BC7E55272E4240300694E6257454C0379A17EFF02D4240D860C7191D7954C02897B2888A2842401F0FFB4CDC7A54C0089BE4BB31264240AA00C819237B54C0F4B74A22A4254240F602FA4C948154C0204C17EFE81142406601C819158254C0B00E4B22D81042405181FA4CB88254C050E7AF88EE0F4240868AC719558354C02CE0E2BB6D0F424004E960B35E8454C0F87CAF88EE0D42407ECBC719FD8454C09C5FB188460D4240D67EFA4C8A8554C007814A22E00C42404E1BC719FF8554C06CEC7D55DB0C4240FE7861B37E8654C01886B088F60C42401A49FA4C788754C073CF17EF680D424034DA94E6E18754C0A49CAF88BA0D4240888661B33C8854C07B93E4BB190E4240B003FA4C868854C010C5B088820E4240FACB2D80C38854C03FEAE4BB010F42409062FA4CE48854C064CD7E558F0F42405A97C719FB8854C07032B0882E10424068D260B3068954C0E81417EFCC104240B6CEC7191D8954C06015E5BB691142405E472D803F8954C020FE17EFFC114240A04594E6718954C0C4BE17EF6412424054B494E6B58954C084AFAF88BA124240300A94E6118A54C0949BE5BBFD1242406E9E94E6758A54C0F73AB1881E1342400E3DC819558B54C0EB69E3BB2D134240A26B2E80C38B54C00863E4BB49134240F688C7191F8C54C070D77D55931342409ADF60B3B88C54C08800B2884A144240825F2E800F8D54C0C4FE18EF7C1442401A69C7194D8D54C0D4E0B1887E1442408A21FB4CA48D54C028A6492260144240FEFC60B35C8E54C0A0F8B188DA134240685E60B35A9054C0003E4B22841142401EF02D80B39054C00C46B088461142407FC593E6119254C0CFC2B28856114240AA3AC719999254C0309A4C223C1142408DC660B3329454C05C88E5BBF10F4240502B2D80799654C05B38E4BBED0E4240B622FA4C149754C0C8CA4922880E4240D8C560B31A9854C010D9B088A60D4240CC5E60B3409954C0704B7E553F0C4240EA6D94E6799B54C0CC74E4BB7108424024412E80219C54C064F9E2BBF9064240E1D9C619F99C54C0B8AA18EFF4034240794561B3429D54C06788E3BB2103424043612D806B9E54C0B81616EFA0004240C277C719E39E54C074244A22D0FF4140C2FCFA4C509F54C0F753E5BB35FF4140A8A9FA4C9A9F54C000BC4B22E8FE414082E52D80E39F54C09CE7B088AEFE414054A961B3D6A254C080AAE4BBA9FB414024742D806BA354C044C6E4BB3DFB41407079FA4CD0A354C06C567E551BFB4140DF54FB4C3CA454C087A9E3BB1DFB41402E1B94E6A9A454C018137E554BFB41404EE261B308A554C0C8B0B0889EFB4140E20EC8195BA554C0C0DCE3BB01FC414080922E809BA554C0C89CB0887AFC4140BED793E6D3A554C09F56B188FEFC41402A532E8003A654C0ABB67C5587FD41407E70C7195FA654C078834A2234FF4140E2F5C6196DA654C0AC8E17EFECFF4140E2A5C71965A654C09CF2E2BBAD0042403BEE2D804BA654C040C6E5BBA5014240FE592D80E7A554C0788D492238034240CA0162B3CEA554C01CB24A22C8034240E0E3FA4CD0A554C03CC016EF2C044240752AC819E9A554C0E8E017EF84044240A9FFC619F9A654C0285318EFF406424050FDFA4C3CA754C0201F4A22680742405843FA4CB2A754C0687DB2888A07424082DBFA4C4EA854C0140E7F5557074240EC35FB4C62AB54C0E06C4C22D8044240DE8961B3EAAC54C000937D55EB034240BC8194E64BB154C058284A22080042409A272E8063B154C02BADB188DAFF4140800861B386B154C0347519EF7CFF4140C804C8199DB154C0BC557E5503FF4140EA072E8097B154C0E0B3E2BB2DFD4140E67AFA4CB4B154C070E37D5593FC41405A6761B3E4B154C06C71B08806FC414072E094E6A3B254C0F4B9B188A6FA4140F62161B3F2B254C0FF3A7E5593F94140722694E619B354C0B0597D55D3F84140CC4C2E8077B354C0F8B5E3BBDDF74140921094E6D9B354C058D77C5577F74140C183C71945B454C0807918EF58F74140709BC7199BB454C0CBD6492288F74140F9B8C71945B554C0E8C7AF887AF84140146F94E62BB654C070E84B2280F941400AAF2E80FBB654C0F8B8B0881AFA41402E7461B38AB754C028B717EF4CFA41404C3B94E635B854C0C4694B2250FA41406F85FA4C32B954C030AEB188FEF94140C47761B3B6B954C0A04017EF98F94140E6A6FA4C14BA54C0D0154A2214F9414085D160B34ABA54C0AC6219EF88F84140649AC71977BA54C0888BE4BBF5F741408ADAC61999BA54C080C717EF44F74140828CC719ADBA54C058BC4A228CF64140103FFB4CB0BA54C040344C22D8F5414074482D809FBA54C09BF8E2BB2DF54140C11FC71985BA54C08393B1888EF44140DCC261B3F6B954C0F805E4BB79F24140FA15C719F9B954C027184B22D0F14140B482C71921BA54C0B87218EF0CF14140B81061B3DCBA54C008CE7D558BEF414008F160B310BB54C0A8507E55F3EE4140E569C81935BB54C054807E55ABED4140223C61B350BB54C0A05617EF04ED4140A6D62D80A9BB54C054794C22E4EB41405024C8193DBD54C0C04317EF04E841408AC494E6E3BE54C0CC2518EFDCE44140D13C2E8065BF54C0E095E3BB51E44140641294E6C9BF54C008F74A2220E441403248C719B9C054C02C88E5BB89E44140245FFB4C62C354C0DB36E3BBEDE44140C38161B322C454C098AA492248E54140827BFA4C7AC454C0E0A4B08842E541400E8793E6D3C454C094E217EF0CE541403ACA61B32EC854C0A891B08836E24140EEF394E669CA54C043E317EF24E141403CDDFA4CECCA54C0DC4BB188C6E0414002AA61B350CB54C08C144C2258E04140A47D2E80E1CC54C078147E55C7DD414020A793E685CD54C0C85BE3BB21DD41400AADFA4C22CF54C0F0F317EF28DC4140C47260B3A0CF54C0B09E4B22BCDB4140EC1BC71901D054C0AC4F4B2244DB4140D2AEFA4C38D054C01842B288CEDA4140D05761B392D154C0874A17EF9CD841405AE02D80E3D254C0E07DE4BBA9D54140DA9DC71951D354C040E0B18856D541403BA8FA4CCCD354C0F8B618EF4CD54140C2BE94E643D454C0B37318EF7CD541407436FB4CD6D454C0884FE5BB89D54140D4CDC61981D554C0C09E4A2254D5414068F2C71911D654C0ACDE7D55DBD441408A7261B302D754C07C2D4B2270D34140145A2E80B7D754C0245D4B2228D2414068A5FA4C92D854C0F8254B220CD14140389761B304DC54C0703CB288A6CE41401EFDC71995DC54C0682AE6BB09CE4140954094E6FFDC54C080CA49226CCD41409E252E80A9DD54C0A84716EF20CC414072FA60B318DF54C0E87A7E55DBC941406ACF93E68DDF54C0E408B1884EC94140350DC719F3DF54C0180617EFF4C8414004E6C7192BE454C0B0BFE4BB95C74140A6FFC7199DE454C0144EE5BBA5C741402E2E2E800BE554C088F216EFDCC7414080DAFA4C66E554C05FE94B223CC84140BE422D80B3E554C0F81A18EFA4C84140EB78C719F7E554C0703416EF14C941402A2794E66DE654C07F9D7D5553C941403ABC2E800FE754C064FC18EF64C94140D20CC8194FE854C0DC96E3BBC1C841408EB8C61907E954C078B6E3BB8DC8414040392E809BE954C04B81E5BB89C8414068E294E6FBE954C0ECD87D55B3C84140A8BD93E665EA54C0A401E4BBCDC84140D0BFFA4CD0EA54C07C9C7C55C7C8414080FAC7193BEB54C0F81A18EFA4C84140D056FA4CDAEB54C03C95AF8846C841403E9360B312EC54C03884E4BB35C8414064582E8055EC54C08B0D7F552FC841409A0AC71999EE54C04CFE16EF84C8414042D4C71903EF54C07804E3BB79C84140A28F61B34EF054C0F803E6BBF1C7414082B093E68DF154C080404C2230C741409D812D8013F354C050CB16EFACC5414088DD93E611F454C0CCD17D555BC441408AF860B3B0F454C0982AB288CAC34140508893E639F554C0C0A449226CC34140825D94E645F754C0C4FEE3BBB9C24140DEB8C71955F854C0AC0A7F551BC2414073CBC619E1F854C0402D7E5593C14140322761B344F954C0BCFC17EF08C141407897FA4C50FA54C05476E4BB91BD4140E07C60B39AFA54C0208EE4BBEDBC414060ECFA4C1CFB54C04C49E6BB09BC414034F4FA4C8CFB54C0005F492294BB41409822C8193DFE54C0F8314B220CBA4140570BFB4CD0FE54C090C516EF84B94140E08960B346FF54C0B306B088EAB84140D0C3FA4CBC0055C0F030B28856B6414020A4FA4CF00055C0A0247F55BFB54140B83AC719110155C074E1E3BB41B54140562894E61F0155C0CC1B7E55C3B44140DC60FA4C200155C0380EE5BB4DB44140CAC5FA4CD80055C068D04A22A0B24140829C61B3CE0055C0D017B088FAB14140B6A42D80DF0055C070D7E4BB3DB1414054ACC619010155C0406C16EF94B04140317E2E802F0155C0A8364A22F4AF41403A38FB4C4E0255C0A4074A2254AD4140A0AA94E67B0255C09784B188B6AC4140249C61B3C20255C0C0724A226CAB4140BA6861B3D80255C007567F55B3AA4140E55861B3F20255C09CAB7D559BA641409C882D803F0355C0B891B1888EA5414072B3FA4CC40355C0A89C4B2264A44140C833FB4C040555C08C3817EF58A24140287BC719A70555C0D4C94C227CA1414084BB2D80170655C0501B7E5503A14140135DFB4C560655C0C0C84B22F0A0414077EBC719FB0755C07C3FB188F6A04140D88661B36E0B55C0D4A47D554FA04140D8A193E6590C55C0F07AB18856A04140DDA094E6C90C55C0E45BE4BB79A04140EA1AC719190D55C004A7E4BBB9A04140CAD0C719650D55C07C91B0881AA1414074B494E6E10D55C040D7E5BBF1A141400E04C819490E55C07B81B0882EA2414040EAC719D10E55C07893B28832A24140B00DC819CF0F55C02FEBAF88AEA141408EA060B3521055C0D0D1B1883EA141401A0EFB4CB81055C004A7E4BBB9A04140213994E6D71155C0675E4B22F09E414002C4C719991255C09FB9B0886E9D41404EC994E6FD1255C0D46B4C223C9C4140A6F793E61D1355C0B09417EFA89B414018CA2E803B1355C0C0A97D55AB9A41407ADCC619791355C0147F7D554F964140D80061B3BA1355C0F03FE5BB999141406365FA4C1E1455C0382F7E55738A4140864494E6731455C090444C2258844140A8A960B3C61455C03F054B22587E4140188160B3661A55C0404BE5BB817E41403E432E80692055C0404BE5BB817E4140885DFB4CF02455C0404BE5BB817E41402571C7199D2755C0404BE5BB817E4140C05560B3A62F55C0404BE5BB817E41403AF094E6AF3755C0404BE5BB817E4140529CC719B93F55C0A4934B22687E41401A7861B3C24755C0F8DBB1884E7E4140B35CFA4CCC4F55C0BC6C7E551B7E4140FCFF2D80D55755C070FD4A22E87D41400EAC60B3DE5F55C070FD4A22E87D4140A98F2E80C36655C0BC6C7E551B7E4140347AFA4CFE7155C0A4934B22687E41400894FA4C507C55C0E0027F559B7E41404644FB4C288655C027CC16EFB47E4140663FFA4C3E9055C0A89CB188B67E4140B4C02D80539A55C0FC9618EFB07E4140FE4161B368A455C0FC9618EFB07E4140CEFBFA4C7EAE55C0FC9618EFB07E41406CBE93E693B855C0F4CEB0880E7F4140F4A794E6A9C255C040F54A226C7F414086F960B3BECC55C0C8074A22F87F41409D8393E6D3D655C0941CE6BB55804140266D94E6E9E055C088547E55B3804140BCBE60B3FEEA55C088547E55B38041404196FA4CC4F455C0EF6416EFD480414092172E80D9FE55C01081E4BB0581414062D1C719EF0856C0D8AEB088368141408648C719270B56C084557F553F8141402C1B2E80DF0B56C084557F553F8141403C8194E6750B56C0B82D16EFB87F4140CC4594E6150C56C0B82D16EFB87F4140564B94E65D0E56C0B82D16EFB87F414070B92E80AF1656C0E021B188BE7F4140DA682E80011F56C07C45B188C27F414006B060B3522756C09C09E3BBC57F41409F5661B3A42F56C0A8FD7D55CB7F414084CDFA4CF63756C053924A22D07F41409E3B95E6474056C0F02617EFD47F41404ABB2D80994856C0F0A9E5BBD97F4140B46A2D80EB5056C028DFE3BBDD7F414046A061B33C5956C0B702E4BBE17F4140AF4F61B38E6156C0D485B288E67F414094C6FA4CE06956C0049D4922EC7F414070CCC719317256C01C2018EFF07F41405AB42D80837A56C0BC25B188F67F41407422C819D58256C06449B188FA7F4140A069FA4C268B56C0F0FBE4BBFD7F41403A10FB4C789356C08090B18802804140C14061B3029456C0D06917EF98814140FA6193E64D9356C05C497F558B82414052F92D80179256C00C0A7F55F38241407E012E80939056C000C5AF88EE834140C2EA60B3388E56C02CECAF881E864140A66AC719478D56C06C064A22C88741407AB8FA4C988C56C05C00B188B6894140CA7D2D802D8C56C0244BB188EA8B414054F3C719098C56C064CE7C556B8E4140DCB760B3608B56C0B85AE4BBA1904140EA63FA4CD88956C000074C22B0904140120C94E6178856C04BBA17EFF48F414023A7C719CB8656C0F4084A22D08F4140FCFAFA4C768556C0F4A917EFFC924140B45794E6698556C0202C4B223098414019A861B30E8656C0842917EF909D4140887BC719518756C0042A4B22E8A34140B6A860B3928756C0C42FB2887EA64140447E61B3AA8756C0149AE5BB55AC4140ACA1FA4C608756C0676CB1884EAF4140E2A860B3988656C02CE2E3BB59B141404807FB4C308356C03410B188FEB54140EEC593E6338256C0B0B7E5BBD9B74140EA6D2D806D8156C04C7AB188F2B94140961A61B31C8156C094D1492210BC41401DFAC619138156C0A8777D5553BF414076B594E6C98056C0232818EF7CC14140E4AAFA4C008056C0B821B188CEC24140D6FA2D80737E56C0EC9D4A2288C341406C1561B3E07C56C0000C18EFDCC34140DE4FFB4C687B56C06C1DB1888AC441405BA3C719BF7A56C0C80819EF24C641402E30FB4C9C7B56C0F4BB17EF40C94140E02C95E69B7C56C068404922A0CB4140392761B3E27C56C00C034B2220CD4140817BC719777C56C043CEE4BB51CE4140422CFB4C647B56C0ACC617EFC4CF41409DD460B33E7A56C0487818EFCCD1414008B160B33A7A56C0A856E4BB79D34140A873C719077C56C0DCCDAF8846D74140DEDEFA4CFC7C56C0045F18EF40DA4140F41794E6EB7C56C0CCCCE5BB89DC41406E0BFA4C067C56C080D44A2240DE4140BE6F2E803D7256C0A7ECE3BB39E54140F22CC719376E56C0009CB088AEEA4140DC9B2E80C96E56C0BCA97C5507ED4140FC6A2D807F7056C02CA3B08806EF4140D9A8C7192D7256C010A9B28856F041400A85FB4C8E7156C0889EB088B6F2414036D5FA4C9C7056C090007E5557F44140A6BFFA4C686F56C01CE0E5BB49F54140926A2E80016E56C094A7E4BB95F54140644C94E61F6C56C064A6B08826F3414042022E80236B56C01851E4BBB9F24140B4D3C719B56A56C0D410B18826F54140B84EFB4C906B56C033F2492210F941406E772D803F6D56C0CCFBB088DEFB414098602E806F6E56C0845418EF24FF41406E672D80536E56C0846F4A2210004240CA3361B3CE6D56C0401D19EF70044240DA5AC719D96B56C050FDB088C2094240D6AA61B3946B56C07C72B088DE0B42404A73FA4C246B56C053D216EF140D424017E5F94C1A6A56C0ABA216EF5C0E424054202E80DF6856C028C3B288620F4240D61194E6DD6756C0E8D617EFCC0F4240857F2E80496756C088917E55231242407A102E80F96856C0B413B2885617424084BA61B3746C56C0DC9017EF9C1F424084A794E64B6B56C0D44319EF3C204240F461C719576556C0CBEC7D559B20424060602E808F6456C0FC3CE4BBF120424073D7FA4CEA6356C040BEE3BBC1214240222D2E80AB6356C0541CB1882A234240399B60B34C6456C0602618EF042442409E5F60B3E66556C0C00C7F55DB244240BE9860B31E6756C0086C7C55BB2642406ECB2D80136856C0806B17EF5C29424092142E80376856C04879E3BBB52B4240666A61B3FE6656C0D8DAE2BBB92C4240DE762D80536556C01CF3B088B22C42409D3161B3D26356C0BF90E3BB052D424008FB93E6A56256C0EC9CB1884A2E42401AB194E6F76156C080C47F5517314240649194E62B6256C0444419EFFC33424084EF61B3946356C01CDDB0884639424069D8F94C7A6356C0FF947D55433B4240468F94E6096356C048677F55A33D4240AA6394E68F6356C07F55B088823F42402473C819D56356C0D03E16EF04404240C84094E6A35F56C0DC84B0882E4042400636FA4CD45F56C0D023E4BB193F4240AA9594E66F6056C02C83E4BB893C42407B2BC719536056C0E811E5BBA53A4240668E60B3A65E56C023E317EFE839424096CBF94CD45D56C0E88E16EFA03A42403E79C719C75C56C07CA317EF443C42401C5A2E80555B56C0A7707D55273F42400432FB4C2A5B56C04C3AE3BBDD3F4240A851FB4C1C5056C058C916EFDC3F4240D2A961B30E4556C04C584A22DC3F42403CD260B3003A56C03C76B188DA3F4240662AC719F32E56C02C9418EFD83F424010BB93E6E52356C010B27F55D73F4240720AFB4CD81856C010B27F55D73F42408EF194E6C90D56C08FE1E4BBD53F4240B749FB4CBC0256C010A07D55D33F4240445D94E68B0256C0F0247D55CF42424018BD93E6790256C0F8524A22744742403EAD93E6930256C09F044B227C494240FADD60B36C0356C0FCC6E4BB19504240DE94C719910456C024C44B2228564240E2D160B3B80456C0502FE4BB6957424051282E80B70456C068354B220C5842401EC761B39C0456C0A0C2E5BB3D58424014442E804B0456C0886E4922485842407940C719D70056C064BB18EFBC574240573760B31AFB55C010054A22D456424091A5FA4C98F755C00822B0884656424044BC94E615F755C0207EB188FE554240C8E293E6C5F655C008D84B224C554240B2BAFB4C4EF655C0A8D6B2888A53424004BDC7190BF655C0F8FA4A22D0524240960494E6B3F555C028D07D554B52424074CCF94C54F555C03887E4BB755242404929C719B9F255C010D47D5583524240363DC719DDF155C03C98AF8886524240729B61B36EEF55C00403B088925242407ECA60B3A6EB55C004B5B088A65242403C6FFA4CC0E655C0A0FB7D55BF5242407507FA4CF4E055C0CCF47E55DB52424080F62D807BDA55C0A0F318EFFC524240282B2E808FD355C018E64922205342409E8294E669CC55C06F9717EF445342401A4BC71945C555C064784A2268534240424761B358BE55C0B8477F558B534240143F94E6DFB755C020C9E3BBAD534240D30FFA4C14B255C05833B188CA5342408A43C7192DAD55C078A9E3BBE1534240D8DA93E665A955C0775BE4BBF553424004C861B3F6A655C034C6E4BB015442407714C8191BA655C06CFBE2BB05544240D26361B356A355C0C01817EF14544240D8B794E607A155C0688818EFE454424088752E807BA055C0F8DA4A22F85442408E7160B3B29D55C074F47E55CF5442403B1C61B3689A55C0D0CF7D553F544240BFB02E80FB9555C0649B17EF7C534240E01F2E80E38D55C0A8EE17EF38524240182661B3468455C0286FB18836514240E43DFA4C807755C0B83A4B22745042407C8793E6936855C04C06E5BBB14F4240321E94E64B5B55C00B8E4B22304F4240305AFA4CC44755C0448C7C55FB4F4240163D2E80BD3755C0E00517EF144F42408AF7C719372855C037F616EF344E4240BE9094E6B11955C0F47417EF644D42403AE9FA4CB00C55C0AF87B188AA4C4240886794E6B10155C0381617EF0C4C4240E283FA4C38F954C0B014E3BB914B4240C93CFB4CC4F354C0A00B7D55434B4240CC4294E6D5F154C0F4714A22284B4240FEBB94E6BDEE54C04808B088FA4A42407C2761B376EC54C044054C22FC4B4240F2A894E6B7EA54C0F3514A22504D4240,-12.1%,-114,831,177,654,Tennessee,true
42,0106000020E61000000600000001030000000100000014000000025672A194E451C01C09BDA32B934440497D18085FE651C078BDA8E2A892444006040BA447E751C0C06585F7DC93444002731EC236E751C058B8E18E6F95444048EA98E1E9E651C0C095938D1D974440C60700383DE651C0AB60DF8B059844406489277ED6E551C0B8C5CF35429944400D67277E4AE551C0AC5ECF351E9A4440F2717CD325E551C08071D0357E9B44407D4C959C11E551C01CF31287DF9C4440EAE3D128A5E451C0E493D0354A9D44400E67277E4AE451C00436248BC79C4440A611BF376DE351C030041217779B44400AA0EB6ACEE351C06058E727BB994440AAF97BD33BE451C008CC7AE0CC9844405EFB7CD3D5E351C0E0FD79E0849744404E947CD351E351C07871D0357E964440807561A6D8E251C018053380D99444404E199B5D24E351C0A86D571D76934440025672A194E451C01C09BDA32B93444001030000000100000017000000D27CD12821D951C00CCC7AE04CBB4440EE717CD385D951C0B47A248B1FBB444002D97CD3A9D951C058A3CF35F6BB44400C67277E4AD951C038B6D035D6BE4440EE717CD385D951C0A45ECF355EC04440944F7CD319D951C0C3C5CF35C2C04440309FD128EDD851C038D5CE352EC144404C947CD3D1D851C0CC2CD035A6C144409CDD267E9AD851C0284FD03532C244402C9FD1284DD951C0D0B2CE3562C34440DA0A7CD321D951C05CA3CF3576C544401A837CD32BD851C094F7CE35FAC94440663E7CD393D751C0BCC5CF35C2C944404A947CD331D751C0EC19CF3546C94440AAF97BD3FBD651C0888D258B7FC84440F5FF267EE6D651C0284FD03572C74440A6B67CD3DDD651C034D5CE35AEC444404606D22811D751C093427AE0DCC14440F4FF267E66D751C0E448258B67BF4440F0717CD3C5D751C08C71D035BEBD44404D947CD311D851C013E8CF350EBD44405EFB7CD395D851C050D2258B17BC4440D27CD12821D951C00CCC7AE04CBB444001030000000100000023000000ACF97BD33BCF51C0E093D0350AC04440643E7CD3F3CE51C0AC5ECF359EBE44405222277EF2D051C0948D258B7FBF44402D9FD1284DD251C0204FD035B2BD4440081C7CD367D351C0204FD035B2BB44402E9FD128ADD451C0888D258BFFBB44402EEA7CD36FD551C0B0C5CF35C2BA4440061C7CD327D651C050877AE034BA44404406D228B1D651C00081CF35AABA4440F5FF267EE6D651C094F7CE357ABC4440AAF97BD37BD651C00C81CF352ABD44409CDD267E7AD451C0F019CF3586BE4440D6C77CD3C3D351C00481CF356ABF44404206D22891D451C040D2258B17C1444062FB7CD3D5D451C018E8CF358EC24440C0607CD39FD451C0B0107BE0E4C34440BE607CD3FFD351C070BF248B37C54440FC4AD228C9D351C0C02CD035E6C544408EC1D128B9D351C01CE8CF35CEC64440D6C77CD3C3D351C020B979E0ACC844404C947CD391D351C03CD5CE352EC94440D27CD128A1D251C0E0FD79E004CA4440EE717CD345D251C064A3CF3576CA4440C4AB277EE2D151C00481CF35EACB4440C2AB277E82D151C07C557BE07CCF4440D4C77CD323D151C098F7CE35FAD04440C2607CD37FD051C0B8C5CF3502D24440E5E3D128E5CE51C008E8CF358ED34440B044277E1ECE51C0F8CB7AE08CD44440B044277E1ECE51C028B979E0ECD14440C0AB277EE2CE51C01BE8CF358ECD4440643E7CD3F3CE51C0204FD035F2C344401A837CD30BCF51C030D5CE356EC24440643E7CD333CF51C068BF248B37C14440ACF97BD33BCF51C0E093D0350AC04440010300000001000000100000000767277E2AD451C048D2258B57CA44400E67277E2AD551C02CB979E0ACC94440725AD12895D551C0C0C5CF3582CA4440725AD12895D551C048D2258BD7CB44400E67277E2AD551C01CB979E02CCE4440BC607CD37FD551C018B979E02CD04440765AD128D5D651C050D2258BD7D04440C2607CD3FFD651C024B979E02CD24440C2607CD3BFD651C0C4C5CF3582D44440C2607CD3FFD551C04CD2258BD7D54440BC607CD37FD551C020B979E02CD444400E67277E2AD551C040D2258BD7D24440715AD12855D451C0B8C5CF3502D144400A67277E6AD351C018B979E02CD04440BE607CD37FD351C054D2258B57CD44400767277E2AD451C048D2258B57CA44400103000000010000001D000000F45DF648CEC751C068C835A7A8C14440F2717CD3E5CB51C0888D258BFFBB4440AE44277EBECC51C08471D035FEBE4440382D7CD3EDCC51C044B6D03556C044404C947CD391CC51C068BF248BB7C14440EE717CD385CC51C0F780CF35AAC24440AE44277E3ECD51C0284FD03572C744408EC1D12879CD51C030B6D03516CD44401A837CD36BCD51C0C82CD03526D04440AE44277E3ECD51C070BF248BB7D244404EC469DB69CC51C038A7BB65A3D644409866F0C569CC51C018EBFD44A3D64440664FFA4C8CCB51C088987D5533D6444056CD60B37ECA51C0AC8B17EFACD5444080B394E671C951C0B47EB18826D544406C31FB4C64C851C057834922A0D44440983BC71991C851C0F7F27C55DFD24440F83C94E6BDC851C0A862B0881ED14440563E61B3EAC851C04843B0885ECF4440B33F2E8017C951C0F8B2E3BB9DCD4440563E61B3EAC851C02B3F7D5543CD4440F83C94E6BDC851C0D02AE5BBE9CC4440983BC71991C851C014284B2290CC44406C31FB4C64C851C04825B18836CC44400C302E8037C851C05F07B2880EC94440AE2E61B30AC851C0FF6B7D55E7C54440482D94E6DDC751C000BF4A22C0C24440A4CEFA4CCEC751C07F1C17EFA8C14440F45DF648CEC751C068C835A7A8C14440010300000001000000740000002A312E800FD851C098357E55B3F24440B2C193E68DD751C03F73E5BB7DF244400ECAFA4C58D651C00C607D559BF24440B66FC819D5D551C0885B4A2274F24440113360B39AD551C0005A16EFF8F144407A9C93E679D551C097D2AF8886F044406413FB4C82D551C08BD5E4BB99EF444026C5F94C94D551C084EE4A22D4EE4440229AC719BDD551C0800AB088BAED4440A25860B3BAD551C07C69B0881EED44406C0095E6A1D551C0B0574922D4EB44406A09FB4CF0D551C08080B2887EE74440967D2D80EBD551C0A00F4B22D0E6444054A293E6CDD551C050FF17EF00E64440CE96FA4C74D551C0A8497C5507E544405441C719B9D451C0043AB2888EE344408698C719ADD351C03CBCE4BB59E24440094394E6F1D251C030394C22BCE144407A7E94E651D251C0308FB0886AE14440DCD6FA4C24D151C0F0E9E2BBF9DF44404811BBAF28CF51C098F19EFBD2DA4440D90A7CD341CF51C0EC93D0358ADA4440E6E3D12865CF51C0680AD0355AD94440BF607CD35FCF51C0D0B2CE35A2D744402E9FD1286DCF51C0204FD03532D744401E837CD3ABCF51C0607479E014D744400C67277EAAD051C040D2258B57D34440FD4AD22849D251C02CD5CE356ED444404406D22851D351C02CD5CE356ED44440D6C77CD3C3D351C097427AE0DCD54440D90A7CD3A1D351C0AF107BE0A4D744401C837CD34BD351C01017268BEFD944404C947CD3D1D251C028D5CE352EDC444098DD267EFAD151C0C02CD035E6DE44409C28D2281DD251C0780AD035DADF44400E67277E8AD251C0F419CF3586E04440C2607CD31FD351C0F035248BC7E04440643E7CD353D351C070BF248B37E04440AEF97BD37BD351C0204FD03572DD4440D6C77CD3C3D351C00C81CF356ADC4440A028D2285DD451C0F019CF35C6DC44405222277E92D551C028B979E0ECDD4440C2AB277EC2D651C0E819CF3586DF444018837CD34BD751C0AFC5CF3542E14440EB717CD365D751C0E093D0358AE34440623E7CD3B3D751C0E0B2CE3562E54440B044277E3ED851C0EC93D0350AE744401D837CD30BD951C014E8CF35CEE84440061C7CD347D951C0D8B2CE3522E74440A228D2285DD951C0B8C5CF3542E44440FC4AD22849D951C060BF248B37E144401D837CD30BD951C0D893D0350ADF4440BC607CD39FD851C00481CF352ADE444006D97CD309D851C0B8C5CF3582DD4440E7E3D12885D751C0C82CD035A6DC444018837CD34BD751C0B8107BE024DB44409ADD267E7AD751C01CE8CF350EDA44406589277E56D851C0C0C5CF3582D744409CDD267E9AD851C008CC7AE04CD64440352D7CD30DD951C018B979E06CD74440BE607CD37FD951C0DC93D0354AD844400C67277E0ADA51C01804258BCFD844400C67277ECADA51C00381CF35EAD84440FA4AD22889DB51C060A3CF3576D84440D2C77CD343DC51C02004258B8FD7444078A57CD397DC51C00017268BAFD644407AA57CD317DB51C0F019CF3586D54440ABF97BD37BDA51C0503CCF3592D34440DC0A7CD341DA51C0D7FD79E004D14440F0717CD365DA51C030D5CE356ECE4440A8B67CD31DDB51C03F3CCF3512CC4440AAB67CD3FDDB51C0680AD035DACA44406889277E56DC51C014E8CF358EC944409B28D2287DDB51C058A3CF35F6C644402E9FD1282DDB51C098F7CE35FAC444408AC1D12819DB51C0B7C5CF3542BE4440EAE3D12845DB51C0888D258BFFBB44400C9C1B4F1BDD51C07C2E4E21FCB34440A0E3B33A0EDE51C017E6B62417B2444087C1D128F9DE51C0D0B2CE35A2B04440BF607CD33FDF51C00817268B6FAF44409ADD267EDADF51C0D8B2CE35E2AE4440BD607CD37FE051C0A45ECF351EAF44404C947CD3F1E151C00017268B2FB044406AA3E4AF92E351C0F0E731F0FAAF444066A89C1F54E651C070FD1FFA0AAF4440B044277E3EF051C0B07A248B5FAA4440D6C0A5E20DF551C0B75B15F292A844403AB45CFE37F651C07C8B16D0C8A74440600794E613F651C03F727E5527A944404CF0C619ADF551C02CFBE2BBADAB4440901095E61BF551C064367F5523B24440E49693E6B9F451C0A8D2B088DEB34440F805FB4C52F451C043C3E3BBE1B444404A4FFB4C7CF351C06431B18836B54440EA0794E625F351C018A6E3BB1DBD444074CB2D80EDF251C0E0507D556BC24440A09860B3F2F251C0589217EF44C64440928094E6FBF251C0AFAC17EFA8CD44405AE293E605F351C02438E4BB0DD54440D2022E800FF351C07852E4BB71DC4440142CC71919F351C0405BE6BBD5E344408C4C61B322F351C0C42716EF38EB4440CE75FA4C2CF351C0873018EF9CF24440CECEFA4C36F351C0F02CB18802FA44409630FA4C40F351C050D6E4BB65014540CED1FA4C76ED51C06F6FE4BB91014540D47BFA4CACE751C0104A4B22C001454086E494E6E1E151C040C5E3BBED01454006562E8017DC51C0DC4CE5BB19024540D2FA93E6C5D851C0E80BB1880602454012B160B3B2D851C098E04B224C0045400ECDC71995D851C0B717B08846FC44409A8760B35AD851C0682D7E5537F444406B2F95E641D851C0F8D54A2260F344402A312E800FD851C098357E55B3F24440,-16.8%,-18,89,0,89,Rhode Island,true
47,0106000020E610000001000000010300000001000000980000001900C81937C35BC0A436B088FAFF44401900C81937C35BC0547BB088FAF74440DA97FA4C36C35BC004317D55FBEF4440595F94E635C35BC024D54B22FCE74440595F94E635C35BC0D48A18EFFCDF4440595F94E635C35BC0745E4C22FCD74440D2262E8035C35BC044F6B188FECF4440CAB561B334C35BC0E4C9E5BBFDC74440CAB561B334C35BC09F7FB288FEBF4440CAB561B334C35BC044C4B288FEB744408B4D94E633C35BC0841AB188FEAF4440D31D2D8033C35BC040414A2200A84440D31D2D8033C35BC0E4147E55FF9F4440D31D2D8033C35BC0A0CA4A2200984440D31D2D8033C35BC0508017EF00904440D31D2D8033C35BC00036E4BB0188444051E5C61933C35BC0B07AE4BB01804440BD3B94E631C35BC0B07AE4BB01804440BD3B94E631C35BC0A00918EF00804440BD3B94E631C35BC090277F55FF7F4440BD3B94E631C35BC01457E4BBFD7F4440BD3B94E631C35BC004E617EFFC7F4440BD3B94E631C35BC004754B22FC7F4440BD3B94E631C35BC084A4B088FA7F44400FC561B32EBB5BC084A4B088FA7F4440F1EE60B32AB35BC084A4B088FA7F4440FE0F61B326AB5BC084A4B088FA7F444056992E8023A35BC084A4B088FA7F4440B2FB93E61F9B5BC084A4B088FA7F4440FD1395E61B935BC084A4B088FA7F44405F76FA4C188B5BC084A4B088FA7F44402AC761B314835BC084A4B088FA7F44408D29C719117B5BC084A4B088FA7F4440A04AC7190D735BC084A4B088FA7F4440F1D394E6096B5BC084A4B088FA7F4440CEFD93E605635BC084A4B088FA7F4440994EFB4C025B5BC084A4B088FA7F444082E9C619FF525BC084A4B088FA7F4440CD01C819FB4A5BC084A4B088FA7F4440A82BC719F7425BC084A4B088FA7F4440A82BC719F7425BC068CEE2BBF96F4440A82BC719F7425BC0C4C8AF88FA5F4440A82BC719F7425BC024C37C55FB4F4440E89394E6F7425BC074DBB088FA3F4440753DC719F9425BC05705E3BBF92F4440753DC719F9425BC0A81D17EFF81F4440753DC719F9425BC00418E4BBF90F4440753DC719F9425BC06412B188FAFF4340753DC719F9425BC054ADAF88FAEF4340753DC719F9425BC098C5E3BBF9DF4340753DC719F9425BC0F34EE4BBF9CF4340753DC719F9425BC0E3E9E2BBF9BF43407DAE93E6F9425BC0280217EFF8AF43407DAE93E6F9425BC088FCE3BBF99F43407DAE93E6F9425BC0E485E4BBF98F43407DAE93E6F9425BC0D420E3BBF97F43407DAE93E6F9425BC0341BB088FA6F43407DAE93E6F9425BC084A4B088FA5F43407DAE93E6F9425BC0D72DB188FA4F4340BD1661B3FA425BC0C457E3BBF93F4340FD7E2E80FB425BC008FF4A22F82F4340FD7E2E80FB425BC068F917EFF81F4340FD7E2E80FB425BC05805E3BBF90F4340FD7E2E80FB425BC0B48EE3BBF9FF4240FD7E2E80FB425BC00818E4BBF9EF4240FD7E2E80FB425BC0E84116EFF8DF4240FD7E2E80FB425BC054ADAF88FACF4240FD7E2E80FB425BC098C5E3BBF9BF4240FD7E2E80FB425BC0787E4922F8AF4240FD7E2E80FB425BC0C8074A22F89F4240FD7E2E80FB425BC0280217EFF88F42407DB794E6FB425BC088FCE3BBF97F4240B02A61B3F84C5BC018AF17EFFC7F4240995CC819F5565BC0A4614B22008042405308FB4CF2605BC0DC964922048042408D7BC719EF6A5BC06C497D5507804240B87DC719EB745BC05BEAB2880A804240A920FB4CE87E5BC0931FB1880E804240DD93C719E5885BC018D2E4BB11804240C1C52E80E1925BC0449616EF14804240420994E6DD9C5BC03F374C22188042402DACC719DBA65BC060FB7D551B804240661F94E6D7B05BC0ECADB1881E804240125AFA4CD4BA5BC088D1B188228042407DC4C719D1C45BC01884E5BB25804240B63794E6CDCE5BC0344817EF288042406172FA4CCAD85BC0D06B17EF2C804240221E2D80C7E25BC0601E4B22308042408688FA4CC4EC5BC0ECD07E553380424039C360B3C0F65BC01895B08836804240296694E6BD005CC0A847E4BB398042405DD960B3BA0A5CC0446BE4BB3D80424089DB60B3B6145CC0D01D18EF40804240C24E2D80B31E5CC0F0E1492244804240ACF160B3B0285CC08C054A22488042405E2CC719AD325CC01BB87D554B804240C99694E6A93C5CC0A86AB1884E804240FD0961B3A6465CC0D42EE3BB5180424067742E80A3505CC060E116EF54804240617F2D809F5A5CC0EF934A2258804240CCE9FA4C9C645CC07FB74A225C80424086952D80996E5CC00C6A7E555F80424069C794E695785CC0A81CB288628042409C3A61B392825CC03840B28866804240A9AB2D8093825CC038D97E5563944240F184C71995825CC0ACA1B0885EA8424031ED94E695825CC02C7CE4BB5DBC424046CF2D8097825CC020A4E4BB59D042404E40FA4C98825CC0203DB18856E44240951994E699825CC024474A2254F8424055BAC7199B825CC0146F4A22500C43409C9361B39C825CC078F618EF4C204340AA042E809D825CC06C8FE5BB49344340F0DDC7199F825CC00BAB7C5547484340F84E94E69F825CC060C17E55435C4340C16094E6A1825CC0703CE4BB4170434000C961B3A2825CC054F317EF3C84434015ABFA4CA4825CC058FDB0883A9843401D1CC719A5825CC064074A2238AC43405D8494E6A5825CC0582F4A2234C0434063F560B3A6825CC0B0B618EF30D4434072662D80A7825CC050D2AF882EE84340726F2E80A9825CC0AF597E552BFC434078E0FA4CAA825CC0A4817E552710444088C293E6AB825CC0B4FCE3BB25244440CD2A61B3AC825CC098B317EF203844400F04FB4CAE825CC09CBDB0881E4C4440D5A42E80AF825CC08F567D551B604440E586C719B1825CC0FF4E18EF18744440EDF793E6B1825CC0908816EF148844403AD12D80B3825CC0F480B188129C44404242FA4CB4825CC0F3197E550FB04440BA1295E6B5825CC0CCD0B1880AC44440C78361B3B6825CC04CABE5BB09D844405E9E60B3B8825CC0D07317EF04EC4440E5D6C619B9825CC0DC7DB088020045401185C719C1765CC0DC7DB088020045404333C819C96A5CC0C09B17EF000045403EEAC719D15E5CC0C02A4B22000045403EA1C719D9525CC0C02A4B22000045403958C719E1465CC0C02A4B22000045406A06C819E93A5CC0C02A4B2200004540E58461B3F02E5CC0C02A4B22000045405E03FB4CF8225CC0A448B288FEFF444059BAFA4C00175CC0946619EFFCFF44408568FB4C080B5CC0946619EFFCFF4440851FFB4C10FF5BC0946619EFFCFF444078652E8017F35BC0946619EFFCFF4440731C2E801FE75BC0946619EFFCFF444072D32D8027DB5BC0B4A77C55FBFF4440A5812E802FCF5BC0A436B088FAFF44401900C81937C35BC0A436B088FAFF4440,-0.6%,-2,335,24,311,Utah,true
54,0106000020E610000001000000010300000001000000CA000000EDDDFA4C66035AC0A8274B220C8045401FCCFA4C64035AC0F8B04B220C7045409119C71961035AC0CCF8E4BB09604540355E94E65D035AC01C82E5BB0950454035AE93E665035AC08B4C4922084045409119C71961035AC0ECD54922083045409119C71961035AC02C7DB18806204540355E94E65D035AC0FCC44A22041045404A402D805F035AC0504E4B22040045401FCCFA4C64035AC03007B18802F0444010EA61B362035AC0F44E4A2200E04440989394E663035AC044677E55FFCF44409F3A94E659035AC09F7FB288FEBF44406D4C94E65B035AC0743818EFFCAF44409122C81963035AC0B7504C22FC9F44409122C81963035AC0348C7C55FB8F4440E736FB4C70035AC084A4B088FA7F4440B8B093E66D0B5AC084A4B088FA7F44404DB260B37A155AC084A4B088FA7F4440E5B32D80871F5AC084A4B088FA7F44403AE561B394295AC084A4B088FA7F4440CAE62E80A1335AC084A4B088FA7F4440F0882D80AD3D5AC084A4B088FA7F4440065294E6B9475AC084A4B088FA7F4440655C60B3C6515AC084A4B088FA7F4440FA5D2D80D35B5AC084A4B088FA7F4440925FFA4CE0655AC084A4B088FA7F4440AF992D80ED6F5AC084A4B088FA7F444007332D80F9795AC084A4B088FA7F444016FC93E605845AC084A4B088FA7F4440ADFD60B3128E5AC084A4B088FA7F444049FF2D801F985AC084A4B088FA7F4440A709FA4C2CA25AC084A4B088FA7F44403F0BC71939AC5AC084A4B088FA7F4440D50C94E645B65AC084A4B088FA7F4440ED46C71953C05AC084A4B088FA7F444081D7C7195FCA5AC084A4B088FA7F44405AA92D806BD45AC084A4B088FA7F4440EFAAFA4C78DE5AC084A4B088FA7F444087ACC71985E85AC084A4B088FA7F44401DAE94E691F25AC084A4B088FA7F444082B860B39EFC5AC084A4B088FA7F444019BA2D80AB065BC084A4B088FA7F444030F460B3B8105BC084A4B088FA7F4440BF8461B3C41A5BC084A4B088FA7F44409C56C719D1245BC084A4B088FA7F4440AD1F2E80DD2E5BC084A4B088FA7F4440CA5961B3EA385BC084A4B088FA7F4440A82BC719F7425BC084A4B088FA7F4440CD01C819FB4A5BC084A4B088FA7F444082E9C619FF525BC084A4B088FA7F4440994EFB4C025B5BC084A4B088FA7F4440CEFD93E605635BC084A4B088FA7F4440F1D394E6096B5BC084A4B088FA7F4440A04AC7190D735BC084A4B088FA7F44408D29C719117B5BC084A4B088FA7F44402AC761B314835BC084A4B088FA7F44405F76FA4C188B5BC084A4B088FA7F4440FD1395E61B935BC084A4B088FA7F4440B2FB93E61F9B5BC084A4B088FA7F444056992E8023A35BC084A4B088FA7F4440FE0F61B326AB5BC084A4B088FA7F4440F1EE60B32AB35BC084A4B088FA7F44400FC561B32EBB5BC084A4B088FA7F4440BD3B94E631C35BC084A4B088FA7F4440BD3B94E631C35BC004754B22FC7F4440BD3B94E631C35BC004E617EFFC7F4440BD3B94E631C35BC01457E4BBFD7F4440BD3B94E631C35BC090277F55FF7F4440BD3B94E631C35BC0A00918EF00804440BD3B94E631C35BC0B07AE4BB0180444051E5C61933C35BC0B07AE4BB01804440D31D2D8033C35BC00036E4BB01884440D31D2D8033C35BC0508017EF00904440D31D2D8033C35BC0A0CA4A2200984440D31D2D8033C35BC0E4147E55FF9F4440D31D2D8033C35BC040414A2200A844408B4D94E633C35BC0841AB188FEAF4440CAB561B334C35BC044C4B288FEB74440CAB561B334C35BC09F7FB288FEBF4440CAB561B334C35BC0E4C9E5BBFDC74440D2262E8035C35BC044F6B188FECF4440595F94E635C35BC0745E4C22FCD74440595F94E635C35BC0D48A18EFFCDF4440595F94E635C35BC024D54B22FCE74440DA97FA4C36C35BC004317D55FBEF44401900C81937C35BC0547BB088FAF744401900C81937C35BC0A436B088FAFF4440A8A9FA4C38C35BC088EDE3BBF5134540BD8B93E639C35BC0EC74B288F2274540B523C8193BC35BC07CAEB088EE3B4540365C2E803BC35BC06065E4BBE94F45403CCDFA4C3CC35BC054FEB088E6634540046E2E803DC35BC0B814B388E2774540911761B33EC35BC03C4EB188DE8B4540A1F9F94C40C35BC02C76B188DA9F454099912E8041C35BC0200F7E55D7B345402E3B61B342C35BC0A4D7AF88D2C74540EEDB94E643C35BC0F8EDB188CEDB45407D85C71945C35BC0F7867E55CBEF4540062FFA4C46C35BC07C4FB088C6034640CBCF2D8047C35BC06B77B088C217464013A9C71949C35BC0D06F4B22C02B46401B1A94E649C35BC044C7B088BA3F46401B1A94E649C35BC0ECC017EF9C43464013A9C71949C35BC0A09C17EF804746400B38FB4C48C35BC0547817EF644B4640CBCF2D8047C35BC07C12B088464F4640CBCF2D8047C35BC0B04D7E552B534640062FFA4C46C35BC05447E5BB0D574640FEBD2D8045C35BC0EC404C22F05A46407D85C71945C35BC034BD7D55D35E4640F64C61B344C35BC0E8987D55B7624640EEDB94E643C35BC08C92E4BB99664640AE73C71943C35BC034FD17EF7C6A46402E3B61B342C35BC078087D555F6E4640A102FB4C42C35BC01C73B0884272464099912E8041C35BC0333DB2882676464099912E8041C35BC0DBA7E5BB097A4640A1F9F94C40C35BC02B2417EFEC7D4640A1F9F94C40C35BC0904018EF008046402080C71903C05BC0904018EF00804640C85BC7190DB95BC0904018EF008046406AC6FA4C16B25BC0904018EF008046405901C7191FAB5BC0904018EF0080464033D4C71929A45BC0904018EF00804640DCAFC719339D5BC0904018EF008046407D1AFB4C3C965BC0904018EF00804640ED8D2D80458F5BC0904018EF008046404728C8194F885BC0904018EF00804640BF0CC71959815BC0904018EF00804640916EFB4C627A5BC0904018EF0080464001E22D806B735BC0904018EF00804640E2B42E80756C5BC0904018EF00804640CBEFFA4C7E655BC0904018EF0080464033632D80875E5BC0904018EF0080464015362E8091575BC0904018EF0080464085A960B39A505BC0904018EF008046409FDB2D80A3495BC0904018EF0080464048B72D80AD425BC0904018EF00804640E82161B3B63B5BC0904018EF0080464012C5FA4CC0345BC0904018EF008046403A6894E6C92D5BC0904018EF008046401CA360B3D2265BC0904018EF008046407B3DFB4CDC1F5BC0904018EF008046406DE993E6E5185BC0904018EF008046404DBC94E6EF115BC0904018EF00804640BE2FC719F90A5BC0904018EF00804640D86194E601045BC0904018EF00804640813D94E60BFD5AC0904018EF00804640A9E02D8015F65AC0904018EF00804640434B61B31EEF5AC0904018EF008046406CEEFA4C28E85AC0904018EF00804640959194E631E15AC0A0B1E4BB018046403E6D94E63BDA5AC0AC937D5503804640E5D7C71945D35AC0AC937D5503804640CE1294E64DCC5AC0AC937D55038046402F1EFB4C58C55AC0AC937D550380464051C194E661BE5AC0AC937D55038046403AFC60B36AB75AC0AC937D5503804640639FFA4C74B05AC0AC937D5503804640854294E67DA95AC0AC937D5503804640651595E687A25AC0AC937D5503804640D588C719919B5AC0AC937D5503804640BDC393E699945AC0AC937D5503804640989694E6A38D5AC0AC937D5503804640080AC719AD865AC0AC937D550380464062A461B3B67F5AC0AC937D55038046405850FA4CC0785AC0AC937D55038046407382C719C9715AC0AC937D5503804640952561B3D26A5AC0AC937D5503804640BDC8FA4CDC635AC0AC937D55038046405F332E80E55C5AC0AC937D5503804640069E61B3EE555AC0AC937D5503804640F149FA4CF84E5AC0AC937D550380464050E494E601485AC0AC937D5503804640BA57C7190B415AC0AC937D55038046401AF261B3143A5AC0AC937D55038046408BD660B31E335AC0AC937D550380464074112D80272C5AC0AC937D55038046404D7361B330255AC0AC937D5503804640C45760B33A1E5AC0AC937D55038046409F2A61B344175AC0AC937D55038046400F9E93E64D105AC0AC937D5503804640E2FFC71957095AC0AC937D550380464071FCF94CA0035AC0AC937D5503804640693B2E8097035AC0001D7E550370464094AF60B392035AC0F8F4B088DE5F46407ECDC71991035AC0DC167E551B504640595094E693035AC0BB1DE3BB0540464037F42D808F035AC01B897C5507304640A1D02D808B035AC07C127D55072046404BBCFA4C7E035AC0CC9B7D55071046405A9E93E67F035AC01C257E55070046401A98C7198B035AC01C31492208F0454005AD2D8087035AC06CBA492208E04540AFF1FA4C84035AC03CA318EF08D04540E1DFFA4C82035AC0A80EB2880AC045405A9E93E67F035AC008097F550BB04540C32A94E673035AC0687418EF0CA045401A1CFA4C6C035AC0539E4A220C904540EDDDFA4C66035AC0A8274B220C804540,-22.3%,-25,87,31,56,Wyoming,true
